Date,Time,Computers,Tables,StudySpaces,QuietArea,Alcove,Total,timestamp
2021-08-16,7:30 PM,2,1,0,2,1,6,08-16-2021 7:48:23
2021-08-17,6:30 PM,3,0,0,1,0,4,08-17-2021 6:48:05
2021-08-17,7:30 PM,1,0,0,1,0,2,08-17-2021 7:33:01
2021-08-17,8:30 PM,1,0,0,1,0,2,08-17-2021 8:26:23
2021-08-18,5:30 PM,5,0,1,1,2,9,08-18-2021 5:47:36
2021-08-18,6:30 PM,3,0,0,1,0,4,08-18-2021 6:30:11
2021-08-18,7:30 PM,2,0,0,1,0,3,08-18-2021 7:33:46
2021-08-18,8:30 PM,0,0,0,0,0,0,08-18-2021 8:49:17
2021-08-19,5:30 PM,9,0,0,2,3,14,08-19-2021 5:26:24
2021-08-19,6:30 PM,2,1,0,4,1,8,08-19-2021 6:32:33
2021-08-19,7:30 PM,6,1,0,2,1,10,08-19-2021 7:46:08
2021-08-19,8:30 PM,0,0,0,3,0,3,08-19-2021 8:34:14
2021-08-21,12:30 PM,5,0,0,1,0,6,08-21-2021 12:24:06
2021-08-21,1:30 PM,3,0,0,0,1,4,08-21-2021 1:40:54
2021-08-21,1:30 PM,3,0,0,0,0,3,08-21-2021 1:46:19
2021-08-23,6:30 PM,2,2,0,3,1,8,08-23-2021 6:26:07
2021-08-23,7:30 PM,1,3,0,1,0,5,08-23-2021 7:34:37
2021-08-23,8:30 PM,1,2,0,0,0,3,08-23-2021 8:30:46
2021-08-24,5:30 PM,14,3,0,3,1,21,08-24-2021 5:26:52
2021-08-24,6:30 PM,2,0,0,1,0,3,08-24-2021 6:26:52
2021-08-24,7:30 PM,3,0,0,1,0,4,08-24-2021 7:28:25
2021-08-24,8:30 PM,1,0,0,1,0,2,08-24-2021 8:26:02
2021-08-25,5:30 PM,6,7,2,3,3,21,08-25-2021 5:37:49
2021-08-25,6:30 PM,3,2,0,2,0,7,08-25-2021 6:40:19
2021-08-25,7:30 PM,1,2,0,2,0,5,08-25-2021 7:30:45
2021-08-25,8:30 PM,1,2,0,1,0,4,08-25-2021 8:33:47
2021-08-26,5:30 PM,2,2,0,2,1,7,08-26-2021 5:33:00
2021-08-26,6:30 PM,0,0,0,1,0,1,08-26-2021 6:29:44
2021-08-26,7:30 PM,0,1,0,2,0,3,08-26-2021 7:32:50
2021-08-26,8:30 PM,0,0,0,2,1,3,08-26-2021 8:32:30
2021-08-28,10:30 AM,0,1,0,1,0,2,08-28-2021 10:30:53
2021-08-28,12:30 PM,4,1,0,2,0,7,08-28-2021 11:31:50
2021-08-28,12:30 PM,4,0,0,2,0,6,08-28-2021 12:30:50
2021-08-28,1:30 PM,4,0,0,2,0,6,08-28-2021 1:31:13
2021-08-30,5:30 PM,9,2,6,3,1,21,08-30-2021 5:32:29
2021-08-30,6:30 PM,3,5,6,2,0,16,08-30-2021 6:34:48
2021-08-30,7:30 PM,2,1,6,2,0,11,08-30-2021 7:34:32
2021-08-30,8:30 PM,1,4,0,1,1,7,08-30-2021 8:30:00
2021-08-31,6:30 PM,2,0,0,1,0,3,08-31-2021 6:28:13
2021-08-31,7:30 PM,0,0,0,1,1,2,08-31-2021 7:23:38
2021-08-31,8:30 PM,0,0,0,0,0,0,08-31-2021 8:28:52
2021-09-01,5:30 PM,6,3,5,2,3,19,09-01-2021 5:33:32
2021-09-01,6:30 PM,0,1,2,1,1,5,09-01-2021 6:27:44
2021-09-01,7:30 PM,0,0,0,2,1,3,09-01-2021 7:33:38
2021-09-02,6:30 PM,6,2,0,2,0,10,09-02-2021 5:31:18
2021-09-02,5:30 PM,6,2,0,2,0,10,09-02-2021 5:32:03
2021-09-02,6:30 PM,3,1,0,0,2,6,09-02-2021 6:32:54
2021-09-02,7:30 PM,2,1,0,0,2,5,09-02-2021 7:29:11
2021-09-02,8:30 PM,1,0,0,1,0,2,09-02-2021 8:30:43
2021-09-04,10:30 AM,0,0,0,0,0,0,09-04-2021 10:29:08
2021-09-04,12:30 PM,0,0,0,1,0,1,09-04-2021 11:52:18
2021-09-04,12:30 PM,1,0,0,1,0,2,09-04-2021 12:25:59
2021-09-04,1:30 PM,0,2,1,0,0,3,09-04-2021 1:27:07
2021-09-07,5:30 PM,6,3,7,5,5,26,09-07-2021 5:32:45
2021-09-07,6:30 PM,3,0,4,1,1,9,09-07-2021 6:29:45
2021-09-07,7:30 PM,2,0,0,1,0,3,09-07-2021 7:49:07
2021-09-07,8:30 PM,1,0,0,0,0,1,09-07-2021 8:28:55
2021-09-08,5:30 PM,12,7,2,3,5,29,09-08-2021 5:30:16
2021-09-08,6:30 PM,2,3,0,2,3,10,09-08-2021 6:31:04
2021-09-08,7:30 PM,1,3,0,3,0,7,09-08-2021 7:28:13
2021-09-08,8:30 PM,1,2,1,2,0,6,09-08-2021 8:29:53
2021-09-09,5:30 PM,5,4,2,3,5,19,09-09-2021 5:40:41
2021-09-09,7:30 PM,2,1,2,2,0,7,09-09-2021 7:28:21
2021-09-09,8:30 PM,2,1,0,0,0,3,09-09-2021 8:32:19
2021-09-11,10:30 AM,1,1,2,1,1,6,09-11-2021 10:34:57
2021-09-11,12:30 PM,4,1,2,3,1,11,09-11-2021 11:35:32
2021-09-11,12:30 PM,6,2,2,2,0,12,09-11-2021 12:26:48
2021-09-13,5:30 PM,3,1,3,0,1,8,09-13-2021 5:29:42
2021-09-13,6:30 PM,3,2,1,1,1,8,09-13-2021 6:32:48
2021-09-13,7:30 PM,1,1,0,1,0,3,09-13-2021 7:31:24
2021-09-13,8:30 PM,0,0,0,3,0,3,09-13-2021 8:53:20
2021-09-15,7:30 PM,2,2,0,1,0,5,09-15-2021 7:34:04
2021-09-16,5:30 PM,8,0,3,1,2,14,09-16-2021 5:36:10
2021-09-16,6:30 PM,2,0,1,1,1,5,09-16-2021 6:47:58
2021-09-16,7:30 PM,2,2,0,2,0,6,09-16-2021 7:49:13
2021-09-16,8:30 PM,2,0,0,1,0,3,09-16-2021 8:32:07
2021-09-18,10:30 AM,0,0,0,1,0,1,09-18-2021 10:33:15
2021-09-18,11:30 AM,1,0,0,1,0,2,09-18-2021 11:27:39
2021-09-18,12:30 PM,1,0,0,1,0,2,09-18-2021 12:25:02
2021-09-20,5:30 PM,5,3,6,2,0,16,09-20-2021 5:34:17
2021-09-20,6:30 PM,2,3,3,0,2,10,09-20-2021 6:34:15
2021-09-20,7:30 PM,2,3,2,0,1,8,09-20-2021 7:30:08
2021-09-21,5:30 PM,6,7,3,1,5,22,09-21-2021 5:25:59
2021-09-21,6:30 PM,2,2,1,1,0,6,09-21-2021 6:25:08
2021-09-21,7:30 PM,0,0,1,1,0,2,09-21-2021 7:36:23
2021-09-21,8:30 PM,0,0,1,1,0,2,09-21-2021 8:30:46
2021-09-22,7:30 PM,2,1,12,2,0,17,09-22-2021 7:39:47
2021-09-23,7:30 PM,0,0,0,2,0,2,09-23-2021 7:49:52
2021-09-23,8:30 PM,0,0,0,1,0,1,09-23-2021 8:35:42
2021-09-25,10:30 AM,0,0,0,0,0,0,09-25-2021 10:29:01
2021-09-25,1:30 PM,3,1,0,0,0,4,09-25-2021 1:33:31
2021-09-27,5:30 PM,5,2,2,4,3,16,09-27-2021 5:50:21
2021-09-27,6:30 PM,1,1,2,3,2,9,09-27-2021 6:47:05
2021-09-27,7:30 PM,1,2,2,0,0,5,09-27-2021 7:32:01
2021-09-27,8:30 PM,1,0,0,0,0,1,09-27-2021 8:39:07
2021-09-28,5:30 PM,2,7,7,3,1,20,09-28-2021 5:27:22
2021-09-29,5:30 PM,8,4,3,2,2,19,09-29-2021 5:32:12
2021-09-29,6:30 PM,4,0,3,1,1,9,09-29-2021 6:33:08
2021-09-29,7:30 PM,4,0,2,1,1,8,09-29-2021 7:28:35
2021-09-30,6:30 PM,3,0,3,1,0,7,09-30-2021 6:32:46
2021-09-30,7:30 PM,1,2,1,1,0,5,09-30-2021 7:33:43
2021-09-30,8:30 PM,0,0,1,2,1,4,09-30-2021 8:36:47
2021-10-02,10:30 AM,1,0,0,0,0,1,10-02-2021 10:32:32
2021-10-02,11:30 AM,2,3,0,1,0,6,10-02-2021 11:29:57
2021-10-02,12:30 PM,3,3,0,1,0,7,10-02-2021 12:25:33
2021-10-02,1:30 PM,2,0,0,1,0,3,10-02-2021 1:37:51
2021-10-04,6:30 PM,3,1,2,1,1,8,10-04-2021 6:23:47
2021-10-04,7:30 PM,5,2,11,1,0,19,10-04-2021 7:22:32
2021-10-04,8:30 PM,2,0,4,0,0,6,10-04-2021 8:28:23
2021-10-05,6:30 PM,1,2,12,1,0,16,10-05-2021 6:37:21
2021-10-05,7:30 PM,1,1,7,1,0,10,10-05-2021 7:36:19
2021-10-06,5:30 PM,2,1,2,1,1,7,10-06-2021 5:34:05
2021-10-06,6:30 PM,1,0,1,1,0,3,10-06-2021 6:38:16
2021-10-06,7:30 PM,4,0,4,2,0,10,10-06-2021 7:38:04
2021-10-06,8:30 PM,1,1,2,0,0,4,10-06-2021 8:31:39
2021-10-06,8:30 PM,1,0,2,1,0,4,10-06-2021 8:35:41
2021-10-07,5:30 PM,7,1,1,3,0,12,10-07-2021 5:33:09
2021-10-07,6:30 PM,0,0,6,1,0,7,10-07-2021 6:37:35
2021-10-07,7:30 PM,3,0,1,1,1,6,10-07-2021 7:38:27
2021-10-07,8:30 PM,0,0,0,0,0,0,10-07-2021 8:35:24
2021-10-09,12:30 PM,2,0,0,1,0,3,10-09-2021 12:38:23
2021-10-11,7:30 PM,5,2,5,1,0,13,10-11-2021 7:26:58
2021-10-11,8:30 PM,0,0,1,0,0,1,10-11-2021 8:37:09
2021-10-12,6:30 PM,1,4,2,1,1,9,10-12-2021 6:24:18
2021-10-12,7:30 PM,2,1,0,2,0,5,10-12-2021 7:29:10
2021-10-13,6:30 PM,1,2,2,4,0,9,10-13-2021 6:27:12
2021-10-13,7:30 PM,4,1,1,0,3,9,10-13-2021 7:26:38
2021-10-14,5:30 PM,6,0,0,2,2,10,10-14-2021 5:30:39
2021-10-14,6:30 PM,4,1,0,0,0,5,10-14-2021 6:28:15
2021-10-14,7:30 PM,2,2,1,1,0,6,10-14-2021 7:31:24
2021-10-14,8:30 PM,0,0,1,0,0,1,10-14-2021 8:34:09
2021-10-16,10:30 AM,0,0,1,0,0,1,10-16-2021 11:28:15
2021-10-16,11:30 AM,0,0,1,0,0,1,10-16-2021 11:28:25
2021-10-16,12:30 PM,1,0,0,0,0,1,10-16-2021 12:28:54
2021-10-18,6:30 PM,8,1,6,2,1,18,10-18-2021 7:15:43
2021-10-18,7:30 PM,5,0,1,1,0,7,10-18-2021 7:42:36
2021-10-18,8:30 PM,3,0,0,0,0,3,10-18-2021 8:35:19
2021-10-19,6:30 PM,4,0,0,1,0,5,10-19-2021 6:43:18
2021-10-19,7:30 PM,0,0,0,0,0,0,10-19-2021 7:37:31
2021-10-19,8:30 PM,1,0,0,0,0,1,10-19-2021 8:32:57
2021-10-20,6:30 PM,4,0,1,1,1,7,10-20-2021 7:31:20
2021-10-20,7:30 PM,1,0,1,1,0,3,10-20-2021 7:31:32
2021-10-21,5:30 PM,2,1,1,0,2,6,10-21-2021 6:07:43
2021-10-21,6:30 PM,2,0,1,0,2,5,10-21-2021 7:02:57
2021-10-21,7:30 PM,2,0,0,0,0,2,10-21-2021 7:33:10
2021-10-21,8:30 PM,3,0,0,0,0,3,10-21-2021 8:24:48
2021-10-26,10:30 AM,10,12,4,3,2,31,2021-10-26T15:44:40.727Z
2021-10-26,11:30 AM,5,10,4,4,1,24,2021-10-26T16:26:09.117Z
2021-10-27,8:30 AM,3,2,1,1,2,9,2021-10-27T13:54:11.406Z
2021-10-27,9:30 AM,3,6,2,4,2,17,2021-10-27T15:00:59.402Z
2021-10-27,10:30 AM,4,8,1,3,2,18,2021-10-27T15:36:11.532Z
2021-10-27,11:30 AM,2,3,3,4,1,13,2021-10-27T16:31:06.417Z
2021-10-28,8:30 AM,3,5,0,1,2,11,2021-10-28T14:34:59.208Z
2021-10-28,9:30 AM,5,8,2,3,2,20,2021-10-28T14:39:13.326Z
2021-10-28,10:30 AM,8,22,6,6,2,44,2021-10-28T15:39:58.980Z
2021-10-28,11:30 AM,6,24,12,6,4,52,2021-10-28T16:33:06.856Z
2021-10-28,5:30 PM,5,1,0,3,1,10,2021-10-28T22:32:26.144Z
2021-10-28,6:30 PM,2,0,2,1,0,5,2021-10-28T23:28:55.315Z
2021-10-28,6:30 PM,2,0,2,1,0,5,2021-10-28T23:29:21.737Z
2021-10-28,7:30 PM,1,0,0,1,0,2,2021-10-29T00:24:00.084Z
2021-10-28,8:30 PM,0,0,0,0,0,0,2021-10-29T01:33:31.815Z
2021-10-29,8:30 AM,2,2,1,1,2,8,2021-10-29T15:18:50.139Z
2021-10-29,9:30 AM,2,1,2,1,2,8,2021-10-29T15:19:05.305Z
2021-10-29,10:30 AM,2,4,2,2,3,13,2021-10-29T15:19:14.633Z
2021-10-29,11:30 AM,5,1,6,1,2,15,2021-10-29T16:36:41.194Z
2021-10-30,10:30 AM,1,0,0,0,0,1,2021-10-30T15:38:42.518Z
2021-10-30,11:30 AM,0,0,0,1,0,1,2021-10-30T16:21:14.480Z
2021-10-30,12:30 PM,1,0,0,1,0,2,2021-10-30T17:36:38.200Z
2021-10-30,1:30 PM,0,0,0,0,0,0,2021-10-30T18:22:38.033Z
2021-11-01,8:30 AM,4,8,0,3,2,17,2021-11-01T13:31:55.776Z
2021-11-01,10:30 AM,5,8,12,6,2,33,2021-11-01T15:31:23.302Z
2021-11-01,11:30 AM,6,10,12,5,4,37,2021-11-01T16:26:30.673Z
2021-11-01,5:30 PM,5,2,0,2,0,9,2021-11-01T22:43:13.725Z
2021-11-01,6:30 PM,0,0,1,1,0,2,2021-11-01T23:36:00.810Z
2021-11-01,7:30 PM,0,0,1,1,0,2,2021-11-02T00:20:41.098Z
2021-11-01,8:30 PM,1,0,0,0,0,1,2021-11-02T01:40:09.501Z
2021-11-02,8:30 AM,5,5,3,2,2,17,2021-11-02T15:25:21.996Z
2021-11-02,9:30 AM,6,5,4,4,5,24,2021-11-02T15:25:34.398Z
2021-11-02,10:30 AM,6,10,8,6,2,32,2021-11-02T15:25:56.660Z
2021-11-02,11:30 AM,6,15,8,6,3,38,2021-11-02T16:20:00.819Z
2021-11-02,12:30 PM,11,15,2,11,0,39,2021-11-02T17:05:30.214Z
2021-11-02,1:30 PM,5,8,4,2,0,19,2021-11-02T18:10:20.717Z
2021-11-02,3:30 PM,6,6,2,4,0,18,2021-11-02T20:08:20.617Z
2021-11-02,5:30 PM,6,1,4,2,0,13,2021-11-02T22:24:52.766Z
2021-11-02,6:30 PM,2,2,20,1,0,25,2021-11-02T23:47:53.192Z
2021-11-02,7:30 PM,1,2,18,0,0,21,2021-11-03T00:31:53.498Z
2021-11-02,8:30 PM,0,1,10,0,0,11,2021-11-03T01:36:04.670Z
2021-11-03,8:30 AM,3,4,1,4,1,13,2021-11-03T15:47:47.182Z
2021-11-03,9:30 AM,4,6,2,3,1,16,2021-11-03T15:48:10.791Z
2021-11-03,10:30 AM,8,12,6,6,2,34,2021-11-03T15:48:31.706Z
2021-11-03,11:30 AM,8,6,5,4,2,25,2021-11-03T16:43:20.789Z
2021-11-03,7:30 PM,4,2,4,3,0,13,2021-11-04T00:36:46.751Z
2021-11-03,8:30 PM,0,1,0,1,0,2,2021-11-04T01:33:31.191Z
2021-11-04,8:30 AM,4,2,3,2,2,13,2021-11-04T14:21:44.869Z
2021-11-04,9:30 AM,4,10,3,1,2,20,2021-11-04T14:21:56.329Z
2021-11-04,12:30 PM,5,10,2,3,0,20,2021-11-04T17:04:54.335Z
2021-11-04,5:30 PM,6,2,3,2,2,15,2021-11-04T22:44:17.091Z
2021-11-04,6:30 PM,1,0,2,1,1,5,2021-11-04T23:27:43.473Z
2021-11-04,7:30 PM,2,1,2,1,0,6,2021-11-05T00:34:31.490Z
2021-11-05,8:30 AM,2,0,0,1,0,3,2021-11-05T13:41:15.910Z
2021-11-06,10:30 AM,2,0,0,1,0,3,2021-11-06T15:34:48.703Z
2021-11-06,11:30 AM,1,0,2,1,0,4,2021-11-06T16:48:06.391Z
2021-11-06,12:30 PM,3,0,2,2,0,7,2021-11-06T17:34:11.911Z
2021-11-06,1:30 PM,2,0,2,1,0,5,2021-11-06T18:28:53.654Z
2021-11-08,8:30 AM,3,5,1,5,2,16,2021-11-08T15:27:38.728Z
2021-11-08,9:30 AM,15,3,2,3,1,24,2021-11-08T15:28:16.217Z
2021-11-08,5:30 PM,3,0,2,2,2,9,2021-11-08T23:39:42.256Z
2021-11-08,6:30 PM,3,0,2,1,0,6,2021-11-09T00:25:13.922Z
2021-11-08,7:30 PM,1,0,0,1,0,2,2021-11-09T02:00:53.090Z
2021-11-08,8:30 PM,1,0,0,0,0,1,2021-11-09T02:36:58.093Z
2021-11-09,9:30 AM,1,4,2,2,3,12,2021-11-09T15:00:54.882Z
2021-11-09,9:30 AM,8,8,4,3,2,25,2021-11-09T15:46:00.107Z
2021-11-09,5:30 PM,4,3,7,2,0,16,2021-11-09T23:29:05.026Z
2021-11-09,6:30 PM,3,1,2,1,0,7,2021-11-10T00:34:28.432Z
2021-11-09,7:30 PM,2,0,0,1,0,3,2021-11-10T01:47:47.405Z
2021-11-10,8:30 AM,5,8,1,3,2,19,2021-11-10T15:26:20.718Z
2021-11-10,9:30 AM,2,3,0,2,5,12,2021-11-10T15:26:44.783Z
2021-11-10,10:30 AM,5,3,2,6,1,17,2021-11-10T17:30:48.544Z
2021-11-10,11:30 AM,8,15,3,6,2,34,2021-11-10T17:31:04.070Z
2021-11-10,5:30 PM,7,0,2,1,0,10,2021-11-10T23:31:21.583Z
2021-11-10,6:30 PM,2,0,1,1,0,4,2021-11-11T00:45:51.917Z
2021-11-11,8:30 AM,2,1,1,1,1,6,2021-11-11T14:34:12.347Z
2021-11-11,9:30 AM,7,8,2,3,2,22,2021-11-11T15:29:22.821Z
2021-11-11,6:30 PM,1,1,1,0,1,4,2021-11-12T00:31:36.011Z
2021-11-11,7:30 PM,1,0,0,0,1,2,2021-11-12T01:38:50.148Z
2021-11-11,8:30 PM,1,0,0,1,1,3,2021-11-12T02:26:19.013Z
2021-11-13,10:30 AM,2,0,0,0,0,2,2021-11-13T16:43:06.351Z
2021-11-13,11:30 AM,1,1,0,1,0,3,2021-11-13T17:25:31.182Z
2021-11-13,12:30 PM,0,2,0,2,0,4,2021-11-13T18:33:45.510Z
2021-11-13,1:30 PM,0,0,0,0,0,0,2021-11-13T19:51:46.014Z
2021-11-15,8:30 AM,2,4,1,1,2,10,2021-11-15T15:36:38.081Z
2021-11-15,9:30 AM,5,8,4,2,2,21,2021-11-15T15:36:53.558Z
2021-11-15,10:30 AM,8,12,10,3,2,35,2021-11-15T16:48:53.215Z
2021-11-15,5:30 PM,5,1,4,2,0,12,2021-11-15T23:49:34.476Z
2021-11-15,6:30 PM,1,0,3,1,1,6,2021-11-16T00:32:35.862Z
2021-11-15,7:30 PM,1,0,10,1,0,12,2021-11-16T01:27:00.569Z
2021-11-15,8:30 PM,0,0,0,1,0,1,2021-11-16T02:47:04.518Z
2021-11-16,8:30 AM,3,2,2,1,1,9,2021-11-16T15:03:57.745Z
2021-11-16,9:30 AM,5,8,2,2,1,18,2021-11-16T15:36:51.977Z
2021-11-16,10:30 AM,8,6,15,4,2,35,2021-11-16T16:24:16.561Z
2021-11-16,11:30 AM,12,8,10,5,4,39,2021-11-16T17:19:58.617Z
2021-11-16,5:30 PM,6,2,6,1,0,15,2021-11-16T23:39:08.761Z
2021-11-16,6:30 PM,1,3,2,2,0,8,2021-11-17T00:41:16.344Z
2021-11-16,7:30 PM,1,0,2,1,0,4,2021-11-17T01:30:35.654Z
2021-11-16,8:30 PM,0,0,2,1,1,4,2021-11-17T02:27:42.597Z
2021-11-17,8:30 AM,1,2,2,2,3,10,2021-11-17T14:31:07.485Z
2021-11-17,9:30 AM,3,12,4,6,2,27,2021-11-17T15:34:28.234Z
2021-11-17,10:30 AM,4,3,2,6,3,18,2021-11-17T16:40:29.327Z
2021-11-17,11:30 AM,3,3,2,3,1,12,2021-11-17T17:33:09.891Z
2021-11-17,5:30 PM,2,0,4,2,1,9,2021-11-17T23:37:51.291Z
2021-11-17,6:30 PM,1,0,5,1,1,8,2021-11-18T00:34:47.773Z
2021-11-17,7:30 PM,2,0,3,0,0,5,2021-11-18T01:34:31.734Z
2021-11-17,8:30 PM,0,0,2,1,0,3,2021-11-18T02:34:28.461Z
2021-11-18,8:30 AM,4,3,1,1,2,11,2021-11-18T15:31:36.537Z
2021-11-18,9:30 AM,3,8,1,4,2,18,2021-11-18T15:31:49.196Z
2021-11-18,11:30 AM,5,12,4,8,2,31,2021-11-18T17:24:16.789Z
2021-11-18,5:30 PM,10,2,0,2,1,15,2021-11-18T23:34:11.856Z
2021-11-18,6:30 PM,1,1,1,1,0,4,2021-11-19T00:40:04.342Z
2021-11-19,8:30 AM,2,2,0,1,1,6,2021-11-19T15:47:51.979Z
2021-11-19,9:30 AM,4,2,1,3,1,11,2021-11-19T16:29:49.612Z
2021-11-19,10:30 AM,2,4,0,3,1,10,2021-11-19T16:32:53.481Z
2021-11-22,8:30 AM,2,2,1,2,1,8,2021-11-22T15:01:25.347Z
2021-11-22,9:30 AM,3,8,4,3,2,20,2021-11-22T15:26:42.681Z
2021-11-22,6:30 PM,0,0,4,0,1,5,2021-11-23T00:29:09.258Z
2021-11-22,7:30 PM,1,0,3,1,0,5,2021-11-23T01:37:29.569Z
2021-11-22,8:30 PM,4,0,3,4,0,11,2021-11-23T02:32:51.281Z
2021-11-23,8:30 AM,2,1,2,1,1,7,2021-11-23T15:15:36.357Z
2021-11-23,9:30 AM,4,8,2,3,2,19,2021-11-23T15:15:53.250Z
2021-11-23,10:30 AM,1,1,4,2,2,10,2021-11-23T16:13:09.112Z
2021-11-23,11:30 AM,5,8,4,2,3,22,2021-11-23T17:22:01.232Z
2021-11-23,12:30 PM,6,8,5,4,0,23,2021-11-23T18:36:54.106Z
2021-11-23,1:30 PM,1,5,4,3,0,13,2021-11-23T19:42:51.518Z
2021-11-23,5:30 PM,0,0,1,0,0,1,2021-11-23T23:37:17.451Z
2021-11-23,6:30 PM,1,0,1,0,1,3,2021-11-24T00:40:02.721Z
2021-11-23,8:30 PM,0,0,0,0,0,0,2021-11-24T02:32:33.488Z
2021-11-29,10:30 AM,9,8,4,2,3,26,2021-11-29T16:43:42.297Z
2021-11-29,11:30 AM,8,9,2,6,4,29,2021-11-29T17:40:09.124Z
2021-11-29,12:30 PM,6,5,2,6,5,24,2021-11-29T18:44:17.594Z
2021-11-29,5:30 PM,2,5,3,2,1,13,2021-11-29T23:28:56.524Z
2021-11-29,6:30 PM,0,0,3,2,1,6,2021-11-30T01:03:46.939Z
2021-11-29,7:30 PM,1,0,2,1,0,4,2021-11-30T01:41:53.079Z
2021-11-29,8:30 PM,2,0,2,1,0,5,2021-11-30T02:31:52.647Z
2021-11-30,8:30 AM,3,1,4,2,1,11,2021-11-30T14:28:42.656Z
2021-11-30,9:30 AM,5,5,3,3,1,17,2021-11-30T15:34:42.427Z
2021-11-30,10:30 AM,8,6,8,2,0,24,2021-11-30T16:23:36.241Z
2021-11-30,11:30 AM,4,2,7,5,1,19,2021-11-30T17:41:23.487Z
2021-11-30,12:30 PM,10,3,5,9,5,32,2021-11-30T18:39:54.779Z
2021-11-30,5:30 PM,6,1,3,2,0,12,2021-11-30T23:53:23.205Z
2021-11-30,6:30 PM,3,2,3,1,0,9,2021-12-01T00:22:54.369Z
2021-11-30,7:30 PM,1,0,0,0,0,1,2021-12-01T01:25:43.158Z
2021-11-30,8:30 PM,2,0,0,0,0,2,2021-12-01T02:31:22.154Z
2021-12-01,5:30 PM,1,0,2,2,2,7,2021-12-01T23:38:40.543Z
2021-12-01,6:30 PM,3,0,1,1,0,5,2021-12-02T00:36:47.940Z
2021-12-01,7:30 PM,2,0,1,1,0,4,2021-12-02T01:40:00.105Z
2021-12-01,8:30 PM,1,0,1,0,0,2,2021-12-02T02:30:53.466Z
2021-12-02,8:30 AM,2,1,1,1,1,6,2021-12-02T16:12:26.353Z
2021-12-02,9:30 AM,4,5,2,2,2,15,2021-12-02T16:12:38.000Z
2021-12-02,10:30 AM,8,2,1,3,2,16,2021-12-02T16:12:50.319Z
2021-12-02,5:30 PM,6,2,1,2,1,12,2021-12-02T23:34:55.707Z
2021-12-02,6:30 PM,2,1,3,1,0,7,2021-12-03T00:39:34.236Z
2021-12-02,7:30 PM,0,0,2,1,0,3,2021-12-03T01:28:31.636Z
2021-12-02,8:30 PM,0,0,2,0,0,2,2021-12-03T02:31:58.150Z
2021-12-03,8:30 AM,1,2,1,1,2,7,2021-12-03T16:24:22.999Z
2021-12-03,9:30 AM,3,2,2,3,1,11,2021-12-03T16:24:33.437Z
2021-12-03,10:30 AM,5,8,2,2,3,20,2021-12-03T16:24:43.931Z
2021-12-03,11:30 AM,4,1,2,2,1,10,2021-12-03T17:25:56.893Z
2021-12-04,10:30 AM,0,1,0,1,1,3,2021-12-04T16:43:49.381Z
2021-12-04,11:30 AM,0,1,0,2,0,3,2021-12-04T17:33:49.111Z
2021-12-04,12:30 PM,1,1,0,1,0,3,2021-12-04T18:36:15.049Z
2021-12-04,1:30 PM,1,3,0,1,0,5,2021-12-04T19:35:29.238Z
2021-12-06,8:30 AM,3,2,2,2,1,10,2021-12-06T15:30:20.022Z
2021-12-06,9:30 AM,5,2,2,3,3,15,2021-12-06T15:30:34.728Z
2021-12-06,10:30 AM,6,4,5,3,1,19,2021-12-06T17:43:43.770Z
2021-12-06,11:30 PM,6,3,3,4,1,17,2021-12-06T18:05:48.874Z
2021-12-06,1:30 PM,7,2,6,2,1,18,2021-12-06T19:45:49.505Z
2021-12-06,5:30 PM,4,8,5,2,1,20,2021-12-06T23:41:05.940Z
2021-12-06,6:30 PM,1,1,4,2,0,8,2021-12-07T00:31:19.991Z
2021-12-06,7:30 PM,2,1,2,1,0,6,2021-12-07T02:03:30.227Z
2021-12-07,8:30 AM,2,2,1,2,1,8,2021-12-07T17:21:19.853Z
2021-12-07,9:30 AM,4,3,3,5,2,17,2021-12-07T17:21:36.848Z
2021-12-07,11:30 AM,6,2,4,3,5,20,2021-12-07T17:21:49.431Z
2021-12-07,5:30 PM,4,5,2,2,0,13,2021-12-07T23:50:03.853Z
2021-12-07,7:30 PM,2,3,2,0,0,7,2021-12-08T01:18:27.334Z
2021-12-08,8:30 AM,1,1,2,2,1,7,2021-12-08T16:30:34.486Z
2021-12-08,9:30 AM,4,1,4,2,1,12,2021-12-08T16:30:46.891Z
2021-12-08,10:30 AM,4,5,4,5,45,63,2021-12-08T16:30:58.165Z
2021-12-08,10:30 AM,4,5,5,4,4,22,2021-12-08T16:37:55.845Z
2021-12-08,5:30 PM,1,1,3,1,0,6,2021-12-08T23:34:53.758Z
2021-12-08,6:30 PM,2,1,4,1,1,9,2021-12-09T00:25:51.974Z
2021-12-08,7:30 PM,1,1,2,1,1,6,2021-12-09T01:48:36.325Z
2021-12-08,8:30 PM,0,0,1,0,0,1,2021-12-09T02:32:25.229Z
2021-12-09,8:30 AM,4,2,2,2,2,12,2021-12-09T15:26:47.242Z
2021-12-09,9:30 AM,5,2,1,2,3,13,2021-12-09T15:26:56.402Z
2021-12-09,11:30 AM,5,8,3,3,3,22,2021-12-09T17:29:19.027Z
2021-12-09,5:30 PM,4,1,0,2,1,8,2021-12-09T23:40:36.068Z
2021-12-09,6:30 PM,5,0,0,1,1,7,2021-12-10T00:31:53.367Z
2021-12-09,7:30 PM,3,0,0,0,2,5,2021-12-10T01:31:09.325Z
2021-12-09,8:30 PM,2,0,0,0,0,2,2021-12-10T02:44:47.242Z
2021-12-10,8:30 AM,1,0,0,1,1,3,2021-12-10T15:36:44.203Z
2021-12-10,9:30 AM,2,1,0,1,1,5,2021-12-10T15:36:52.298Z
2021-12-11,10:30 AM,0,0,0,0,0,0,2021-12-11T16:36:27.340Z
2021-12-11,11:30 AM,0,0,0,0,0,0,2021-12-11T17:36:18.658Z
2021-12-11,12:30 PM,0,1,0,0,0,1,2021-12-11T18:40:01.141Z
2021-12-13,8:30 AM,1,1,0,1,0,3,2021-12-13T15:14:22.670Z
2021-12-13,9:30 AM,3,2,0,3,1,9,2021-12-13T15:14:42.486Z
2021-12-13,2:30 PM,3,0,1,2,1,7,2021-12-13T20:31:55.185Z
2021-12-13,3:30 PM,0,0,1,1,0,2,2021-12-13T21:26:59.791Z
2021-12-14,8:30 AM,1,0,0,1,0,2,2021-12-14T15:56:50.280Z
2021-12-14,9:30 AM,2,1,1,0,0,4,2021-12-14T15:56:58.513Z
2021-12-14,10:30 AM,3,1,2,0,0,6,2021-12-14T15:57:13.259Z
2021-12-14,10:30 AM,2,2,1,1,1,7,2021-12-14T16:38:07.682Z
2021-12-14,11:30 AM,0,0,0,0,0,0,2021-12-14T17:29:13.042Z
2021-12-14,2:30 PM,2,0,0,0,0,2,2021-12-14T20:30:37.515Z
2021-12-14,4:30 PM,3,0,0,0,0,3,2021-12-14T22:29:05.735Z
2021-12-15,8:30 AM,1,0,0,1,0,2,2021-12-15T15:31:53.651Z
2021-12-15,9:30 AM,4,1,0,1,1,7,2021-12-15T15:32:03.339Z
2021-12-15,2:30 PM,2,1,1,1,0,5,2021-12-15T21:24:48.241Z
2021-12-15,3:30 PM,1,0,1,0,0,2,2021-12-15T21:24:59.576Z
2021-12-15,4:30 PM,1,0,0,0,0,1,2021-12-15T22:37:33.949Z
2021-12-15,5:30 PM,1,0,0,0,0,1,2021-12-15T23:29:37.558Z
2021-12-16,8:30 AM,0,0,1,1,0,2,2021-12-16T14:56:22.808Z
2021-12-16,9:30 AM,0,0,1,0,0,1,2021-12-16T15:36:44.032Z
2021-12-16,4:30 PM,1,0,1,0,0,2,2021-12-16T22:37:52.100Z
2021-12-16,5:30 PM,0,0,1,0,0,1,2021-12-16T23:40:10.053Z
2021-12-17,8:30 AM,1,1,0,0,0,2,2021-12-17T15:39:07.514Z
2021-12-17,9:30 AM,0,1,0,0,0,1,2021-12-17T15:39:15.836Z
2021-12-17,1:30 PM,0,0,0,1,0,1,2021-12-17T19:18:02.657Z
2021-12-17,12:30 PM,0,0,0,1,0,1,2021-12-17T19:18:19.159Z
2021-12-17,2:30 PM,3,0,0,0,0,3,2021-12-17T21:11:19.666Z
2021-12-17,4:30 PM,0,0,0,0,0,0,2021-12-17T22:43:10.063Z
2021-12-20,2:30 PM,0,0,0,0,0,0,2021-12-20T20:29:41.693Z
2021-12-20,3:30 PM,4,0,0,1,0,5,2021-12-20T21:29:34.459Z
2021-12-20,4:30 PM,3,0,0,0,0,3,2021-12-20T22:34:28.469Z
2021-12-20,5:30 PM,0,0,0,1,0,1,2021-12-20T23:31:56.881Z
2021-12-21,3:30 PM,0,0,0,1,0,1,2021-12-21T21:23:35.596Z
2021-12-21,4:30 PM,3,0,0,0,0,3,2021-12-21T22:27:40.779Z
2021-12-21,5:30 PM,3,0,0,0,0,3,2021-12-21T23:23:39.920Z
2022-01-03,8:30 AM,1,0,0,0,0,1,2022-01-03T16:14:28.740Z
2022-01-03,9:30 AM,1,0,1,0,0,2,2022-01-03T16:14:40.022Z
2022-01-03,2:30 PM,2,0,0,0,0,2,2022-01-03T20:43:42.321Z
2022-01-03,3:30 PM,1,0,0,0,0,1,2022-01-03T21:40:44.431Z
2022-01-03,4:30 PM,0,0,0,0,0,0,2022-01-03T22:34:00.484Z
2022-01-03,5:30 PM,1,0,0,0,0,1,2022-01-03T23:28:59.480Z
2022-01-04,8:30 AM,1,0,1,0,0,2,2022-01-04T15:10:54.957Z
2022-01-04,9:30 AM,2,1,1,0,0,4,2022-01-04T15:11:03.140Z
2022-01-04,10:30 AM,3,0,1,1,1,6,2022-01-04T16:51:15.919Z
2022-01-04,11:30 AM,4,2,1,1,1,9,2022-01-04T17:10:07.347Z
2022-01-04,2:30 PM,1,0,1,0,0,2,2022-01-04T20:31:24.621Z
2022-01-04,3:30 PM,1,1,0,0,0,2,2022-01-04T22:02:41.762Z
2022-01-04,4:30 PM,1,0,0,0,0,1,2022-01-04T22:29:29.241Z
2022-01-04,5:30 PM,2,0,0,0,0,2,2022-01-04T23:32:05.351Z
2022-01-05,2:30 PM,2,0,1,1,1,5,2022-01-05T20:36:04.838Z
2022-01-05,3:30 PM,0,0,1,1,0,2,2022-01-05T21:29:17.963Z
2022-01-05,4:30 PM,0,0,0,1,0,1,2022-01-05T22:37:22.566Z
2022-01-06,8:30 AM,1,0,0,0,0,1,2022-01-06T15:36:00.899Z
2022-01-06,9:30 AM,0,0,0,0,0,0,2022-01-06T15:36:13.090Z
2022-01-06,10:30 AM,1,1,0,0,0,2,2022-01-06T17:36:19.093Z
2022-01-06,11:30 AM,0,0,0,0,0,0,2022-01-06T17:36:31.742Z
2022-01-06,2:30 PM,0,0,0,0,0,0,2022-01-06T20:26:56.887Z
2022-01-06,3:30 PM,1,1,0,0,0,2,2022-01-06T21:32:02.520Z
2022-01-06,5:30 PM,0,0,0,0,0,0,2022-01-06T23:27:54.571Z
2022-01-07,7:30 AM,0,0,0,0,0,0,2022-01-07T13:32:01.464Z
2022-01-07,8:30 AM,0,0,0,0,0,0,2022-01-07T14:32:19.802Z
2022-01-07,9:30 AM,0,0,0,0,0,0,2022-01-07T15:27:37.712Z
2022-01-07,9:30 AM,0,0,0,0,0,0,2022-01-07T15:47:39.386Z
2022-01-07,10:30 AM,0,0,0,0,0,0,2022-01-07T16:41:12.608Z
2022-01-10,8:30 AM,2,0,0,0,0,2,2022-01-10T15:36:15.114Z
2022-01-10,9:30 AM,2,0,0,1,0,3,2022-01-10T15:36:23.457Z
2022-01-10,11:30 AM,2,0,3,1,1,7,2022-01-10T19:00:13.882Z
2022-01-10,10:30 AM,2,0,3,1,1,7,2022-01-10T19:00:42.696Z
2022-01-10,2:30 PM,3,0,2,1,0,6,2022-01-10T20:43:16.347Z
2022-01-10,3:30 PM,1,0,4,0,0,5,2022-01-10T21:27:43.083Z
2022-01-10,4:30 PM,0,0,0,0,0,0,2022-01-10T22:30:46.157Z
2022-01-10,5:30 PM,0,0,0,0,0,0,2022-01-10T23:33:28.343Z
2022-01-11,3:30 PM,1,0,1,0,0,2,2022-01-11T21:36:10.805Z
2022-01-11,4:30 PM,1,0,0,1,0,2,2022-01-11T22:39:08.452Z
2022-01-11,5:30 PM,0,0,0,0,0,0,2022-01-11T23:38:29.439Z
2022-01-12,8:30 AM,2,1,0,0,0,3,2022-01-12T15:35:31.776Z
2022-01-12,9:30 AM,2,0,0,0,0,2,2022-01-12T15:36:51.367Z
2022-01-12,2:30 PM,1,1,0,0,0,2,2022-01-12T20:47:55.194Z
2022-01-12,3:30 PM,1,0,0,0,0,1,2022-01-12T21:37:48.756Z
2022-01-12,4:30 PM,0,0,0,0,0,0,2022-01-12T22:33:23.243Z
2022-01-12,5:30 PM,0,0,0,0,0,0,2022-01-12T23:35:54.756Z
2022-01-13,8:30 AM,1,0,0,0,0,1,2022-01-13T16:50:50.626Z
2022-01-13,9:30 AM,2,0,0,0,0,2,2022-01-13T16:51:09.278Z
2022-01-13,12:30 PM,2,0,0,0,0,2,2022-01-13T18:34:26.122Z
2022-01-13,1:30 PM,1,1,0,0,0,2,2022-01-13T19:52:46.056Z
2022-01-13,2:30 PM,1,1,0,0,0,2,2022-01-13T20:47:00.126Z
2022-01-13,3:30 PM,3,2,0,0,0,5,2022-01-13T21:46:24.303Z
2022-01-13,4:30 PM,1,3,0,0,0,4,2022-01-13T22:32:07.312Z
2022-01-14,12:30 PM,2,0,0,0,0,2,2022-01-14T18:17:00.468Z
2022-01-18,8:30 AM,3,1,1,2,2,9,2022-01-18T14:30:05.632Z
2022-01-18,9:30 AM,3,2,4,3,2,14,2022-01-18T15:47:02.344Z
2022-01-18,10:30 AM,10,3,5,4,3,25,2022-01-18T16:55:29.896Z
2022-01-18,11:30 AM,12,5,3,4,3,27,2022-01-18T17:42:19.797Z
2022-01-18,5:30 PM,2,0,0,1,1,4,2022-01-18T23:36:28.483Z
2022-01-18,6:30 PM,3,0,0,1,0,4,2022-01-19T01:16:10.855Z
2022-01-18,7:30 PM,2,1,0,0,1,4,2022-01-19T01:16:28.352Z
2022-01-19,8:30 AM,2,1,6,1,0,10,2022-01-19T14:26:37.709Z
2022-01-19,9:30 AM,12,8,5,5,4,34,2022-01-19T15:47:37.589Z
2022-01-19,12:30 PM,12,7,7,4,0,30,2022-01-19T18:46:00.508Z
2022-01-19,10:30 PM,15,5,4,2,2,28,2022-01-19T19:35:59.548Z
2022-01-19,11:30 PM,15,5,3,5,2,30,2022-01-19T19:36:16.852Z
2022-01-19,1:30 PM,5,2,1,3,3,14,2022-01-19T19:36:59.997Z
2022-01-19,2:30 PM,3,4,0,1,0,8,2022-01-19T20:34:03.164Z
2022-01-19,4:30 PM,3,1,0,0,0,4,2022-01-19T22:27:01.005Z
2022-01-19,4:30 PM,3,0,0,0,1,4,2022-01-19T22:58:13.266Z
2022-01-19,6:30 PM,4,0,0,0,0,4,2022-01-20T00:31:27.547Z
2022-01-19,6:30 PM,4,1,0,0,0,5,2022-01-20T00:36:19.442Z
2022-01-19,8:30 PM,1,0,0,0,0,1,2022-01-20T02:30:04.019Z
2022-01-19,8:30 PM,2,0,0,1,0,3,2022-01-20T02:31:31.174Z
2022-01-20,8:30 AM,3,5,1,2,2,13,2022-01-20T15:14:55.168Z
2022-01-20,9:30 AM,5,3,1,2,2,13,2022-01-20T16:40:51.098Z
2022-01-20,10:30 AM,8,6,1,3,5,23,2022-01-20T16:41:03.922Z
2022-01-20,11:30 AM,22,8,3,2,2,37,2022-01-20T17:50:14.124Z
2022-01-20,11:30 PM,10,10,1,4,5,30,2022-01-20T18:08:51.728Z
2022-01-20,1:30 PM,4,6,3,2,0,15,2022-01-20T19:27:28.660Z
2022-01-20,3:30 PM,6,1,1,3,1,12,2022-01-20T21:19:22.984Z
2022-01-20,4:30 PM,2,1,0,1,0,4,2022-01-20T22:47:35.882Z
2022-01-20,5:30 PM,4,0,2,0,0,6,2022-01-21T00:02:36.978Z
2022-01-20,6:30 PM,2,1,2,1,0,6,2022-01-21T00:30:29.509Z
2022-01-20,7:30 PM,4,0,1,0,0,5,2022-01-21T01:35:52.160Z
2022-01-20,8:30 PM,2,0,0,0,0,2,2022-01-21T02:36:33.917Z
2022-01-21,8:30 AM,1,0,0,2,0,3,2022-01-21T15:15:14.066Z
2022-01-21,12:30 PM,4,2,0,1,0,7,2022-01-21T18:18:55.132Z
2022-01-21,1:30 PM,4,0,0,1,1,6,2022-01-21T19:24:39.132Z
2022-01-21,9:30 AM,2,1,1,2,1,7,2022-01-21T19:27:16.309Z
2022-01-21,10:30 AM,2,1,1,1,2,7,2022-01-21T19:27:45.832Z
2022-01-21,11:30 AM,5,5,0,1,1,12,2022-01-21T19:28:24.487Z
2022-01-21,2:30 PM,4,1,0,1,0,6,2022-01-21T20:31:52.630Z
2022-01-21,3:30 PM,5,1,0,1,0,7,2022-01-21T21:26:20.637Z
2022-01-21,4:30 PM,3,1,0,0,0,4,2022-01-21T22:20:03.447Z
2022-01-22,10:30 AM,3,0,0,1,0,4,2022-01-22T16:38:30.260Z
2022-01-22,11:30 AM,2,0,0,0,0,2,2022-01-22T17:25:00.028Z