Date,Time,Computers,Silent,Quiet,Active,Other,Total,timestamp
2021-08-16,7:30 AM,2,0,0,0,15,17,08-16-2021 7:49:10
2021-08-16,8:30 AM,1,0,1,0,3,5,08-16-2021 8:31:00
2021-08-16,9:30 AM,3,0,2,1,3,9,08-16-2021 9:30:15
2021-08-16,10:30 AM,8,3,1,4,2,18,08-16-2021 10:31:36
2021-08-16,11:30 AM,14,2,2,1,1,20,08-16-2021 11:33:59
2021-08-16,11:30 AM,14,1,2,1,1,19,08-16-2021 11:36:15
2021-08-16,12:30 PM,6,0,1,1,2,10,08-16-2021 12:43:38
2021-08-16,1:30 PM,16,3,2,2,0,23,08-16-2021 1:38:26
2021-08-16,2:30 PM,11,4,2,5,3,25,08-16-2021 2:48:46
2021-08-16,4:30 PM,5,1,2,1,0,9,08-16-2021 4:39:32
2021-08-16,5:30 PM,5,2,1,1,0,9,08-16-2021 5:32:22
2021-08-16,6:30 PM,3,2,2,0,1,8,08-16-2021 6:40:34
2021-08-16,7:30 PM,3,2,0,0,0,5,08-16-2021 7:34:01
2021-08-16,8:30 PM,3,1,0,0,0,4,08-16-2021 8:33:21
2021-08-17,7:30 AM,1,0,0,0,0,1,08-17-2021 7:31:25
2021-08-17,8:30 AM,1,0,0,0,0,1,08-17-2021 8:29:32
2021-08-17,9:30 AM,5,0,2,1,1,9,08-17-2021 9:30:38
2021-08-17,9:30 AM,5,2,4,1,0,12,08-17-2021 9:41:26
2021-08-17,10:30 AM,8,3,6,1,0,18,08-17-2021 10:32:21
2021-08-17,11:30 AM,9,2,7,1,0,19,08-17-2021 11:29:35
2021-08-17,12:30 PM,12,2,6,0,2,22,08-17-2021 12:37:03
2021-08-17,1:30 PM,8,1,4,2,2,17,08-17-2021 1:34:23
2021-08-17,2:30 PM,10,2,8,0,0,20,08-17-2021 2:37:01
2021-08-17,6:30 PM,4,2,1,0,0,7,08-17-2021 6:34:06
2021-08-17,7:30 PM,3,1,1,0,0,5,08-17-2021 7:30:34
2021-08-17,8:30 PM,1,1,0,0,0,2,08-17-2021 8:29:43
2021-08-18,7:30 AM,0,0,0,0,0,0,08-18-2021 7:29:18
2021-08-18,8:30 AM,4,1,1,0,1,7,08-18-2021 8:29:48
2021-08-18,9:30 AM,4,1,6,0,1,12,08-18-2021 9:31:55
2021-08-18,10:30 AM,9,3,4,1,2,19,08-18-2021 10:30:19
2021-08-18,11:30 AM,8,5,10,2,0,25,08-18-2021 11:33:28
2021-08-18,1:30 PM,11,2,9,4,0,26,08-18-2021 1:37:52
2021-08-18,2:30 PM,8,2,7,1,1,19,08-18-2021 2:28:56
2021-08-18,5:30 PM,7,3,4,3,1,18,08-18-2021 5:31:01
2021-08-18,6:30 PM,3,1,1,2,1,8,08-18-2021 6:30:12
2021-08-18,7:30 PM,4,0,1,0,0,5,08-18-2021 7:30:25
2021-08-18,8:30 PM,3,0,0,0,0,3,08-18-2021 8:30:40
2021-08-19,7:30 AM,0,0,0,0,0,0,08-19-2021 7:35:23
2021-08-19,8:30 AM,2,0,4,0,0,6,08-19-2021 8:30:06
2021-08-19,9:30 AM,2,2,2,1,0,7,08-19-2021 9:31:03
2021-08-19,10:30 AM,12,3,5,4,0,24,08-19-2021 10:27:49
2021-08-19,11:30 AM,8,2,5,2,2,19,08-19-2021 11:35:31
2021-08-19,12:30 PM,10,8,3,3,0,24,08-19-2021 12:32:23
2021-08-19,1:30 PM,7,5,13,3,0,28,08-19-2021 1:28:50
2021-08-19,2:30 PM,12,8,6,1,0,27,08-19-2021 2:34:24
2021-08-19,3:30 PM,7,6,4,1,2,20,08-19-2021 3:32:03
2021-08-19,4:30 PM,4,2,2,1,1,10,08-19-2021 4:32:10
2021-08-19,5:30 PM,4,3,2,0,0,9,08-19-2021 5:31:56
2021-08-19,6:30 PM,1,3,1,0,0,5,08-19-2021 6:32:57
2021-08-19,7:30 PM,1,2,1,0,0,4,08-19-2021 7:33:51
2021-08-19,8:30 PM,2,2,2,1,0,7,08-19-2021 8:30:27
2021-08-20,7:30 AM,1,0,0,0,0,1,08-20-2021 7:38:04
2021-08-20,8:30 AM,1,1,0,1,0,3,08-20-2021 8:30:56
2021-08-20,9:30 AM,4,1,2,0,0,7,08-20-2021 9:30:50
2021-08-20,10:30 AM,4,1,2,1,0,8,08-20-2021 10:30:19
2021-08-20,11:30 AM,3,1,2,0,2,8,08-20-2021 11:33:35
2021-08-20,12:30 PM,7,2,1,0,0,10,08-20-2021 12:29:17
2021-08-20,1:30 PM,4,1,0,1,2,8,08-20-2021 1:35:02
2021-08-20,2:30 PM,3,1,2,1,2,9,08-20-2021 2:30:05
2021-08-20,3:30 PM,5,1,1,1,2,10,08-20-2021 3:30:01
2021-08-20,4:30 PM,3,1,1,1,2,8,08-20-2021 4:31:16
2021-08-20,5:30 PM,3,0,3,0,1,7,08-20-2021 5:29:52
2021-08-20,6:30 PM,1,0,1,0,0,2,08-20-2021 6:33:22
2021-08-20,7:30 PM,0,1,1,0,0,2,08-20-2021 7:31:50
2021-08-20,8:30 PM,0,1,0,0,0,1,08-20-2021 8:31:06
2021-08-21,9:30 AM,0,0,1,0,0,1,08-21-2021 9:30:16
2021-08-21,10:30 AM,3,0,1,0,2,6,08-21-2021 11:33:55
2021-08-21,11:30 AM,2,0,2,0,2,6,08-21-2021 11:36:06
2021-08-21,2:30 PM,10,0,2,0,2,14,08-21-2021 2:45:37
2021-08-21,3:30 PM,11,3,5,1,1,21,08-21-2021 3:23:07
2021-08-21,4:30 PM,6,3,4,1,2,16,08-21-2021 4:24:52
2021-08-23,7:30 AM,0,0,0,0,0,0,08-23-2021 7:30:39
2021-08-23,8:30 AM,3,0,1,1,1,6,08-23-2021 8:32:53
2021-08-23,9:30 AM,5,1,1,1,2,10,08-23-2021 9:31:01
2021-08-23,10:30 AM,4,1,5,2,2,14,08-23-2021 10:33:27
2021-08-23,11:30 AM,7,2,12,2,1,24,08-23-2021 11:30:29
2021-08-23,11:30 AM,12,7,10,3,1,33,08-23-2021 11:33:17
2021-08-23,12:30 PM,13,7,5,1,0,26,08-23-2021 12:36:36
2021-08-23,1:30 PM,5,3,9,2,0,19,08-23-2021 1:29:37
2021-08-23,3:30 PM,4,2,6,2,2,16,08-23-2021 3:36:05
2021-08-23,5:30 PM,5,2,4,0,0,11,08-23-2021 5:33:12
2021-08-23,6:30 PM,4,2,1,0,0,7,08-23-2021 6:30:08
2021-08-23,7:30 PM,3,0,1,0,0,4,08-23-2021 7:31:00
2021-08-23,8:30 PM,1,0,0,0,0,1,08-23-2021 8:30:42
2021-08-24,7:30 AM,0,0,2,0,0,2,08-24-2021 7:40:11
2021-08-24,8:30 AM,4,0,3,0,0,7,08-24-2021 8:32:05
2021-08-24,9:30 AM,3,0,4,1,2,10,08-24-2021 9:30:53
2021-08-24,10:30 AM,7,3,8,0,0,18,08-24-2021 10:28:47
2021-08-24,11:30 AM,4,3,5,2,2,16,08-24-2021 11:30:44
2021-08-24,12:30 PM,11,5,7,2,0,25,08-24-2021 1:32:49
2021-08-24,2:30 PM,7,7,9,2,0,25,08-24-2021 2:33:18
2021-08-24,3:30 PM,8,4,6,3,2,23,08-24-2021 3:32:40
2021-08-24,4:30 PM,5,1,5,2,2,15,08-24-2021 4:35:10
2021-08-24,5:30 PM,6,1,3,0,0,10,08-24-2021 5:35:32
2021-08-24,6:30 PM,4,1,3,0,1,9,08-24-2021 6:30:07
2021-08-24,7:30 PM,5,1,2,0,1,9,08-24-2021 7:30:32
2021-08-24,8:30 PM,1,0,1,0,0,2,08-24-2021 8:31:28
2021-08-25,7:30 AM,0,0,0,0,0,0,08-25-2021 7:48:24
2021-08-25,8:30 AM,3,0,0,0,2,5,08-25-2021 8:32:51
2021-08-25,9:30 AM,6,1,1,2,0,10,08-25-2021 9:32:32
2021-08-25,10:30 AM,2,1,4,0,0,7,08-25-2021 10:34:11
2021-08-25,11:30 AM,8,0,9,0,1,18,08-25-2021 11:37:10
2021-08-25,12:30 PM,14,4,8,2,2,30,08-25-2021 12:31:46
2021-08-25,1:30 PM,8,4,3,0,0,15,08-25-2021 1:49:43
2021-08-25,2:30 PM,4,1,2,0,2,9,08-25-2021 2:24:59
2021-08-25,5:30 PM,7,3,3,0,0,13,08-25-2021 5:31:16
2021-08-25,6:30 PM,0,1,3,0,0,4,08-25-2021 6:32:21
2021-08-25,7:30 PM,0,0,0,0,1,1,08-25-2021 7:30:42
2021-08-25,8:30 PM,0,0,0,0,0,0,08-25-2021 8:29:20
2021-08-26,7:30 AM,1,0,0,0,0,1,08-26-2021 7:36:20
2021-08-26,8:30 AM,2,1,0,0,1,4,08-26-2021 8:31:35
2021-08-26,9:30 AM,1,2,1,0,0,4,08-26-2021 9:32:30
2021-08-26,9:30 AM,1,2,1,1,0,5,08-26-2021 9:36:32
2021-08-26,10:30 AM,5,1,3,1,1,11,08-26-2021 10:35:17
2021-08-26,11:30 AM,8,2,5,2,4,21,08-26-2021 11:31:11
2021-08-26,12:30 PM,4,3,6,2,0,15,08-26-2021 12:30:50
2021-08-26,1:30 PM,4,3,9,2,1,19,08-26-2021 1:34:38
2021-08-26,4:30 PM,8,3,5,2,0,18,08-26-2021 4:30:59
2021-08-26,5:30 PM,3,2,2,1,0,8,08-26-2021 5:30:07
2021-08-26,6:30 PM,1,0,1,1,0,3,08-26-2021 6:29:33
2021-08-26,7:30 PM,2,2,1,1,0,6,08-26-2021 7:32:19
2021-08-26,8:30 PM,1,1,0,1,0,3,08-26-2021 8:31:34
2021-08-27,8:30 AM,4,1,1,0,0,6,08-27-2021 8:33:10
2021-08-27,9:30 AM,1,2,1,1,0,5,08-27-2021 9:28:50
2021-08-27,10:30 AM,5,1,1,1,0,8,08-27-2021 10:32:49
2021-08-27,11:30 AM,4,2,4,0,1,11,08-27-2021 11:27:18
2021-08-27,12:30 PM,5,1,7,0,1,14,08-27-2021 12:32:54
2021-08-27,1:30 PM,8,2,6,1,7,24,08-27-2021 1:29:55
2021-08-27,2:30 PM,11,2,8,2,12,35,08-27-2021 2:30:56
2021-08-27,3:30 PM,4,2,6,0,8,20,08-27-2021 3:30:45
2021-08-27,4:30 PM,6,1,6,0,3,16,08-27-2021 4:30:36
2021-08-27,5:30 PM,3,1,0,1,0,5,08-27-2021 5:34:27
2021-08-27,6:30 PM,2,1,0,0,0,3,08-27-2021 6:30:54
2021-08-27,7:30 PM,4,1,0,0,0,5,08-27-2021 7:32:46
2021-08-27,8:30 PM,0,0,0,0,0,0,08-27-2021 8:30:28
2021-08-28,9:30 AM,2,0,1,0,0,3,08-28-2021 9:32:34
2021-08-28,10:30 AM,4,0,1,0,0,5,08-28-2021 10:30:09
2021-08-28,11:30 AM,5,0,1,1,0,7,08-28-2021 11:36:16
2021-08-28,12:30 PM,5,0,2,0,0,7,08-28-2021 12:32:02
2021-08-28,2:30 PM,4,2,3,2,0,11,08-28-2021 2:29:24
2021-08-28,3:30 PM,4,2,2,0,0,8,08-28-2021 3:34:30
2021-08-30,7:30 AM,0,0,0,0,0,0,08-30-2021 7:32:25
2021-08-30,8:30 AM,3,0,3,0,4,10,08-30-2021 8:32:27
2021-08-30,9:30 AM,6,1,6,1,2,16,08-30-2021 9:35:13
2021-08-30,10:30 AM,8,1,5,1,4,19,08-30-2021 10:34:50
2021-08-30,11:30 AM,4,4,12,2,1,23,08-30-2021 11:36:19
2021-08-30,12:30 PM,10,7,14,1,2,34,08-30-2021 12:32:42
2021-08-30,1:30 PM,6,4,7,1,3,21,08-30-2021 1:42:44
2021-08-30,2:30 PM,5,4,6,1,3,19,08-30-2021 2:36:06
2021-08-30,5:30 PM,5,1,3,1,0,10,08-30-2021 5:30:41
2021-08-30,6:30 PM,2,0,1,0,0,3,08-30-2021 6:30:50
2021-08-30,7:30 PM,3,0,0,0,0,3,08-30-2021 7:30:08
2021-08-30,8:30 PM,2,0,0,0,0,2,08-30-2021 8:31:34
2021-08-31,7:30 AM,1,0,0,0,0,1,08-31-2021 7:32:59
2021-08-31,8:30 AM,5,2,3,0,1,11,08-31-2021 8:29:21
2021-08-31,9:30 AM,3,3,4,0,0,10,08-31-2021 9:30:03
2021-08-31,10:30 AM,8,4,13,4,0,29,08-31-2021 10:30:01
2021-08-31,11:30 AM,5,6,14,4,0,29,08-31-2021 11:29:30
2021-08-31,12:30 PM,12,5,10,5,5,37,08-31-2021 12:35:16
2021-08-31,1:30 PM,3,2,7,4,3,19,08-31-2021 1:32:43
2021-08-31,5:30 PM,6,1,4,1,0,12,08-31-2021 5:35:55
2021-08-31,6:30 PM,4,1,2,1,0,8,08-31-2021 6:29:30
2021-08-31,7:30 PM,2,0,0,1,0,3,08-31-2021 7:34:58
2021-08-31,8:30 PM,0,0,0,0,0,0,08-31-2021 8:28:48
2021-08-31,8:30 PM,0,2,0,0,0,2,08-31-2021 8:37:20
2021-09-01,7:30 AM,0,0,0,0,0,0,09-01-2021 7:29:37
2021-09-01,8:30 AM,2,0,1,0,1,4,09-01-2021 8:33:04
2021-09-01,9:30 AM,5,1,1,1,0,8,09-01-2021 9:32:47
2021-09-01,10:30 AM,8,3,6,0,0,17,09-01-2021 10:33:34
2021-09-01,11:30 AM,6,3,10,2,1,22,09-01-2021 11:41:45
2021-09-01,12:30 PM,8,11,10,3,0,32,09-01-2021 12:40:43
2021-09-01,1:30 PM,9,3,8,1,0,21,09-01-2021 1:31:34
2021-09-01,3:30 PM,8,7,20,4,1,40,09-01-2021 3:32:29
2021-09-01,5:30 PM,6,4,6,0,0,16,09-01-2021 5:31:04
2021-09-01,6:30 PM,0,2,1,1,2,6,09-01-2021 6:32:53
2021-09-01,7:30 PM,4,0,0,0,0,4,09-01-2021 7:34:38
2021-09-01,8:30 PM,1,0,0,0,0,1,09-01-2021 8:29:32
2021-09-02,7:30 AM,1,0,0,0,0,1,09-02-2021 7:31:44
2021-09-02,8:30 AM,2,0,0,0,0,2,09-02-2021 8:33:33
2021-09-02,9:30 AM,2,1,6,3,0,12,09-02-2021 9:28:32
2021-09-02,10:30 AM,4,4,10,3,1,22,09-02-2021 10:31:48
2021-09-02,11:30 AM,5,5,10,5,3,28,09-02-2021 11:33:14
2021-09-02,1:30 PM,9,2,5,10,3,29,09-02-2021 1:37:38
2021-09-02,2:30 PM,4,4,3,12,2,25,09-02-2021 2:38:06
2021-09-02,3:30 PM,4,3,5,6,7,25,09-02-2021 3:40:23
2021-09-02,4:30 PM,5,3,1,6,2,17,09-02-2021 4:32:58
2021-09-02,5:30 PM,2,3,1,0,1,7,09-02-2021 5:36:14
2021-09-02,6:30 PM,2,1,1,0,0,4,09-02-2021 6:35:14
2021-09-02,7:30 PM,0,1,1,0,0,2,09-02-2021 7:38:30
2021-09-02,8:30 PM,0,1,0,0,0,1,09-02-2021 8:31:36
2021-09-03,7:30 AM,1,0,0,0,0,1,09-03-2021 7:35:51
2021-09-03,8:30 AM,3,0,0,0,0,3,09-03-2021 8:31:23
2021-09-03,9:30 AM,3,2,2,0,1,8,09-03-2021 9:38:01
2021-09-03,10:30 AM,4,2,4,0,1,11,09-03-2021 10:29:22
2021-09-03,11:30 AM,4,2,6,0,0,12,09-03-2021 11:27:32
2021-09-03,12:30 PM,3,1,2,1,0,7,09-03-2021 12:32:56
2021-09-03,1:30 PM,4,1,0,1,1,7,09-03-2021 1:37:38
2021-09-03,2:30 PM,3,1,1,1,1,7,09-03-2021 2:30:10
2021-09-03,3:30 PM,2,1,3,1,4,11,09-03-2021 3:36:10
2021-09-03,4:30 PM,4,1,3,4,2,14,09-03-2021 4:30:37
2021-09-03,5:30 PM,1,2,2,3,0,8,09-03-2021 5:29:54
2021-09-03,6:30 PM,2,2,2,2,0,8,09-03-2021 6:25:41
2021-09-03,7:30 PM,1,2,0,1,0,4,09-03-2021 7:32:49
2021-09-03,8:30 PM,0,2,0,1,0,3,09-03-2021 8:29:53
2021-09-04,9:30 AM,2,0,1,0,2,5,09-04-2021 9:37:48
2021-09-04,9:30 AM,1,0,1,0,1,3,09-04-2021 9:43:50
2021-09-04,10:30 AM,1,0,1,0,0,2,09-04-2021 10:41:02
2021-09-04,11:30 AM,2,1,1,0,0,4,09-04-2021 11:36:44
2021-09-04,12:30 PM,2,1,2,0,0,5,09-04-2021 12:33:15
2021-09-04,3:30 PM,7,2,3,4,0,16,09-04-2021 3:37:09
2021-09-04,4:30 PM,6,2,3,1,0,12,09-04-2021 4:28:28
2021-09-07,7:30 AM,0,0,0,0,0,0,09-07-2021 7:36:24
2021-09-07,8:30 AM,5,1,1,1,0,8,09-07-2021 8:29:38
2021-09-07,9:30 AM,6,2,6,1,1,16,09-07-2021 9:25:48
2021-09-07,9:30 AM,6,3,7,3,0,19,09-07-2021 9:31:34
2021-09-07,10:30 AM,9,5,10,3,2,29,09-07-2021 10:31:52
2021-09-07,11:30 AM,9,3,8,3,1,24,09-07-2021 11:31:02
2021-09-07,12:30 PM,12,1,16,4,1,34,09-07-2021 12:29:31
2021-09-07,1:30 PM,8,2,10,1,1,22,09-07-2021 1:33:41
2021-09-07,2:30 PM,8,4,4,3,4,23,09-07-2021 2:40:18
2021-09-07,4:30 PM,8,4,5,1,1,19,09-07-2021 4:36:17
2021-09-07,5:30 PM,8,3,2,2,2,17,09-07-2021 5:30:05
2021-09-07,6:30 PM,2,1,1,1,0,5,09-07-2021 6:42:02
2021-09-08,7:30 AM,0,0,0,0,0,0,09-08-2021 7:30:47
2021-09-08,8:30 AM,1,1,2,0,1,5,09-08-2021 8:32:23
2021-09-08,9:30 AM,5,4,5,0,1,15,09-08-2021 9:33:41
2021-09-08,11:30 AM,4,3,10,2,2,21,09-08-2021 11:32:28
2021-09-08,12:30 PM,5,4,10,5,0,24,09-08-2021 12:33:04
2021-09-08,1:30 PM,6,2,3,3,0,14,09-08-2021 1:39:12
2021-09-08,5:30 PM,5,0,6,0,0,11,09-08-2021 5:31:19
2021-09-08,6:30 PM,4,0,5,0,0,9,09-08-2021 6:30:22
2021-09-08,7:30 PM,3,1,2,1,0,7,09-08-2021 7:29:27
2021-09-08,8:30 PM,3,0,0,0,0,3,09-08-2021 8:29:31
2021-09-09,7:30 AM,1,0,0,0,1,2,09-09-2021 7:41:35
2021-09-09,8:30 AM,2,1,1,1,5,10,09-09-2021 8:30:13
2021-09-09,9:30 AM,3,2,2,1,4,12,09-09-2021 9:45:06
2021-09-09,10:30 AM,4,5,7,2,5,23,09-09-2021 10:33:45
2021-09-09,11:30 AM,8,1,10,5,0,24,09-09-2021 11:32:13
2021-09-09,1:30 PM,4,1,4,0,1,10,09-09-2021 1:41:46
2021-09-09,2:30 PM,9,2,6,2,1,20,09-09-2021 2:31:58
2021-09-09,3:30 PM,8,1,2,1,0,12,09-09-2021 3:30:29
2021-09-09,4:30 PM,4,1,2,1,2,10,09-09-2021 4:34:23
2021-09-09,5:30 PM,5,3,2,0,0,10,09-09-2021 5:30:07
2021-09-09,6:30 PM,3,2,4,0,0,9,09-09-2021 6:31:35
2021-09-09,7:30 PM,3,3,3,0,0,9,09-09-2021 7:33:02
2021-09-09,8:30 PM,1,3,0,0,0,4,09-09-2021 8:30:12
2021-09-10,7:30 AM,1,0,0,0,0,1,09-10-2021 7:35:16
2021-09-10,8:30 AM,1,0,1,0,0,2,09-10-2021 8:39:17
2021-09-10,9:30 AM,1,1,1,0,4,7,09-10-2021 9:32:52
2021-09-10,10:30 AM,3,3,4,0,4,14,09-10-2021 10:29:22
2021-09-10,11:30 AM,4,3,3,0,4,14,09-10-2021 11:29:47
2021-09-10,12:30 PM,1,1,3,1,1,7,09-10-2021 12:26:45
2021-09-10,1:30 PM,1,2,3,2,1,9,09-10-2021 1:33:05
2021-09-10,2:30 PM,1,2,3,0,5,11,09-10-2021 2:30:44
2021-09-10,3:30 PM,3,2,3,2,2,12,09-10-2021 3:30:27
2021-09-10,4:30 PM,4,1,2,0,5,12,09-10-2021 4:39:13
2021-09-10,5:30 PM,2,0,3,1,0,6,09-10-2021 5:29:27
2021-09-10,7:30 PM,3,0,1,0,0,4,09-10-2021 7:30:53
2021-09-10,8:30 PM,0,0,1,0,0,1,09-10-2021 8:31:40
2021-09-11,9:30 AM,0,0,0,1,0,1,09-11-2021 9:30:47
2021-09-11,10:30 AM,1,0,2,1,0,4,09-11-2021 10:32:00
2021-09-11,11:30 AM,1,0,3,0,0,4,09-11-2021 11:30:17
2021-09-11,12:30 PM,3,0,3,3,0,9,09-11-2021 12:29:25
2021-09-11,1:30 PM,3,1,2,3,0,9,09-11-2021 1:27:13
2021-09-11,3:30 PM,4,0,2,0,2,8,09-11-2021 3:36:54
2021-09-11,4:30 PM,1,0,0,0,2,3,09-11-2021 4:32:32
2021-09-13,7:30 AM,1,0,0,0,0,1,09-13-2021 7:35:27
2021-09-13,8:30 AM,4,0,1,0,2,7,09-13-2021 8:33:06
2021-09-13,9:30 AM,6,0,2,1,2,11,09-13-2021 9:32:45
2021-09-13,10:30 AM,11,2,5,1,4,23,09-13-2021 10:34:44
2021-09-13,11:30 AM,5,1,3,1,2,12,09-13-2021 11:35:56
2021-09-13,1:30 PM,7,3,9,0,0,19,09-13-2021 1:43:14
2021-09-13,2:30 PM,5,5,5,1,0,16,09-13-2021 2:35:46
2021-09-13,3:30 PM,8,3,3,2,0,16,09-13-2021 3:28:16
2021-09-13,4:30 PM,6,2,4,1,5,18,09-13-2021 4:30:26
2021-09-13,5:30 PM,2,2,6,5,0,15,09-13-2021 5:32:57
2021-09-13,6:30 PM,1,3,4,0,0,8,09-13-2021 6:30:27
2021-09-13,7:30 PM,0,0,3,1,1,5,09-13-2021 7:30:58
2021-09-13,8:30 PM,0,0,0,0,0,0,09-13-2021 8:31:15
2021-09-14,7:30 AM,1,0,0,0,0,1,09-14-2021 7:32:27
2021-09-14,8:30 AM,5,0,1,0,1,7,09-14-2021 8:32:00
2021-09-14,9:30 AM,5,1,1,0,3,10,09-14-2021 9:30:30
2021-09-14,10:30 AM,5,5,3,0,0,13,09-14-2021 10:28:41
2021-09-14,11:30 AM,5,6,6,0,1,18,09-14-2021 11:31:13
2021-09-14,12:30 PM,17,5,15,4,0,41,09-14-2021 12:30:21
2021-09-14,1:30 PM,7,0,9,5,0,21,09-14-2021 1:33:56
2021-09-14,2:30 PM,10,1,3,1,4,19,09-14-2021 2:33:18
2021-09-14,5:30 PM,3,1,5,1,0,10,09-14-2021 5:30:47
2021-09-14,6:30 PM,4,1,1,0,0,6,09-14-2021 6:29:29
2021-09-14,7:30 PM,4,1,1,0,0,6,09-14-2021 7:31:30
2021-09-14,7:30 PM,1,1,2,0,0,4,09-14-2021 8:33:07
2021-09-15,7:30 AM,0,0,0,0,0,0,09-15-2021 7:29:51
2021-09-15,8:30 AM,4,1,1,0,1,7,09-15-2021 8:33:32
2021-09-15,9:30 AM,4,5,0,1,2,12,09-15-2021 9:34:34
2021-09-15,10:30 AM,6,4,4,1,2,17,09-15-2021 10:33:02
2021-09-15,12:30 PM,3,4,8,1,3,19,09-15-2021 12:35:04
2021-09-15,2:30 PM,7,3,9,2,1,22,09-15-2021 2:28:00
2021-09-15,3:30 PM,12,1,11,1,3,28,09-15-2021 3:33:05
2021-09-15,4:30 PM,10,3,3,1,1,18,09-15-2021 4:29:55
2021-09-15,5:30 PM,7,1,1,0,0,9,09-15-2021 5:30:09
2021-09-15,6:30 PM,3,0,1,0,1,5,09-15-2021 6:28:10
2021-09-15,7:30 PM,3,0,0,0,0,3,09-15-2021 7:30:57
2021-09-15,8:30 PM,3,0,0,0,0,3,09-15-2021 8:29:49
2021-09-16,7:30 AM,2,0,0,0,1,3,09-16-2021 7:33:32
2021-09-16,8:30 AM,4,0,2,1,0,7,09-16-2021 8:45:29
2021-09-16,9:30 AM,4,0,1,3,1,9,09-16-2021 9:31:19
2021-09-16,10:30 AM,3,1,4,3,1,12,09-16-2021 10:32:14
2021-09-16,11:30 AM,10,4,6,4,3,27,09-16-2021 11:34:04
2021-09-16,12:30 PM,16,4,15,5,2,42,09-16-2021 12:34:44
2021-09-16,1:30 PM,5,1,2,1,1,10,09-16-2021 2:22:16
2021-09-16,2:30 PM,8,1,4,2,2,17,09-16-2021 2:31:27
2021-09-16,3:30 PM,6,1,2,1,3,13,09-16-2021 3:34:03
2021-09-16,4:30 PM,3,1,1,1,2,8,09-16-2021 4:31:35
2021-09-16,5:30 PM,4,0,3,1,0,8,09-16-2021 5:39:08
2021-09-16,6:30 PM,4,0,1,1,0,6,09-16-2021 6:33:57
2021-09-16,7:30 PM,2,0,1,1,0,4,09-16-2021 7:34:37
2021-09-16,8:30 PM,0,0,0,0,0,0,09-16-2021 8:31:02
2021-09-17,7:30 AM,1,0,0,0,0,1,09-17-2021 7:35:20
2021-09-17,8:30 AM,1,0,0,0,0,1,09-17-2021 8:33:35
2021-09-17,9:30 AM,5,0,0,3,1,9,09-17-2021 9:28:26
2021-09-17,10:30 AM,6,0,0,3,7,16,09-17-2021 10:31:55
2021-09-17,11:30 AM,3,1,0,2,6,12,09-17-2021 11:32:08
2021-09-17,12:30 PM,3,0,2,1,5,11,09-17-2021 12:31:46
2021-09-17,1:30 PM,7,0,6,0,1,14,09-17-2021 1:38:02
2021-09-17,2:30 PM,6,0,4,3,0,13,09-17-2021 2:34:06
2021-09-17,3:30 PM,9,1,1,4,1,16,09-17-2021 3:38:35
2021-09-17,4:30 PM,5,0,5,3,2,15,09-17-2021 4:29:27
2021-09-17,5:30 PM,2,0,3,1,0,6,09-17-2021 5:31:23
2021-09-17,6:30 PM,0,1,1,0,0,2,09-17-2021 6:30:14
2021-09-17,7:30 PM,2,1,0,0,0,3,09-17-2021 7:30:41
2021-09-17,8:30 PM,1,1,0,0,0,2,09-17-2021 8:28:23
2021-09-18,9:30 AM,4,0,1,0,3,8,09-18-2021 10:08:58
2021-09-18,10:30 AM,1,0,0,0,3,4,09-18-2021 10:37:36
2021-09-18,11:30 AM,1,1,0,0,1,3,09-18-2021 11:33:52
2021-09-18,11:30 AM,1,1,0,0,0,2,09-18-2021 11:36:35
2021-09-18,12:30 PM,4,1,0,0,0,5,09-18-2021 12:34:27
2021-09-18,1:30 PM,4,1,0,0,0,5,09-18-2021 1:31:47
2021-09-20,7:30 AM,1,0,0,0,0,1,09-20-2021 7:37:03
2021-09-20,8:30 AM,7,0,1,0,1,9,09-20-2021 8:34:03
2021-09-20,9:30 AM,6,1,6,0,2,15,09-20-2021 9:34:12
2021-09-20,10:30 AM,4,2,5,0,7,18,09-20-2021 10:33:46
2021-09-20,11:30 AM,3,2,6,0,1,12,09-20-2021 11:48:37
2021-09-20,12:30 PM,9,5,10,0,6,30,09-20-2021 12:37:28
2021-09-20,1:30 PM,7,1,11,0,5,24,09-20-2021 1:36:59
2021-09-20,2:30 PM,5,1,9,2,0,17,09-20-2021 2:30:12
2021-09-20,3:30 PM,11,2,4,1,0,18,09-20-2021 3:31:22
2021-09-20,4:30 PM,9,1,6,0,0,16,09-20-2021 4:34:49
2021-09-20,5:30 PM,3,0,0,0,0,3,09-20-2021 5:49:16
2021-09-20,6:30 PM,2,0,2,0,0,4,09-20-2021 6:31:12
2021-09-20,7:30 PM,5,0,2,0,0,7,09-20-2021 7:33:55
2021-09-20,8:30 PM,0,0,0,0,0,0,09-20-2021 8:32:53
2021-09-21,7:30 AM,1,0,0,0,0,1,09-21-2021 7:33:40
2021-09-21,8:30 AM,3,0,1,1,0,5,09-21-2021 8:29:13
2021-09-21,9:30 AM,7,1,3,1,1,13,09-21-2021 9:31:35
2021-09-21,10:30 AM,5,3,8,2,0,18,09-21-2021 10:31:57
2021-09-21,11:30 AM,4,3,6,0,0,13,09-21-2021 11:29:37
2021-09-21,12:30 PM,8,5,12,3,2,30,09-21-2021 12:29:19
2021-09-21,2:30 PM,9,2,9,2,2,24,09-21-2021 2:09:14
2021-09-21,5:30 PM,5,0,3,0,2,10,09-21-2021 5:30:56
2021-09-21,6:30 PM,4,0,4,3,2,13,09-21-2021 6:35:20
2021-09-21,7:30 PM,0,0,3,0,2,5,09-21-2021 7:31:19
2021-09-21,7:30 PM,0,0,2,0,0,2,09-21-2021 8:34:46
2021-09-22,7:30 AM,0,0,0,0,0,0,09-22-2021 7:37:14
2021-09-22,8:30 AM,2,0,1,1,1,5,09-22-2021 8:33:24
2021-09-22,9:30 AM,5,1,2,1,0,9,09-22-2021 9:31:25
2021-09-22,10:30 AM,3,1,4,0,0,8,09-22-2021 10:31:11
2021-09-22,11:30 AM,3,4,6,1,0,14,09-22-2021 11:36:38
2021-09-22,12:30 PM,6,6,8,1,0,21,09-22-2021 12:37:49
2021-09-22,1:30 PM,6,7,5,0,1,19,09-22-2021 1:34:36
2021-09-22,5:30 PM,7,1,5,0,0,13,09-22-2021 5:29:36
2021-09-22,6:30 PM,2,0,0,0,0,2,09-22-2021 6:31:44
2021-09-22,7:30 PM,3,1,1,0,0,5,09-22-2021 7:30:59
2021-09-22,8:30 PM,1,0,2,0,0,3,09-22-2021 8:29:52
2021-09-23,7:30 AM,1,0,0,0,0,1,09-23-2021 7:32:39
2021-09-23,8:30 AM,2,2,2,1,1,8,09-23-2021 8:31:05
2021-09-23,9:30 AM,2,2,2,3,1,10,09-23-2021 9:29:21
2021-09-23,10:30 AM,3,3,7,5,2,20,09-23-2021 10:28:37
2021-09-23,11:30 AM,5,3,7,3,3,21,09-23-2021 11:37:35
2021-09-23,2:30 PM,6,0,4,1,0,11,09-23-2021 2:26:45
2021-09-23,1:30 PM,4,0,4,0,1,9,09-23-2021 2:27:16
2021-09-23,3:30 PM,5,1,4,1,3,14,09-23-2021 3:33:36
2021-09-23,4:30 PM,5,0,3,0,2,10,09-23-2021 4:32:15
2021-09-23,5:30 PM,7,1,2,0,1,11,09-23-2021 5:34:47
2021-09-23,6:30 PM,2,0,4,0,0,6,09-23-2021 6:29:54
2021-09-23,7:30 PM,2,0,4,0,0,6,09-23-2021 7:31:19
2021-09-23,8:30 PM,3,0,1,0,0,4,09-23-2021 8:31:08
2021-09-24,7:30 AM,1,0,0,0,0,1,09-24-2021 7:42:20
2021-09-24,8:30 AM,2,0,1,0,0,3,09-24-2021 8:28:50
2021-09-24,9:30 AM,5,0,2,0,1,8,09-24-2021 9:30:23
2021-09-24,10:30 AM,3,2,1,1,1,8,09-24-2021 10:31:58
2021-09-24,12:30 PM,5,0,4,0,1,10,09-24-2021 12:01:14
2021-09-24,12:30 PM,3,1,4,0,1,9,09-24-2021 12:30:21
2021-09-24,1:30 PM,1,0,2,0,1,4,09-24-2021 1:30:58
2021-09-24,2:30 PM,4,1,3,0,1,9,09-24-2021 2:31:00
2021-09-24,3:30 PM,2,0,2,0,1,5,09-24-2021 4:07:40
2021-09-24,4:30 PM,1,1,0,0,2,4,09-24-2021 4:27:12
2021-09-24,5:30 PM,2,1,0,0,0,3,09-24-2021 5:29:32
2021-09-24,6:30 PM,0,0,0,0,0,0,09-24-2021 6:31:17
2021-09-24,7:30 PM,3,0,0,0,0,3,09-24-2021 7:29:25
2021-09-24,8:30 PM,2,0,0,0,0,2,09-24-2021 8:27:42
2021-09-25,9:30 AM,2,0,0,0,0,2,09-25-2021 9:33:18
2021-09-25,10:30 AM,4,0,1,0,1,6,09-25-2021 10:33:34
2021-09-25,11:30 AM,2,0,2,1,5,10,09-25-2021 11:33:06
2021-09-25,12:30 PM,7,0,2,1,5,15,09-25-2021 12:40:19
2021-09-27,7:30 AM,1,0,0,0,0,1,09-27-2021 7:37:46
2021-09-27,8:30 AM,3,0,1,0,1,5,09-27-2021 8:59:13
2021-09-27,9:30 AM,9,0,3,0,2,14,09-27-2021 9:27:56
2021-09-27,11:30 AM,8,0,3,1,2,14,09-27-2021 11:00:18
2021-09-27,11:30 AM,6,2,7,0,1,16,09-27-2021 11:30:31
2021-09-27,12:30 PM,6,2,4,3,3,18,09-27-2021 1:44:32
2021-09-27,1:30 PM,7,2,6,1,1,17,09-27-2021 1:58:29
2021-09-27,5:30 PM,6,4,4,0,0,14,09-27-2021 5:32:16
2021-09-27,6:30 PM,1,1,1,0,0,3,09-27-2021 6:34:49
2021-09-27,7:30 PM,1,0,1,0,0,2,09-27-2021 7:32:59
2021-09-27,8:30 PM,3,0,0,0,0,3,09-27-2021 8:30:29
2021-09-28,7:30 AM,2,0,0,0,0,2,09-28-2021 7:37:54
2021-09-28,8:30 AM,5,0,3,0,0,8,09-28-2021 8:33:03
2021-09-28,9:30 AM,7,1,2,0,0,10,09-28-2021 9:32:17
2021-09-28,10:30 AM,7,1,6,1,2,17,09-28-2021 10:33:13
2021-09-28,11:30 AM,3,4,8,0,0,15,09-28-2021 11:32:03
2021-09-28,12:30 PM,13,3,8,6,0,30,09-28-2021 12:28:20
2021-09-28,12:30 PM,8,4,12,7,1,32,09-28-2021 1:04:11
2021-09-28,1:30 PM,2,3,7,4,1,17,09-28-2021 1:31:49
2021-09-28,5:30 PM,5,1,3,1,2,12,09-28-2021 5:32:53
2021-09-28,6:30 PM,2,1,3,1,0,7,09-28-2021 6:28:30
2021-09-28,7:30 PM,3,0,5,1,0,9,09-28-2021 7:39:59
2021-09-28,8:30 PM,2,1,4,0,0,7,09-28-2021 8:27:27
2021-09-29,7:30 AM,0,0,0,0,0,0,09-29-2021 7:34:55
2021-09-29,8:30 AM,1,0,2,0,1,4,09-29-2021 8:33:36
2021-09-29,9:30 AM,4,0,5,3,2,14,09-29-2021 9:32:25
2021-09-29,10:30 AM,3,1,3,1,2,10,09-29-2021 10:31:00
2021-09-29,11:30 AM,8,4,10,2,2,26,09-29-2021 11:36:22
2021-09-29,12:30 PM,7,6,10,6,2,31,09-29-2021 12:44:16
2021-09-29,1:30 PM,7,4,5,3,2,21,09-29-2021 1:42:03
2021-09-29,2:30 PM,7,3,9,2,1,22,09-29-2021 2:33:30
2021-09-29,5:30 PM,4,2,3,1,0,10,09-29-2021 5:31:27
2021-09-29,6:30 PM,2,2,3,0,0,7,09-29-2021 6:32:45
2021-09-29,7:30 PM,5,1,0,1,0,7,09-29-2021 7:30:26
2021-09-29,8:30 PM,3,1,0,1,0,5,09-29-2021 8:29:24
2021-09-30,7:30 AM,1,0,0,0,0,1,09-30-2021 8:23:44
2021-09-30,8:30 AM,1,0,1,0,0,2,09-30-2021 8:30:42
2021-09-30,9:30 AM,6,1,4,1,0,12,09-30-2021 9:29:12
2021-09-30,10:30 AM,4,2,6,0,0,12,09-30-2021 10:31:48
2021-09-30,11:30 AM,4,1,3,2,1,11,09-30-2021 11:31:40
2021-09-30,1:30 PM,7,4,4,10,3,28,09-30-2021 1:32:08
2021-09-30,2:30 PM,1,0,6,6,2,15,09-30-2021 2:28:18
2021-09-30,3:30 PM,4,0,6,2,1,13,09-30-2021 3:33:05
2021-09-30,4:30 PM,5,1,4,0,3,13,09-30-2021 4:32:29
2021-09-30,5:30 PM,3,1,4,2,0,10,09-30-2021 5:33:24
2021-09-30,6:30 PM,4,1,3,2,0,10,09-30-2021 6:35:16
2021-09-30,7:30 PM,4,1,1,2,0,8,09-30-2021 7:32:34
2021-09-30,8:30 PM,1,1,0,0,0,2,09-30-2021 8:32:02
2021-10-01,7:30 AM,1,0,3,0,0,4,10-01-2021 7:33:57
2021-10-01,8:30 AM,1,1,0,1,0,3,10-01-2021 8:31:55
2021-10-01,9:30 AM,4,1,0,1,0,6,10-01-2021 10:29:43
2021-10-01,10:30 AM,3,2,0,1,1,7,10-01-2021 10:31:50
2021-10-01,11:30 AM,1,2,0,1,3,7,10-01-2021 11:27:52
2021-10-01,12:30 PM,2,2,0,0,1,5,10-01-2021 12:35:41
2021-10-01,2:30 PM,2,1,3,1,1,8,10-01-2021 2:55:48
2021-10-01,3:30 PM,1,0,3,0,0,4,10-01-2021 3:30:23
2021-10-01,3:30 PM,2,3,4,1,0,10,10-01-2021 3:45:53
2021-10-01,4:30 PM,3,2,2,2,0,9,10-01-2021 4:38:07
2021-10-01,5:30 PM,3,2,2,2,0,9,10-01-2021 5:33:04
2021-10-01,6:30 PM,1,3,2,2,0,8,10-01-2021 6:30:09
2021-10-01,7:30 PM,1,3,2,2,0,8,10-01-2021 7:29:33
2021-10-01,8:30 PM,1,1,0,0,0,2,10-01-2021 8:30:05
2021-10-02,9:30 AM,1,0,0,4,0,5,10-02-2021 9:32:47
2021-10-02,10:30 AM,1,0,0,4,2,7,10-02-2021 10:32:41
2021-10-02,11:30 AM,0,1,0,4,2,7,10-02-2021 11:32:07
2021-10-02,12:30 PM,2,1,0,3,2,8,10-02-2021 12:30:40
2021-10-02,1:30 PM,3,1,2,0,2,8,10-02-2021 2:15:34
2021-10-02,2:30 PM,4,1,1,1,2,9,10-02-2021 2:44:07
2021-10-02,3:30 PM,4,1,1,1,0,7,10-02-2021 3:40:16
2021-10-04,7:30 AM,2,0,0,0,0,2,10-04-2021 7:37:35
2021-10-04,8:30 AM,5,0,2,0,1,8,10-04-2021 8:33:09
2021-10-04,9:30 AM,6,1,4,0,2,13,10-04-2021 9:31:26
2021-10-04,10:30 AM,10,4,7,1,1,23,10-04-2021 10:36:32
2021-10-04,11:30 AM,5,4,7,1,1,18,10-04-2021 11:29:27
2021-10-04,12:30 PM,10,9,5,3,0,27,10-04-2021 12:40:52
2021-10-04,1:30 PM,6,6,6,2,0,20,10-04-2021 1:34:35
2021-10-04,2:30 PM,3,2,2,1,2,10,10-04-2021 2:32:46
2021-10-04,5:30 PM,7,3,4,2,0,16,10-04-2021 5:34:27
2021-10-04,6:30 PM,4,1,5,2,0,12,10-04-2021 6:33:32
2021-10-04,7:30 PM,3,1,3,0,0,7,10-04-2021 7:31:27
2021-10-04,8:30 PM,4,0,2,1,0,7,10-04-2021 8:30:40
2021-10-05,7:30 AM,1,0,0,0,0,1,10-05-2021 7:33:46
2021-10-05,8:30 AM,4,1,0,0,0,5,10-05-2021 8:32:38
2021-10-05,9:30 AM,5,1,2,1,1,10,10-05-2021 9:29:17
2021-10-05,10:30 AM,4,1,2,1,1,9,10-05-2021 10:30:32
2021-10-05,11:30 AM,6,1,3,1,0,11,10-05-2021 11:54:41
2021-10-05,12:30 PM,15,8,10,6,0,39,10-05-2021 12:29:19
2021-10-05,1:30 PM,4,5,7,6,2,24,10-05-2021 1:32:18
2021-10-05,3:30 PM,5,4,10,3,5,27,10-05-2021 3:32:56
2021-10-05,5:30 PM,10,3,2,1,3,19,10-05-2021 5:33:18
2021-10-05,6:30 PM,4,2,6,3,3,18,10-05-2021 6:38:19
2021-10-05,7:30 PM,8,2,5,4,2,21,10-05-2021 7:32:17
2021-10-05,8:30 PM,0,1,1,4,0,6,10-05-2021 8:37:38
2021-10-06,7:30 AM,0,0,0,0,0,0,10-06-2021 7:36:03
2021-10-06,8:30 AM,1,0,3,0,0,4,10-06-2021 8:40:04
2021-10-06,9:30 AM,3,0,7,0,1,11,10-06-2021 9:29:48
2021-10-06,10:30 AM,6,1,5,0,2,14,10-06-2021 10:31:44
2021-10-06,10:30 AM,4,4,9,2,2,21,10-06-2021 10:33:19
2021-10-06,11:30 AM,4,7,5,5,1,22,10-06-2021 11:31:23
2021-10-06,12:30 PM,7,3,5,2,0,17,10-06-2021 12:58:59
2021-10-06,1:30 PM,5,4,5,2,3,19,10-06-2021 1:34:19
2021-10-06,2:30 PM,4,1,5,3,4,17,10-06-2021 2:37:24
2021-10-06,5:30 PM,4,1,2,0,0,7,10-06-2021 5:30:46
2021-10-06,6:30 PM,6,1,2,0,0,9,10-06-2021 6:31:42
2021-10-06,7:30 PM,5,2,2,1,0,10,10-06-2021 7:31:46
2021-10-06,8:30 PM,3,0,1,3,0,7,10-06-2021 8:30:52
2021-10-07,7:30 AM,0,0,0,0,0,0,10-07-2021 7:35:44
2021-10-07,8:30 AM,0,1,0,0,0,1,10-07-2021 8:30:28
2021-10-07,9:30 AM,3,1,2,0,1,7,10-07-2021 9:37:35
2021-10-07,10:30 AM,5,0,5,0,2,12,10-07-2021 10:29:23
2021-10-07,11:30 AM,4,1,2,2,6,15,10-07-2021 11:32:58
2021-10-07,12:30 PM,4,2,5,4,4,19,10-07-2021 12:33:07
2021-10-07,2:30 PM,4,1,5,0,2,12,10-07-2021 2:29:53
2021-10-07,1:30 PM,4,0,4,0,1,9,10-07-2021 2:30:38
2021-10-07,3:30 PM,4,0,5,0,7,16,10-07-2021 3:35:31
2021-10-07,4:30 PM,3,1,6,2,4,16,10-07-2021 4:23:36
2021-10-07,5:30 PM,2,3,3,0,0,8,10-07-2021 5:33:11
2021-10-07,6:30 PM,8,1,4,0,0,13,10-07-2021 6:36:48
2021-10-07,7:30 PM,7,1,0,1,0,9,10-07-2021 7:31:06
2021-10-07,8:30 PM,3,0,1,0,0,4,10-07-2021 8:30:30
2021-10-08,7:30 AM,2,0,0,0,0,2,10-08-2021 7:33:51
2021-10-08,8:30 AM,2,0,0,0,0,2,10-08-2021 8:29:43
2021-10-08,9:30 AM,2,0,0,0,1,3,10-08-2021 9:28:38
2021-10-08,10:30 AM,3,4,1,0,1,9,10-08-2021 10:30:07
2021-10-08,11:30 AM,3,0,3,1,3,10,10-08-2021 11:29:21
2021-10-08,12:30 PM,2,1,1,0,5,9,10-08-2021 12:31:05
2021-10-08,1:30 PM,2,1,4,0,3,10,10-08-2021 1:33:59
2021-10-08,2:30 PM,7,1,2,0,3,13,10-08-2021 2:33:47
2021-10-08,5:30 PM,1,2,4,1,0,8,10-08-2021 5:30:28
2021-10-08,6:30 PM,1,2,2,2,0,7,10-08-2021 6:31:30
2021-10-08,7:30 PM,2,1,3,0,0,6,10-08-2021 7:31:37
2021-10-08,8:30 PM,2,1,2,0,0,5,10-08-2021 8:31:28
2021-10-09,9:30 AM,2,0,1,0,1,4,10-09-2021 9:36:23
2021-10-09,10:30 AM,0,0,2,0,0,2,10-09-2021 10:31:50
2021-10-09,12:30 PM,6,1,3,0,2,12,10-09-2021 12:30:59
2021-10-09,1:30 PM,3,1,6,0,2,12,10-09-2021 1:26:56
2021-10-11,7:30 AM,1,0,0,0,0,1,10-11-2021 7:34:08
2021-10-11,8:30 AM,4,0,3,0,4,11,10-11-2021 8:32:16
2021-10-11,9:30 AM,5,2,3,0,3,13,10-11-2021 9:34:06
2021-10-11,10:30 AM,16,12,3,4,3,38,10-11-2021 10:32:59
2021-10-11,11:30 AM,7,3,5,0,3,18,10-11-2021 11:50:56
2021-10-11,12:30 PM,5,5,5,3,0,18,10-11-2021 12:39:28
2021-10-11,1:30 PM,4,4,1,2,0,11,10-11-2021 1:32:08
2021-10-11,2:30 PM,6,2,4,2,3,17,10-11-2021 2:35:04
2021-10-12,7:30 AM,0,0,0,0,1,1,10-12-2021 7:34:13
2021-10-12,8:30 AM,3,0,0,0,0,3,10-12-2021 8:30:54
2021-10-12,9:30 AM,4,0,1,0,2,7,10-12-2021 9:27:40
2021-10-12,10:30 AM,9,1,14,1,3,28,10-12-2021 10:32:59
2021-10-12,11:30 AM,4,6,5,0,2,17,10-12-2021 11:33:53
2021-10-12,12:30 PM,5,8,13,4,1,31,10-12-2021 12:41:49
2021-10-12,5:30 PM,6,1,8,0,1,16,10-12-2021 6:32:48
2021-10-12,6:30 PM,4,0,4,0,1,9,10-12-2021 6:33:06
2021-10-12,7:30 PM,4,1,3,0,1,9,10-12-2021 8:31:03
2021-10-12,8:30 PM,3,1,2,0,0,6,10-12-2021 8:31:33
2021-10-13,7:30 AM,1,0,0,0,0,1,10-13-2021 7:34:04
2021-10-13,8:30 AM,1,0,4,0,0,5,10-13-2021 8:31:44
2021-10-13,9:30 AM,4,0,1,0,1,6,10-13-2021 9:32:45
2021-10-13,10:30 AM,4,5,2,2,0,13,10-13-2021 10:36:25
2021-10-13,11:30 AM,5,4,7,3,0,19,10-13-2021 11:33:11
2021-10-13,12:30 PM,7,5,3,0,5,20,10-13-2021 12:33:30
2021-10-13,1:30 PM,3,1,5,2,1,12,10-13-2021 1:51:00
2021-10-13,2:30 PM,4,2,5,3,0,14,10-13-2021 2:58:56
2021-10-13,5:30 PM,2,1,1,0,0,4,10-13-2021 5:40:54
2021-10-13,6:30 PM,2,2,1,1,0,6,10-13-2021 6:31:34
2021-10-13,7:30 PM,2,1,4,1,0,8,10-13-2021 7:30:17
2021-10-13,8:30 PM,1,2,4,1,0,8,10-13-2021 8:29:38
2021-10-14,7:30 AM,1,0,0,0,0,1,10-14-2021 7:46:39
2021-10-14,8:30 AM,1,0,1,0,1,3,10-14-2021 8:32:55
2021-10-14,9:30 AM,5,1,1,0,1,8,10-14-2021 9:30:23
2021-10-14,10:30 AM,5,1,3,0,0,9,10-14-2021 10:25:56
2021-10-14,11:30 AM,5,1,4,1,0,11,10-14-2021 11:29:02
2021-10-14,12:30 PM,13,2,10,4,2,31,10-14-2021 12:33:53
2021-10-14,1:30 PM,6,1,3,1,0,11,10-14-2021 1:32:46
2021-10-14,2:30 PM,5,1,1,1,2,10,10-14-2021 2:32:07
2021-10-14,3:30 PM,5,2,3,1,5,16,10-14-2021 3:32:11
2021-10-14,5:30 PM,2,3,2,0,0,7,10-14-2021 5:31:18
2021-10-14,6:30 PM,4,2,3,2,2,13,10-14-2021 7:35:30
2021-10-14,7:30 PM,2,2,1,0,0,5,10-14-2021 7:35:57
2021-10-14,8:30 PM,2,2,0,0,0,4,10-14-2021 8:31:13
2021-10-15,7:30 AM,1,0,0,0,0,1,10-15-2021 7:33:53
2021-10-15,8:30 AM,1,1,0,0,0,2,10-15-2021 8:29:35
2021-10-15,9:30 AM,3,1,1,0,1,6,10-15-2021 9:28:57
2021-10-15,11:30 AM,6,0,3,1,6,16,10-15-2021 11:28:37
2021-10-15,1:30 PM,1,4,4,1,10,20,10-15-2021 1:34:40
2021-10-15,5:30 PM,1,2,0,0,0,3,10-15-2021 5:34:08
2021-10-15,6:30 PM,1,1,0,0,0,2,10-15-2021 6:30:17
2021-10-15,7:30 PM,2,0,0,1,0,3,10-15-2021 7:30:40
2021-10-15,8:30 PM,2,0,0,0,0,2,10-15-2021 8:31:15
2021-10-16,9:30 AM,2,0,0,0,2,4,10-16-2021 9:30:40
2021-10-16,10:30 AM,0,0,1,0,2,3,10-16-2021 10:32:38
2021-10-16,10:30 AM,0,0,0,0,1,1,10-16-2021 10:33:28
2021-10-16,11:30 AM,2,0,3,0,2,7,10-16-2021 11:35:40
2021-10-16,1:30 PM,4,0,1,0,2,7,10-16-2021 1:44:09
2021-10-16,2:30 PM,2,1,2,0,2,7,10-16-2021 3:17:24
2021-10-16,3:30 PM,3,0,5,0,2,10,10-16-2021 3:39:56
2021-10-16,4:30 PM,4,0,3,0,3,10,10-16-2021 4:31:45
2021-10-16,4:30 PM,3,1,4,1,3,12,10-16-2021 4:47:19
2021-10-18,7:30 AM,1,0,0,0,0,1,10-18-2021 7:34:24
2021-10-18,8:30 AM,5,0,2,0,4,11,10-18-2021 8:32:42
2021-10-18,9:30 AM,10,0,2,3,3,18,10-18-2021 9:30:10
2021-10-18,10:30 AM,6,1,4,2,2,15,10-18-2021 10:32:22
2021-10-18,1:30 PM,6,3,6,3,2,20,10-18-2021 1:41:12
2021-10-18,2:30 PM,4,1,8,1,1,15,10-18-2021 2:33:20
2021-10-18,4:30 PM,9,1,3,1,3,17,10-18-2021 4:39:53
2021-10-18,5:30 PM,8,2,2,1,0,13,10-18-2021 5:30:18
2021-10-18,6:30 PM,4,2,2,0,1,9,10-18-2021 6:32:41
2021-10-18,7:30 PM,3,1,1,1,0,6,10-18-2021 7:56:12
2021-10-18,8:30 PM,1,2,2,0,0,5,10-18-2021 8:30:59
2021-10-19,7:30 AM,1,0,0,0,0,1,10-19-2021 7:36:36
2021-10-19,8:30 AM,3,0,0,0,0,3,10-19-2021 8:32:19
2021-10-19,9:30 AM,2,0,4,0,1,7,10-19-2021 9:35:50
2021-10-19,10:30 AM,10,0,10,2,0,22,10-19-2021 10:29:39
2021-10-19,11:30 AM,6,3,6,2,1,18,10-19-2021 11:27:38
2021-10-19,12:30 PM,13,7,12,4,0,36,10-19-2021 12:28:32
2021-10-19,1:30 PM,4,7,7,15,5,38,10-19-2021 1:34:15
2021-10-19,2:30 PM,4,5,4,7,4,24,10-19-2021 2:35:29
2021-10-19,5:30 PM,6,1,2,1,0,10,10-19-2021 5:32:48
2021-10-19,6:30 PM,5,3,3,0,0,11,10-19-2021 6:32:30
2021-10-19,7:30 PM,5,3,6,0,0,14,10-19-2021 7:30:34
2021-10-19,8:30 PM,3,1,3,0,0,7,10-19-2021 8:29:49
2021-10-20,7:30 AM,1,0,0,0,0,1,10-20-2021 7:32:55
2021-10-20,8:30 AM,2,0,2,0,0,4,10-20-2021 8:31:30
2021-10-20,9:30 AM,6,2,5,3,2,18,10-20-2021 9:27:29
2021-10-20,10:30 AM,7,3,6,0,6,22,10-20-2021 10:33:22
2021-10-20,11:30 AM,8,4,9,19,6,46,10-20-2021 11:31:14
2021-10-20,1:30 PM,8,1,6,4,1,20,10-20-2021 1:50:52
2021-10-20,2:30 PM,5,2,8,3,4,22,10-20-2021 2:30:31
2021-10-20,3:30 PM,5,3,4,4,3,19,10-20-2021 3:43:48
2021-10-20,4:30 PM,8,1,5,0,0,14,10-20-2021 4:30:46
2021-10-20,5:30 PM,1,1,6,0,0,8,10-20-2021 5:32:39
2021-10-20,6:30 PM,2,1,4,0,0,7,10-20-2021 6:35:21
2021-10-20,7:30 PM,0,0,3,0,0,3,10-20-2021 7:32:32
2021-10-20,8:30 PM,1,1,2,0,0,4,10-20-2021 8:31:16
2021-10-21,7:30 AM,1,0,1,0,0,2,10-21-2021 7:33:34
2021-10-21,8:30 AM,3,1,1,0,2,7,10-21-2021 8:39:56
2021-10-21,9:30 AM,3,0,4,1,3,11,10-21-2021 9:31:53
2021-10-21,10:30 AM,9,0,6,3,1,19,10-21-2021 10:30:59
2021-10-21,11:30 AM,9,2,3,2,2,18,10-21-2021 11:33:56
2021-10-21,12:30 PM,10,3,7,7,4,31,10-21-2021 12:34:58
2021-10-21,2:30 PM,5,2,5,2,4,18,10-21-2021 2:36:02
2021-10-21,3:30 PM,4,2,5,2,2,15,10-21-2021 4:50:34
2021-10-21,4:30 PM,1,1,3,2,2,9,10-21-2021 4:51:04
2021-10-21,5:30 PM,8,2,3,0,0,13,10-21-2021 5:33:25
2021-10-21,6:30 PM,1,2,1,2,0,6,10-21-2021 6:31:49
2021-10-21,7:30 PM,4,1,2,2,0,9,10-21-2021 7:32:26
2021-10-21,8:30 PM,5,2,2,0,0,9,10-21-2021 8:29:52
2021-10-22,7:30 AM,2,0,0,0,0,2,10-22-2021 7:34:39
2021-10-22,8:30 AM,1,0,0,0,1,2,10-22-2021 8:28:33
2021-10-22,9:30 AM,3,1,1,0,3,8,10-22-2021 9:30:19
2021-10-22,10:30 AM,5,1,1,0,2,9,10-22-2021 10:36:17
2021-10-22,11:30 AM,4,0,1,1,3,9,10-22-2021 11:33:40
2021-10-22,12:30 PM,7,0,4,0,7,18,10-22-2021 12:33:00
2021-10-22,5:30 PM,1,1,0,0,0,2,10-22-2021 5:31:13
2021-10-22,6:30 PM,2,0,0,0,0,2,10-22-2021 6:30:10
2021-10-22,7:30 PM,3,0,0,1,0,4,2021-10-23T00:29:46.267Z
2021-10-22,8:30 PM,1,0,0,1,0,2,2021-10-23T01:29:42.468Z
2021-10-23,9:30 AM,3,0,0,0,0,3,2021-10-23T14:29:56.118Z
2021-10-23,10:30 AM,1,0,0,0,1,2,2021-10-23T15:36:57.338Z
2021-10-23,11:30 AM,1,0,0,0,1,2,2021-10-23T16:54:00.158Z
2021-10-25,7:30 AM,1,0,0,0,0,1,2021-10-25T12:33:25.434Z
2021-10-25,8:30 AM,2,0,3,0,1,6,2021-10-25T13:29:41.687Z
2021-10-25,9:30 AM,4,0,4,1,3,12,2021-10-25T14:32:11.167Z
2021-10-25,12:30 PM,6,6,10,9,7,38,2021-10-25T17:33:48.986Z
2021-10-25,1:30 PM,4,5,10,15,5,39,2021-10-25T18:47:45.754Z
2021-10-25,2:30 PM,9,4,6,3,4,26,2021-10-25T19:30:17.339Z
2021-10-25,5:30 PM,6,1,2,0,1,10,2021-10-25T22:30:29.064Z
2021-10-25,6:30 PM,3,2,1,1,0,7,2021-10-25T23:30:41.382Z
2021-10-25,7:30 PM,3,0,1,0,0,4,2021-10-26T00:29:39.147Z
2021-10-25,8:30 PM,2,0,1,2,0,5,2021-10-26T01:29:00.347Z
2021-10-26,7:30 AM,1,0,0,0,0,1,2021-10-26T12:34:09.211Z
2021-10-26,8:30 AM,3,1,2,0,1,7,2021-10-26T13:30:57.556Z
2021-10-26,9:30 AM,4,2,6,0,2,14,2021-10-26T14:38:12.551Z
2021-10-26,10:30 AM,7,2,7,0,0,16,2021-10-26T15:34:00.587Z
2021-10-26,11:30 AM,6,2,4,6,0,18,2021-10-26T16:35:30.624Z
2021-10-26,12:30 PM,20,6,15,20,5,66,2021-10-26T17:40:41.182Z
2021-10-26,4:30 PM,3,3,11,2,2,21,2021-10-26T21:36:39.503Z
2021-10-26,5:30 PM,4,1,5,0,0,10,2021-10-26T22:35:22.740Z
2021-10-26,6:30 PM,2,2,5,3,2,14,2021-10-26T23:30:58.352Z
2021-10-26,7:30 PM,6,2,3,0,0,11,2021-10-27T01:31:07.637Z
2021-10-26,8:30 PM,2,1,0,0,0,3,2021-10-27T01:31:26.797Z
2021-10-27,7:30 AM,0,0,0,0,1,1,2021-10-27T12:34:18.152Z
2021-10-27,8:30 AM,2,0,4,0,0,6,2021-10-27T13:30:49.333Z
2021-10-27,9:30 AM,4,2,5,0,2,13,2021-10-27T14:34:39.713Z
2021-10-27,10:30 AM,8,2,6,0,0,16,2021-10-27T15:34:27.863Z
2021-10-27,11:30 AM,6,1,6,0,0,13,2021-10-27T16:33:15.275Z
2021-10-27,1:30 PM,5,2,11,1,0,19,2021-10-27T18:31:20.373Z
2021-10-27,2:30 PM,5,3,7,2,0,17,2021-10-27T19:38:05.601Z
2021-10-27,3:30 PM,6,2,6,0,0,14,2021-10-27T20:36:16.062Z
2021-10-27,5:30 PM,4,2,0,2,0,8,2021-10-27T22:33:09.298Z
2021-10-27,6:30 PM,3,1,0,3,0,7,2021-10-27T23:34:20.731Z
2021-10-27,7:30 PM,2,0,0,2,0,4,2021-10-28T00:29:58.050Z
2021-10-27,8:30 PM,2,0,1,0,0,3,2021-10-28T01:31:55.555Z
2021-10-28,7:30 AM,0,0,0,0,0,0,2021-10-28T12:42:03.570Z
2021-10-28,8:30 AM,1,1,0,0,1,3,2021-10-28T13:32:22.935Z
2021-10-28,9:30 AM,11,1,11,2,0,25,2021-10-28T14:48:12.965Z
2021-10-28,10:30 AM,9,0,9,1,4,23,2021-10-28T15:33:47.097Z
2021-10-28,11:30 AM,7,2,3,2,2,16,2021-10-28T16:32:37.412Z
2021-10-28,3:30 PM,5,2,2,2,3,14,2021-10-28T20:34:22.252Z
2021-10-28,5:30 PM,5,2,2,0,1,10,2021-10-28T22:33:44.952Z
2021-10-29,7:30 AM,1,0,0,0,0,1,2021-10-29T12:34:26.531Z
2021-10-29,8:30 AM,1,0,0,1,0,2,2021-10-29T13:30:33.142Z
2021-10-29,9:30 AM,2,0,1,1,1,5,2021-10-29T14:31:34.425Z
2021-10-29,10:30 AM,4,0,3,3,0,10,2021-10-29T15:34:14.271Z
2021-10-29,11:30 AM,4,0,5,3,0,12,2021-10-29T16:37:09.549Z
2021-10-29,2:30 PM,2,3,7,0,4,16,2021-10-29T19:30:36.103Z
2021-10-29,3:30 PM,5,3,2,0,0,10,2021-10-29T20:33:34.305Z
2021-10-29,6:30 PM,0,0,1,0,0,1,2021-10-29T23:44:53.888Z
2021-10-29,8:30 PM,2,0,0,0,0,2,2021-10-30T01:34:24.827Z
2021-10-29,7:30 PM,2,0,0,0,0,2,2021-10-30T01:34:51.011Z
2021-10-30,9:30 AM,0,0,0,2,0,2,2021-10-30T14:31:26.832Z
2021-10-30,9:30 AM,0,0,0,2,0,2,2021-10-30T14:37:30.361Z
2021-10-30,10:30 AM,1,0,0,2,0,3,2021-10-30T15:32:17.624Z
2021-10-30,1:30 PM,2,0,0,2,0,4,2021-10-30T18:28:04.124Z
2021-10-30,11:30 PM,1,0,0,0,0,1,2021-10-30T18:28:30.876Z
2021-10-30,12:30 PM,4,0,0,2,0,6,2021-10-30T18:29:01.931Z
2021-10-30,2:30 PM,5,3,3,4,0,15,2021-10-30T19:55:48.771Z
2021-10-30,3:30 PM,3,0,3,0,0,6,2021-10-30T20:29:47.022Z
2021-10-30,4:30 PM,3,0,2,0,0,5,2021-10-30T21:31:06.785Z
2021-10-30,4:30 PM,6,1,3,0,0,10,2021-10-30T21:42:53.561Z
2021-11-01,7:30 AM,1,0,0,0,0,1,2021-11-01T12:34:00.529Z
2021-11-01,8:30 AM,1,1,1,0,0,3,2021-11-01T13:28:02.233Z
2021-11-01,9:30 AM,3,1,4,0,0,8,2021-11-01T14:30:41.782Z
2021-11-01,10:30 AM,8,3,4,4,0,19,2021-11-01T15:31:59.237Z
2021-11-01,1:30 PM,8,4,8,0,0,20,2021-11-01T18:29:09.182Z
2021-11-01,2:30 PM,6,1,4,2,0,13,2021-11-01T19:31:51.077Z
2021-11-01,5:30 PM,7,1,4,3,0,15,2021-11-01T22:30:39.936Z
2021-11-01,6:30 PM,1,1,4,2,0,8,2021-11-01T23:32:19.883Z
2021-11-01,7:30 PM,2,2,4,1,0,9,2021-11-02T00:35:25.405Z
2021-11-01,8:30 PM,3,2,2,0,0,7,2021-11-02T01:30:17.439Z
2021-11-02,7:30 AM,0,0,0,0,0,0,2021-11-02T12:34:51.832Z
2021-11-02,8:30 AM,3,0,2,1,0,6,2021-11-02T13:31:14.781Z
2021-11-02,9:30 AM,3,0,1,0,1,5,2021-11-02T14:32:27.766Z
2021-11-02,10:30 AM,4,0,5,1,0,10,2021-11-02T15:35:01.946Z
2021-11-02,11:30 AM,3,2,10,3,1,19,2021-11-02T16:30:00.504Z
2021-11-02,12:30 PM,10,6,18,9,0,43,2021-11-02T17:29:47.901Z
2021-11-02,3:30 PM,5,4,7,5,0,21,2021-11-02T20:44:52.598Z
2021-11-02,6:30 PM,6,3,3,0,0,12,2021-11-02T23:36:07.679Z
2021-11-03,7:30 PM,6,2,2,3,0,13,2021-11-03T12:24:45.527Z
2021-11-03,8:30 PM,3,2,2,3,0,10,2021-11-03T12:25:26.398Z
2021-11-03,7:30 AM,0,0,0,0,0,0,2021-11-03T12:38:26.615Z
2021-11-03,8:30 AM,5,0,2,0,0,7,2021-11-03T13:32:43.482Z
2021-11-03,9:30 AM,3,1,2,0,0,6,2021-11-03T14:31:34.617Z
2021-11-03,10:30 AM,6,4,7,1,1,19,2021-11-03T15:29:58.635Z
2021-11-03,12:30 PM,10,7,7,6,0,30,2021-11-03T17:38:00.934Z
2021-11-03,1:30 PM,13,5,17,1,3,39,2021-11-03T18:36:58.643Z
2021-11-03,2:30 PM,7,5,13,2,3,30,2021-11-03T19:31:43.883Z
2021-11-03,3:30 PM,5,5,15,1,2,28,2021-11-03T20:32:21.649Z
2021-11-03,4:30 PM,5,1,4,1,0,11,2021-11-03T21:29:55.462Z
2021-11-03,5:30 PM,6,4,5,2,0,17,2021-11-03T22:29:59.470Z
2021-11-03,6:30 PM,4,1,0,2,0,7,2021-11-03T23:36:38.159Z
2021-11-03,7:30 PM,4,1,0,2,0,7,2021-11-04T00:30:29.677Z
2021-11-03,8:30 PM,2,1,0,0,0,3,2021-11-04T01:31:03.912Z
2021-11-04,7:30 AM,0,0,0,0,0,0,2021-11-04T12:33:17.759Z
2021-11-04,8:30 AM,1,0,0,0,0,1,2021-11-04T13:33:54.111Z
2021-11-04,10:30 AM,8,7,5,1,3,24,2021-11-04T15:31:07.446Z
2021-11-04,2:30 PM,10,2,5,0,0,17,2021-11-04T19:31:43.944Z
2021-11-04,3:30 PM,6,2,5,2,0,15,2021-11-04T20:31:22.171Z
2021-11-04,5:30 PM,6,1,3,0,1,11,2021-11-04T22:37:38.266Z
2021-11-04,6:30 PM,4,1,3,0,0,8,2021-11-04T23:35:12.663Z
2021-11-04,7:30 PM,1,1,0,1,0,3,2021-11-05T00:29:14.760Z
2021-11-04,8:30 PM,1,0,1,0,0,2,2021-11-05T01:30:36.287Z
2021-11-05,7:30 AM,1,0,0,0,0,1,2021-11-05T12:37:31.536Z
2021-11-05,8:30 AM,1,0,0,0,0,1,2021-11-05T13:31:20.016Z
2021-11-05,9:30 AM,1,0,2,0,1,4,2021-11-05T14:29:42.748Z
2021-11-05,10:30 AM,7,0,1,0,0,8,2021-11-05T15:34:43.296Z
2021-11-05,11:30 AM,6,1,2,0,1,10,2021-11-05T16:31:26.174Z
2021-11-05,12:30 PM,5,2,4,1,0,12,2021-11-05T17:38:23.840Z
2021-11-05,1:30 PM,5,0,5,1,2,13,2021-11-05T18:32:05.693Z
2021-11-05,3:30 PM,6,1,4,0,0,11,2021-11-05T23:32:44.048Z
2021-11-05,4:30 PM,5,0,4,0,0,9,2021-11-05T23:33:02.912Z
2021-11-05,5:30 PM,4,0,4,1,0,9,2021-11-05T23:33:21.567Z
2021-11-05,6:30 PM,3,0,0,0,0,3,2021-11-05T23:33:51.839Z
2021-11-05,8:30 PM,3,0,1,0,0,4,2021-11-06T01:31:06.247Z
2021-11-06,9:30 PM,0,0,0,0,0,0,2021-11-06T18:29:53.068Z
2021-11-06,10:30 PM,2,0,2,0,0,4,2021-11-06T18:30:11.572Z
2021-11-06,11:30 PM,2,0,3,0,1,6,2021-11-06T18:30:34.739Z
2021-11-06,12:30 PM,3,0,3,0,2,8,2021-11-06T18:31:07.987Z
2021-11-06,1:30 PM,5,2,2,0,0,9,2021-11-06T18:31:26.740Z
2021-11-06,2:30 PM,6,3,7,1,0,17,2021-11-06T19:19:41.686Z
2021-11-06,3:30 PM,7,3,7,3,0,20,2021-11-06T20:16:19.436Z
2021-11-08,7:30 AM,1,0,0,0,0,1,2021-11-08T14:10:25.341Z
2021-11-08,8:30 AM,4,0,2,0,0,6,2021-11-08T14:39:53.459Z
2021-11-08,9:30 AM,8,0,2,0,0,10,2021-11-08T15:33:17.164Z
2021-11-08,1:30 PM,5,4,3,5,1,18,2021-11-08T19:42:10.772Z
2021-11-08,2:30 PM,3,5,6,4,0,18,2021-11-08T20:30:47.898Z
2021-11-08,3:30 PM,7,3,4,2,0,16,2021-11-08T21:34:14.364Z
2021-11-08,4:30 PM,4,3,4,2,0,13,2021-11-08T22:29:59.012Z
2021-11-08,5:30 PM,4,1,3,1,0,9,2021-11-08T23:29:35.547Z
2021-11-08,6:30 PM,6,1,2,1,0,10,2021-11-09T00:41:51.160Z
2021-11-08,7:30 PM,2,1,2,1,0,6,2021-11-09T01:34:31.067Z
2021-11-08,8:30 PM,1,1,1,1,0,4,2021-11-09T02:29:46.234Z
2021-11-09,7:30 AM,1,0,0,0,0,1,2021-11-09T13:35:44.448Z
2021-11-09,8:30 AM,2,2,0,0,3,7,2021-11-09T14:32:52.961Z
2021-11-09,9:30 AM,9,3,5,0,1,18,2021-11-09T15:32:16.476Z
2021-11-09,10:30 AM,5,4,14,2,1,26,2021-11-09T16:38:48.713Z
2021-11-09,11:30 AM,8,6,9,0,1,24,2021-11-09T17:31:58.220Z
2021-11-09,12:30 PM,13,6,7,8,0,34,2021-11-09T18:28:34.574Z
2021-11-09,3:30 PM,5,4,7,4,3,23,2021-11-09T21:29:55.569Z
2021-11-09,4:30 PM,5,2,10,4,5,26,2021-11-09T22:32:02.231Z
2021-11-10,7:30 AM,0,0,0,0,0,0,2021-11-10T13:33:57.559Z
2021-11-10,8:30 AM,1,0,2,0,0,3,2021-11-10T14:30:32.257Z
2021-11-10,11:30 AM,8,3,5,2,1,19,2021-11-10T17:35:25.293Z
2021-11-10,12:30 PM,5,1,7,2,0,15,2021-11-10T18:45:09.406Z
2021-11-10,1:30 PM,4,2,6,1,1,14,2021-11-10T19:37:06.164Z
2021-11-10,2:30 PM,5,1,5,1,5,17,2021-11-10T20:29:33.076Z
2021-11-10,3:30 PM,3,2,3,1,1,10,2021-11-10T21:36:11.128Z
2021-11-10,5:30 PM,3,1,1,0,0,5,2021-11-10T23:29:50.377Z
2021-11-10,6:30 PM,2,2,2,0,0,6,2021-11-11T00:31:54.588Z
2021-11-10,7:30 PM,1,1,2,0,0,4,2021-11-11T01:33:33.597Z
2021-11-10,8:30 PM,2,2,1,0,0,5,2021-11-11T02:28:52.399Z
2021-11-11,7:30 AM,0,0,0,0,0,0,2021-11-11T13:32:39.262Z
2021-11-11,8:30 AM,2,0,0,0,0,2,2021-11-11T15:09:18.945Z
2021-11-11,9:30 AM,9,0,4,1,1,15,2021-11-11T15:29:18.740Z
2021-11-11,10:30 AM,7,3,7,0,3,20,2021-11-11T16:29:51.779Z
2021-11-11,11:30 AM,5,2,3,1,0,11,2021-11-11T17:34:09.186Z
2021-11-11,1:30 PM,6,1,4,0,0,11,2021-11-11T22:52:51.217Z
2021-11-11,2:30 PM,6,2,4,0,0,12,2021-11-11T22:53:09.704Z
2021-11-11,3:30 PM,7,3,4,0,0,14,2021-11-11T22:53:39.112Z
2021-11-11,4:30 PM,6,3,4,0,0,13,2021-11-11T22:54:03.144Z
2021-11-11,5:30 PM,4,2,4,1,0,11,2021-11-11T23:35:01.224Z
2021-11-11,6:30 PM,5,1,4,1,0,11,2021-11-12T00:28:01.462Z
2021-11-11,7:30 PM,4,1,3,0,0,8,2021-11-12T01:32:25.689Z
2021-11-11,8:30 PM,4,1,2,0,0,7,2021-11-12T02:30:21.376Z
2021-11-12,7:30 AM,2,0,0,0,0,2,2021-11-12T14:02:45.169Z
2021-11-12,8:30 AM,2,2,0,0,0,4,2021-11-12T14:31:26.108Z
2021-11-12,9:30 AM,2,3,0,0,0,5,2021-11-12T15:34:52.406Z
2021-11-12,10:30 AM,3,3,0,0,0,6,2021-11-12T16:29:14.583Z
2021-11-12,11:30 AM,3,3,2,0,1,9,2021-11-12T17:31:21.647Z
2021-11-12,12:30 PM,5,4,5,0,2,16,2021-11-12T18:31:15.145Z
2021-11-12,1:30 PM,4,5,5,2,1,17,2021-11-12T19:31:59.393Z
2021-11-12,4:30 PM,4,3,2,3,1,13,2021-11-12T22:31:49.385Z
2021-11-12,5:30 PM,3,2,1,2,0,8,2021-11-12T23:37:47.160Z
2021-11-12,6:30 PM,3,1,1,0,0,5,2021-11-13T01:01:36.106Z
2021-11-12,7:30 PM,3,1,0,2,0,6,2021-11-13T01:30:36.508Z
2021-11-12,8:30 PM,4,1,0,0,0,5,2021-11-13T02:31:32.387Z
2021-11-13,9:30 AM,2,1,1,0,0,4,2021-11-13T15:31:31.873Z
2021-11-13,10:30 AM,0,1,1,0,0,2,2021-11-13T16:30:09.146Z
2021-11-13,11:30 AM,2,1,1,2,2,8,2021-11-13T17:28:41.915Z
2021-11-13,12:30 PM,3,1,2,0,0,6,2021-11-13T19:28:37.613Z
2021-11-13,1:30 PM,4,1,2,1,0,8,2021-11-13T19:28:57.315Z
2021-11-13,2:30 PM,5,3,3,2,0,13,2021-11-13T20:52:55.966Z
2021-11-13,4:30 PM,6,2,4,1,0,13,2021-11-13T22:27:53.874Z
2021-11-15,7:30 AM,0,0,0,0,0,0,2021-11-15T13:34:26.142Z
2021-11-15,8:30 AM,3,0,2,0,0,5,2021-11-15T14:31:18.466Z
2021-11-15,9:30 AM,4,0,3,0,0,7,2021-11-15T15:34:43.314Z
2021-11-15,10:30 AM,5,2,4,0,0,11,2021-11-15T16:33:09.014Z
2021-11-15,2:30 PM,5,5,3,2,0,15,2021-11-15T20:43:34.553Z
2021-11-15,3:30 PM,6,1,3,5,0,15,2021-11-15T21:40:02.758Z
2021-11-15,4:30 PM,6,2,2,4,0,14,2021-11-15T22:31:06.544Z
2021-11-15,5:30 PM,7,3,2,1,1,14,2021-11-15T23:29:53.090Z
2021-11-15,6:30 PM,2,1,3,1,0,7,2021-11-16T00:30:56.902Z
2021-11-15,7:30 PM,2,0,1,2,1,6,2021-11-16T01:30:28.451Z
2021-11-15,8:30 PM,1,2,0,2,1,6,2021-11-16T02:31:52.658Z
2021-11-16,7:30 AM,0,0,0,0,0,0,2021-11-16T13:36:17.386Z
2021-11-16,8:30 AM,3,0,1,1,0,5,2021-11-16T14:31:54.657Z
2021-11-16,9:30 AM,1,1,4,4,0,10,2021-11-16T15:30:17.676Z
2021-11-16,10:30 AM,5,2,17,5,0,29,2021-11-16T16:31:40.287Z
2021-11-16,11:30 AM,5,2,7,3,0,17,2021-11-16T17:29:59.407Z
2021-11-16,12:30 PM,8,7,13,4,3,35,2021-11-16T18:36:01.848Z
2021-11-16,1:30 PM,4,3,7,6,1,21,2021-11-16T19:29:15.258Z
2021-11-16,2:30 PM,6,2,8,4,1,21,2021-11-16T20:38:09.047Z
2021-11-16,3:30 PM,5,2,8,3,0,18,2021-11-16T21:34:23.781Z
2021-11-16,4:30 PM,5,1,5,3,0,14,2021-11-16T22:33:19.370Z
2021-11-16,5:30 PM,4,0,4,0,0,8,2021-11-17T00:30:36.540Z
2021-11-16,6:30 PM,1,0,2,0,0,3,2021-11-17T00:30:54.699Z
2021-11-16,8:30 PM,2,0,2,2,0,6,2021-11-17T02:29:30.313Z
2021-11-17,7:30 AM,0,0,0,0,0,0,2021-11-17T13:31:38.566Z
2021-11-17,8:30 AM,2,0,3,0,0,5,2021-11-17T14:32:51.340Z
2021-11-17,9:30 AM,2,3,3,0,1,9,2021-11-17T15:33:02.500Z
2021-11-17,10:30 AM,3,5,4,0,0,12,2021-11-17T16:30:54.755Z
2021-11-17,11:30 AM,7,5,8,3,4,27,2021-11-17T17:34:48.951Z
2021-11-17,1:30 PM,4,4,8,2,5,23,2021-11-17T19:33:34.550Z
2021-11-17,2:30 PM,5,1,4,2,1,13,2021-11-17T20:29:26.932Z
2021-11-17,3:30 PM,3,4,3,1,0,11,2021-11-17T21:29:11.853Z
2021-11-17,4:30 PM,3,3,10,1,1,18,2021-11-17T22:32:12.083Z
2021-11-17,6:30 PM,4,1,3,0,0,8,2021-11-18T00:00:58.963Z
2021-11-17,6:30 PM,6,0,1,0,0,7,2021-11-18T00:31:01.649Z
2021-11-17,7:30 PM,2,0,2,0,1,5,2021-11-18T01:33:07.284Z
2021-11-17,8:30 PM,1,0,1,0,0,2,2021-11-18T02:30:20.180Z
2021-11-18,7:30 AM,1,0,0,0,0,1,2021-11-18T13:32:17.508Z
2021-11-18,8:30 AM,2,0,1,0,0,3,2021-11-18T14:33:13.618Z
2021-11-18,9:30 AM,2,2,7,0,1,12,2021-11-18T15:36:18.976Z
2021-11-18,10:30 AM,3,4,8,1,1,17,2021-11-18T16:29:59.716Z
2021-11-18,11:30 AM,5,2,3,0,1,11,2021-11-18T17:32:56.823Z
2021-11-18,12:30 PM,5,3,8,8,3,27,2021-11-18T18:32:01.199Z
2021-11-18,1:30 PM,8,2,6,0,0,16,2021-11-18T19:30:07.861Z
2021-11-18,2:30 PM,7,1,4,0,0,12,2021-11-18T20:34:40.749Z
2021-11-18,4:30 PM,6,1,3,1,0,11,2021-11-18T22:30:10.642Z
2021-11-18,5:30 PM,6,1,5,0,0,12,2021-11-18T23:29:54.832Z
2021-11-18,6:30 PM,1,1,2,0,0,4,2021-11-19T00:27:32.203Z
2021-11-18,7:30 PM,2,1,0,0,0,3,2021-11-19T01:29:52.866Z
2021-11-18,8:30 PM,1,1,0,0,0,2,2021-11-19T02:30:39.165Z
2021-11-19,7:30 AM,1,0,0,0,0,1,2021-11-19T13:35:06.375Z
2021-11-19,8:30 AM,1,0,1,0,1,3,2021-11-19T14:34:06.886Z
2021-11-19,9:30 AM,3,1,2,0,0,6,2021-11-19T15:30:54.714Z
2021-11-19,10:30 AM,4,1,1,0,0,6,2021-11-19T16:32:24.275Z
2021-11-19,11:30 AM,3,1,1,0,1,6,2021-11-19T17:37:03.577Z
2021-11-19,12:30 PM,4,3,2,0,0,9,2021-11-19T18:32:37.832Z
2021-11-19,2:30 PM,5,4,3,2,0,14,2021-11-19T20:46:16.175Z
2021-11-19,3:30 PM,3,1,2,0,0,6,2021-11-19T21:26:35.796Z
2021-11-19,4:30 PM,5,1,3,0,0,9,2021-11-19T22:41:10.804Z
2021-11-19,5:30 PM,3,0,4,0,0,7,2021-11-19T23:32:04.953Z
2021-11-19,8:30 PM,2,0,3,0,0,5,2021-11-20T02:31:12.710Z
2021-11-20,9:30 AM,0,0,0,0,0,0,2021-11-20T15:30:19.877Z
2021-11-20,10:30 AM,1,0,0,0,0,1,2021-11-20T16:37:11.977Z
2021-11-20,1:30 PM,3,1,0,2,0,6,2021-11-20T19:37:50.711Z
2021-11-20,2:30 PM,6,1,1,2,0,10,2021-11-20T20:26:12.990Z
2021-11-20,3:30 PM,7,0,2,2,0,11,2021-11-20T21:31:19.572Z
2021-11-20,3:30 PM,5,2,1,3,0,11,2021-11-20T21:31:58.822Z
2021-11-22,7:30 AM,0,0,0,0,0,0,2021-11-22T13:29:30.430Z
2021-11-22,8:30 AM,4,1,2,0,0,7,2021-11-22T14:31:39.949Z
2021-11-22,9:30 AM,6,0,0,0,0,6,2021-11-22T15:33:38.724Z
2021-11-22,10:30 AM,7,1,1,0,0,9,2021-11-22T16:33:04.296Z
2021-11-22,1:30 PM,5,1,3,0,0,9,2021-11-22T19:40:50.695Z
2021-11-22,2:30 PM,4,1,2,0,4,11,2021-11-22T20:30:25.844Z
2021-11-22,3:30 PM,5,1,3,0,1,10,2021-11-22T21:33:19.660Z
2021-11-22,4:30 PM,6,3,1,0,1,11,2021-11-22T22:31:17.526Z
2021-11-22,5:30 PM,4,2,3,0,0,9,2021-11-22T23:31:03.640Z
2021-11-22,6:30 PM,6,1,5,0,0,12,2021-11-23T00:30:06.115Z
2021-11-22,7:30 PM,1,1,2,0,0,4,2021-11-23T01:30:33.231Z
2021-11-22,8:30 PM,3,1,0,0,0,4,2021-11-23T02:29:32.910Z
2021-11-23,7:30 AM,0,0,0,0,0,0,2021-11-23T13:31:39.899Z
2021-11-23,8:30 AM,2,0,0,0,0,2,2021-11-23T14:30:17.939Z
2021-11-23,9:30 AM,6,0,0,0,4,10,2021-11-23T15:31:46.336Z
2021-11-23,10:30 AM,7,3,2,0,0,12,2021-11-23T16:31:55.540Z
2021-11-23,11:30 AM,4,2,2,0,1,9,2021-11-23T17:27:45.257Z
2021-11-23,12:30 PM,7,2,4,0,0,13,2021-11-23T18:22:11.007Z
2021-11-23,1:30 PM,7,2,5,6,1,21,2021-11-23T19:29:59.475Z
2021-11-23,4:30 PM,5,2,4,0,2,13,2021-11-23T22:32:01.782Z
2021-11-23,5:30 PM,6,1,1,0,0,8,2021-11-24T00:07:05.695Z
2021-11-23,6:30 PM,4,1,0,0,0,5,2021-11-24T00:31:38.021Z
2021-11-23,7:30 PM,1,1,0,0,0,2,2021-11-24T02:28:37.297Z
2021-11-23,8:30 PM,2,1,0,0,0,3,2021-11-24T02:28:59.368Z
2021-11-29,7:30 AM,0,0,0,0,0,0,2021-11-29T13:56:56.280Z
2021-11-29,8:30 AM,3,0,0,2,0,5,2021-11-29T14:32:57.904Z
2021-11-29,9:30 AM,5,1,2,2,1,11,2021-11-29T15:32:15.884Z
2021-11-29,3:30 PM,5,3,4,1,0,13,2021-11-29T21:42:17.339Z
2021-11-29,4:30 PM,5,3,7,2,0,17,2021-11-29T22:29:54.943Z
2021-11-29,5:30 PM,4,1,7,1,0,13,2021-11-29T23:29:04.381Z
2021-11-29,6:30 PM,6,0,1,0,0,7,2021-11-30T00:28:20.627Z
2021-11-29,7:30 PM,9,1,0,0,0,10,2021-11-30T01:30:41.860Z
2021-11-29,8:30 PM,2,0,0,0,0,2,2021-11-30T02:31:44.471Z
2021-11-30,7:30 AM,0,0,0,0,0,0,2021-11-30T13:31:40.053Z
2021-11-30,8:30 AM,2,0,0,1,0,3,2021-11-30T14:32:05.440Z
2021-11-30,9:30 AM,2,1,0,0,0,3,2021-11-30T15:33:31.181Z
2021-11-30,10:30 AM,3,1,8,0,3,15,2021-11-30T16:31:14.109Z
2021-11-30,11:30 AM,5,2,3,1,1,12,2021-11-30T17:32:54.102Z
2021-11-30,3:30 PM,10,2,5,0,0,17,2021-11-30T21:31:04.052Z
2021-11-30,5:30 PM,6,1,1,1,0,9,2021-11-30T23:35:18.842Z
2021-12-01,7:30 AM,0,0,0,0,0,0,2021-12-01T13:51:51.640Z
2021-12-01,8:30 AM,16,0,1,0,0,17,2021-12-01T14:35:59.125Z
2021-12-01,10:30 AM,9,5,10,0,2,26,2021-12-01T16:34:57.722Z
2021-12-01,1:30 PM,7,3,4,0,0,14,2021-12-01T19:42:52.913Z
2021-12-01,2:30 PM,9,3,5,1,3,21,2021-12-01T20:34:05.056Z
2021-12-01,3:30 PM,8,4,7,1,0,20,2021-12-01T21:29:42.611Z
2021-12-01,4:30 PM,8,2,6,1,0,17,2021-12-01T22:32:56.964Z
2021-12-01,5:30 PM,7,0,3,1,0,11,2021-12-01T23:31:57.728Z
2021-12-01,6:30 PM,3,1,3,2,0,9,2021-12-02T00:27:26.739Z
2021-12-01,7:30 PM,2,0,2,1,0,5,2021-12-02T01:32:32.071Z
2021-12-01,8:30 PM,2,0,0,1,0,3,2021-12-02T02:28:57.237Z
2021-12-02,7:30 AM,0,0,0,0,0,0,2021-12-02T13:35:49.093Z
2021-12-02,8:30 AM,4,0,1,0,0,5,2021-12-02T14:55:56.466Z
2021-12-02,9:30 AM,6,2,3,0,1,12,2021-12-02T15:28:01.081Z
2021-12-02,10:30 AM,10,3,10,0,2,25,2021-12-02T16:31:10.165Z
2021-12-02,11:30 AM,8,0,3,0,1,12,2021-12-02T17:33:11.501Z
2021-12-02,2:30 PM,11,1,6,1,0,19,2021-12-02T20:34:32.622Z
2021-12-02,3:30 PM,7,2,5,1,1,16,2021-12-02T21:33:52.803Z
2021-12-02,4:30 PM,4,2,2,0,0,8,2021-12-02T22:35:12.242Z
2021-12-02,5:30 PM,1,3,4,1,0,9,2021-12-02T23:46:57.731Z
2021-12-02,6:30 PM,1,4,4,1,0,10,2021-12-03T00:27:41.177Z
2021-12-02,7:30 PM,1,1,6,1,0,9,2021-12-03T01:34:07.323Z
2021-12-02,8:30 PM,1,0,1,0,0,2,2021-12-03T02:34:15.957Z
2021-12-03,7:30 AM,1,0,0,0,0,1,2021-12-03T13:40:40.912Z
2021-12-03,8:30 AM,2,0,0,1,1,4,2021-12-03T14:33:07.398Z
2021-12-03,9:30 AM,3,2,2,1,0,8,2021-12-03T15:32:42.257Z
2021-12-03,10:30 AM,3,4,2,1,0,10,2021-12-03T16:31:01.378Z
2021-12-03,11:30 AM,4,3,2,1,0,10,2021-12-03T17:40:24.531Z
2021-12-03,12:30 PM,4,2,6,1,0,13,2021-12-03T18:32:16.419Z
2021-12-03,3:30 PM,8,2,10,3,2,25,2021-12-03T21:32:14.526Z
2021-12-03,5:30 PM,6,2,3,1,0,12,2021-12-03T23:45:18.669Z
2021-12-03,6:30 PM,5,1,2,0,0,8,2021-12-04T02:31:56.702Z
2021-12-03,7:30 PM,3,0,2,0,0,5,2021-12-04T02:32:34.390Z
2021-12-03,8:30 PM,0,1,0,0,0,1,2021-12-04T02:33:15.214Z
2021-12-03,8:30 PM,0,0,2,1,0,3,2021-12-04T02:40:29.248Z
2021-12-04,9:30 AM,1,0,0,0,0,1,2021-12-04T15:28:35.397Z
2021-12-04,10:30 AM,1,0,2,1,0,4,2021-12-04T16:30:51.694Z
2021-12-04,11:30 PM,2,0,2,1,0,5,2021-12-04T19:25:47.886Z
2021-12-04,12:30 PM,3,0,2,1,2,8,2021-12-04T19:26:07.614Z
2021-12-04,1:30 PM,5,0,2,1,0,8,2021-12-04T19:26:31.838Z
2021-12-04,1:30 PM,9,3,6,2,0,20,2021-12-04T19:58:45.049Z
2021-12-04,2:30 PM,5,2,4,1,0,12,2021-12-04T20:24:19.570Z
2021-12-04,3:30 PM,5,2,2,1,0,10,2021-12-04T21:26:50.945Z
2021-12-06,7:30 AM,0,0,0,0,0,0,2021-12-06T13:32:10.967Z
2021-12-06,8:30 AM,3,0,1,0,0,4,2021-12-06T14:31:43.889Z
2021-12-06,9:30 AM,4,1,1,0,0,6,2021-12-06T15:34:21.729Z
2021-12-06,11:30 AM,5,2,7,3,0,17,2021-12-06T17:34:17.542Z
2021-12-06,1:30 PM,5,2,6,0,0,13,2021-12-06T19:32:42.946Z
2021-12-06,2:30 PM,3,4,8,3,1,19,2021-12-06T20:32:44.588Z
2021-12-06,3:30 PM,4,1,2,1,0,8,2021-12-06T21:38:11.631Z
2021-12-06,4:30 PM,7,2,8,6,0,23,2021-12-06T22:31:05.657Z
2021-12-06,5:30 PM,8,0,11,2,0,21,2021-12-06T23:31:13.714Z
2021-12-06,6:30 PM,5,0,4,2,0,11,2021-12-07T00:30:46.509Z
2021-12-06,7:30 PM,3,0,3,2,0,8,2021-12-07T01:33:46.775Z
2021-12-06,8:30 PM,2,0,0,2,0,4,2021-12-07T02:35:17.814Z
2021-12-07,7:30 AM,0,0,0,0,0,0,2021-12-07T13:32:33.073Z
2021-12-07,8:30 AM,1,1,1,0,0,3,2021-12-07T14:31:47.398Z
2021-12-07,9:30 AM,5,2,4,0,0,11,2021-12-07T15:30:41.474Z
2021-12-07,10:30 AM,4,4,7,0,1,16,2021-12-07T16:31:36.192Z
2021-12-07,11:30 AM,4,5,7,9,1,26,2021-12-07T17:37:39.314Z
2021-12-07,3:30 PM,8,5,12,4,2,31,2021-12-07T21:30:46.926Z
2021-12-07,5:30 PM,5,1,2,1,0,9,2021-12-07T23:29:57.372Z
2021-12-07,6:30 PM,4,1,2,4,0,11,2021-12-08T00:40:37.648Z
2021-12-07,8:30 PM,3,0,2,2,2,9,2021-12-08T02:08:48.496Z
2021-12-08,7:30 AM,0,0,0,0,0,0,2021-12-08T13:36:57.130Z
2021-12-08,8:30 AM,3,1,1,0,0,5,2021-12-08T14:31:44.552Z
2021-12-08,9:30 AM,7,0,6,1,0,14,2021-12-08T15:33:00.721Z
2021-12-08,10:30 AM,7,1,3,1,2,14,2021-12-08T16:32:52.161Z
2021-12-08,1:30 PM,8,2,4,0,0,14,2021-12-08T19:31:40.861Z
2021-12-08,2:30 PM,5,2,5,1,4,17,2021-12-08T20:32:08.726Z
2021-12-08,3:30 PM,7,2,8,4,0,21,2021-12-08T21:34:23.546Z
2021-12-08,4:30 PM,5,3,1,3,1,13,2021-12-08T22:32:13.336Z
2021-12-08,5:30 PM,4,3,0,2,1,10,2021-12-08T23:32:30.671Z
2021-12-08,6:30 PM,3,3,5,2,0,13,2021-12-09T00:29:52.746Z
2021-12-08,7:30 PM,1,2,3,0,0,6,2021-12-09T01:30:37.815Z
2021-12-08,8:30 PM,0,1,1,0,0,2,2021-12-09T02:37:57.539Z
2021-12-09,10:30 AM,10,4,5,2,5,26,2021-12-09T16:40:25.416Z
2021-12-09,12:30 PM,12,5,8,0,2,27,2021-12-09T18:33:20.509Z
2021-12-09,1:30 PM,7,2,4,2,0,15,2021-12-09T20:59:39.001Z
2021-12-09,2:30 PM,5,2,5,1,0,13,2021-12-09T20:59:58.703Z
2021-12-09,3:30 PM,5,1,4,1,0,11,2021-12-09T22:32:32.234Z
2021-12-09,4:30 PM,4,1,2,1,0,8,2021-12-09T22:32:56.041Z
2021-12-09,5:30 PM,7,0,1,0,0,8,2021-12-09T23:36:16.159Z
2021-12-09,6:30 PM,4,0,4,0,0,8,2021-12-10T00:36:22.717Z
2021-12-09,7:30 PM,3,1,3,0,0,7,2021-12-10T01:39:21.000Z
2021-12-09,8:30 PM,1,0,2,0,0,3,2021-12-10T02:30:07.495Z
2021-12-10,7:30 AM,1,0,0,0,0,1,2021-12-10T13:35:37.727Z
2021-12-10,8:30 AM,1,0,0,1,0,2,2021-12-10T14:31:22.736Z
2021-12-10,9:30 AM,3,1,0,1,0,5,2021-12-10T15:31:38.566Z
2021-12-10,10:30 AM,5,1,0,1,0,7,2021-12-10T16:31:00.212Z
2021-12-10,11:30 AM,5,0,1,2,0,8,2021-12-10T17:33:20.834Z
2021-12-10,3:30 PM,8,1,1,0,0,10,2021-12-10T21:31:07.374Z
2021-12-10,4:30 PM,3,1,1,0,0,5,2021-12-10T22:43:08.157Z
2021-12-10,5:30 PM,3,0,1,0,0,4,2021-12-10T23:30:55.038Z
2021-12-10,6:30 PM,3,0,1,0,0,4,2021-12-11T01:32:13.541Z
2021-12-10,7:30 PM,1,1,0,0,0,2,2021-12-11T01:32:39.524Z
2021-12-10,8:30 PM,1,1,0,0,0,2,2021-12-11T02:31:45.852Z
2021-12-11,9:30 AM,0,0,0,0,0,0,2021-12-11T15:29:57.923Z
2021-12-11,10:30 AM,3,0,0,0,0,3,2021-12-11T16:39:50.145Z
2021-12-11,1:30 PM,3,0,1,0,0,4,2021-12-11T19:35:11.712Z
2021-12-11,1:30 PM,2,0,1,0,0,3,2021-12-11T19:38:47.383Z
2021-12-11,2:30 PM,5,1,0,1,0,7,2021-12-11T20:29:31.473Z
2021-12-11,3:30 PM,5,1,1,0,0,7,2021-12-11T21:32:09.650Z
2021-12-11,4:30 PM,4,1,1,2,0,8,2021-12-11T22:39:40.173Z
2021-12-13,7:30 AM,1,0,0,0,0,1,2021-12-13T13:58:32.962Z
2021-12-13,8:30 AM,2,0,0,0,2,4,2021-12-13T14:49:34.580Z
2021-12-13,9:30 AM,1,0,0,0,0,1,2021-12-13T15:32:05.191Z
2021-12-13,10:30 AM,2,0,0,0,1,3,2021-12-13T16:33:02.187Z
2021-12-13,12:30 PM,3,1,0,0,1,5,2021-12-13T18:33:28.846Z
2021-12-13,1:30 PM,2,1,0,0,0,3,2021-12-13T20:05:33.854Z
2021-12-13,2:30 PM,2,0,1,0,0,3,2021-12-13T20:45:40.611Z
2021-12-13,3:30 PM,4,1,1,0,0,6,2021-12-13T22:38:27.148Z
2021-12-13,4:30 PM,3,1,1,0,0,5,2021-12-13T22:38:55.690Z
2021-12-13,5:30 PM,1,0,0,0,0,1,2021-12-13T23:59:03.357Z
2021-12-14,7:30 AM,0,0,0,0,0,0,2021-12-14T13:35:38.365Z
2021-12-14,8:30 AM,0,0,0,0,1,1,2021-12-14T14:32:27.471Z
2021-12-14,9:30 AM,0,0,0,1,0,1,2021-12-14T15:32:00.144Z
2021-12-14,10:30 AM,0,1,0,0,0,1,2021-12-14T16:30:28.523Z
2021-12-14,12:30 PM,2,0,1,0,0,3,2021-12-14T18:35:15.815Z
2021-12-14,2:30 PM,1,1,0,0,0,2,2021-12-14T20:43:21.994Z
2021-12-14,4:30 PM,0,1,0,0,0,1,2021-12-14T22:00:56.274Z
2021-12-14,3:30 PM,0,1,0,0,0,1,2021-12-14T22:01:30.138Z
2021-12-14,5:30 PM,0,1,0,0,0,1,2021-12-14T23:30:23.780Z
2021-12-15,7:30 AM,0,0,0,0,0,0,2021-12-15T13:46:56.540Z
2021-12-15,8:30 AM,1,0,0,0,0,1,2021-12-15T14:35:25.036Z
2021-12-15,9:30 AM,0,0,0,0,0,0,2021-12-15T15:30:16.193Z
2021-12-15,10:30 AM,0,0,1,0,0,1,2021-12-15T16:30:58.151Z
2021-12-15,11:30 AM,2,0,1,1,0,4,2021-12-15T17:33:58.872Z
2021-12-15,12:30 PM,0,0,2,0,0,2,2021-12-15T18:33:56.025Z
2021-12-15,1:30 PM,2,0,1,0,0,3,2021-12-15T19:32:27.323Z
2021-12-15,2:30 PM,2,0,0,0,0,2,2021-12-15T20:35:39.266Z
2021-12-15,3:30 PM,1,0,0,0,0,1,2021-12-15T21:34:24.226Z
2021-12-15,4:30 PM,1,0,1,0,0,2,2021-12-15T23:29:59.335Z
2021-12-15,5:30 PM,1,0,1,0,0,2,2021-12-15T23:30:13.919Z
2021-12-16,7:30 AM,0,0,0,0,0,0,2021-12-16T13:31:58.894Z
2021-12-16,8:30 AM,0,0,0,0,0,0,2021-12-16T14:32:06.378Z
2021-12-16,10:30 AM,0,0,5,0,0,5,2021-12-16T16:33:50.784Z
2021-12-16,12:30 PM,1,0,2,0,0,3,2021-12-16T18:32:06.498Z
2021-12-16,1:30 PM,1,0,1,0,0,2,2021-12-16T19:36:33.690Z
2021-12-16,2:30 PM,3,0,1,0,0,4,2021-12-16T23:27:46.683Z
2021-12-16,3:30 PM,1,0,0,0,0,1,2021-12-16T23:28:03.777Z
2021-12-16,4:30 PM,1,0,0,0,0,1,2021-12-16T23:28:23.237Z
2021-12-16,5:30 PM,0,0,0,0,0,0,2021-12-16T23:28:35.421Z
2021-12-17,7:30 AM,0,0,0,0,0,0,2021-12-17T13:31:21.154Z
2021-12-17,8:30 AM,1,0,0,0,0,1,2021-12-17T14:36:35.911Z
2021-12-17,9:30 AM,1,0,0,0,0,1,2021-12-17T15:46:40.963Z
2021-12-17,10:30 AM,1,0,0,0,0,1,2021-12-17T16:31:43.152Z
2021-12-17,12:30 PM,2,0,0,1,0,3,2021-12-17T18:34:49.467Z
2021-12-17,1:30 PM,1,0,0,1,0,2,2021-12-17T19:50:45.313Z
2021-12-17,2:30 PM,1,0,0,0,0,1,2021-12-18T19:04:31.888Z
2021-12-17,3:30 PM,0,0,0,0,1,1,2021-12-18T19:04:58.437Z
2021-12-17,4:30 PM,0,1,0,0,0,1,2021-12-18T19:05:23.435Z
2021-12-17,5:30 PM,0,0,0,0,0,0,2021-12-18T19:05:45.904Z
2021-12-20,7:30 AM,1,0,0,0,0,1,2021-12-20T13:37:38.551Z
2021-12-20,8:30 AM,1,0,0,0,0,1,2021-12-20T14:32:00.710Z
2021-12-20,9:30 AM,1,1,0,0,0,2,2021-12-20T15:33:33.121Z
2021-12-20,10:30 AM,1,1,1,0,0,3,2021-12-20T16:27:59.350Z
2021-12-20,12:30 PM,1,0,1,0,0,2,2021-12-20T18:49:40.647Z
2021-12-20,1:30 PM,3,0,1,0,0,4,2021-12-20T19:36:11.346Z
2021-12-20,2:30 PM,4,0,0,0,0,4,2021-12-20T23:37:22.183Z
2021-12-20,5:30 PM,3,1,0,0,0,4,2021-12-20T23:37:40.918Z
2021-12-20,3:30 PM,3,1,0,0,0,4,2021-12-20T23:39:50.980Z
2021-12-21,7:30 AM,0,0,0,0,0,0,2021-12-21T14:01:09.524Z
2021-12-21,8:30 AM,0,0,0,0,0,0,2021-12-21T14:31:46.873Z
2021-12-21,9:30 AM,0,0,0,0,0,0,2021-12-21T15:31:20.921Z
2021-12-21,10:30 AM,0,0,0,0,0,0,2021-12-21T16:53:52.955Z
2021-12-21,11:30 AM,1,0,1,0,0,2,2021-12-21T17:30:40.087Z
2021-12-21,11:30 AM,1,0,0,0,1,2,2021-12-21T17:32:49.654Z
2021-12-21,12:30 PM,1,0,0,0,0,1,2021-12-21T18:31:43.461Z
2021-12-21,1:30 PM,2,2,0,2,0,6,2021-12-21T19:31:51.364Z
2021-12-21,2:30 PM,3,0,0,0,0,3,2021-12-21T20:56:12.331Z
2021-12-21,4:30 PM,2,0,0,0,2,4,2021-12-21T22:27:39.357Z
2021-12-21,5:30 PM,1,0,0,0,0,1,2021-12-21T23:41:27.090Z
2021-12-22,7:30 AM,0,0,0,0,0,0,2021-12-22T13:51:24.304Z
2021-12-22,8:30 AM,1,0,0,0,0,1,2021-12-22T14:31:16.736Z
2021-12-22,9:30 AM,1,0,0,0,0,1,2021-12-22T15:30:56.990Z
2021-12-22,10:30 AM,1,0,0,0,1,2,2021-12-22T16:31:52.140Z
2021-12-22,11:30 AM,1,0,0,0,0,1,2021-12-22T17:29:26.245Z
2021-12-22,12:30 PM,1,0,0,0,0,1,2021-12-22T18:29:22.140Z
2022-01-03,7:30 AM,0,0,0,0,0,0,2022-01-03T13:32:49.884Z
2022-01-03,8:30 AM,1,0,0,0,0,1,2022-01-03T14:36:47.724Z
2022-01-03,9:30 AM,3,0,0,0,0,3,2022-01-03T15:33:55.789Z
2022-01-03,10:30 AM,1,0,0,0,0,1,2022-01-03T16:29:03.980Z
2022-01-03,11:30 AM,1,0,0,0,1,2,2022-01-03T17:39:48.294Z
2022-01-03,12:30 PM,1,0,0,0,0,1,2022-01-03T18:34:20.762Z
2022-01-03,1:30 PM,1,0,0,0,0,1,2022-01-03T19:37:02.491Z
2022-01-03,2:30 PM,1,0,1,0,0,2,2022-01-03T21:56:52.852Z
2022-01-03,3:30 PM,1,0,0,1,0,2,2022-01-03T21:57:09.612Z
2022-01-03,4:30 PM,2,0,0,0,0,2,2022-01-03T22:34:34.592Z
2022-01-04,7:30 AM,0,0,0,0,0,0,2022-01-04T14:02:50.372Z
2022-01-04,8:30 AM,0,0,0,0,0,0,2022-01-04T14:29:31.276Z
2022-01-04,9:30 AM,0,0,0,1,1,2,2022-01-04T15:31:56.983Z
2022-01-04,10:30 AM,1,0,0,0,0,1,2022-01-04T16:31:35.983Z
2022-01-04,11:30 AM,1,0,1,0,0,2,2022-01-04T17:37:24.505Z
2022-01-04,12:30 PM,1,0,0,0,0,1,2022-01-04T18:35:31.229Z
2022-01-04,1:30 PM,1,0,0,0,0,1,2022-01-04T19:39:09.249Z
2022-01-04,2:30 PM,1,0,0,0,0,1,2022-01-04T20:32:46.594Z
2022-01-04,3:30 PM,2,0,0,0,0,2,2022-01-04T23:41:15.637Z
2022-01-04,4:30 PM,4,0,0,0,0,4,2022-01-04T23:41:34.405Z
2022-01-04,5:30 PM,0,0,1,0,0,1,2022-01-04T23:41:56.125Z
2022-01-05,7:30 AM,0,0,0,0,0,0,2022-01-05T13:31:43.952Z
2022-01-05,8:30 AM,1,0,0,0,0,1,2022-01-05T14:31:02.657Z
2022-01-05,9:30 AM,2,0,0,0,1,3,2022-01-05T15:29:31.231Z
2022-01-05,10:30 AM,0,0,0,0,0,0,2022-01-05T16:31:07.344Z
2022-01-05,11:30 AM,0,0,0,0,0,0,2022-01-05T17:27:32.094Z
2022-01-05,11:30 AM,0,0,0,0,0,0,2022-01-05T17:32:11.303Z
2022-01-05,12:30 PM,2,0,0,0,0,2,2022-01-05T18:45:38.306Z
2022-01-05,1:30 PM,2,0,1,0,1,4,2022-01-05T19:35:54.020Z
2022-01-06,7:30 AM,0,0,0,0,0,0,2022-01-06T13:33:51.331Z
2022-01-06,8:30 AM,0,0,0,0,0,0,2022-01-06T14:30:53.834Z
2022-01-06,9:30 AM,2,0,0,0,0,2,2022-01-06T15:30:31.625Z
2022-01-06,10:30 AM,1,0,0,0,0,1,2022-01-06T16:36:18.150Z
2022-01-06,2:30 PM,3,0,0,0,0,3,2022-01-06T20:29:42.353Z
2022-01-06,3:30 PM,1,0,0,8,0,9,2022-01-06T21:38:08.029Z
2022-01-06,4:30 PM,1,0,0,0,2,3,2022-01-06T23:34:06.467Z
2022-01-06,5:30 PM,0,0,0,0,0,0,2022-01-06T23:34:30.307Z
2022-01-07,7:30 AM,1,0,0,0,0,1,2022-01-07T13:32:08.493Z
2022-01-07,8:30 AM,1,0,0,0,0,1,2022-01-07T14:28:59.620Z
2022-01-07,9:30 AM,1,1,0,0,1,3,2022-01-07T15:30:16.846Z
2022-01-07,10:30 AM,1,2,0,0,0,3,2022-01-07T16:28:31.236Z
2022-01-07,11:30 AM,1,2,1,0,0,4,2022-01-07T17:48:25.634Z
2022-01-07,11:30 AM,1,2,1,0,0,4,2022-01-07T17:49:15.874Z
2022-01-07,12:30 PM,2,0,0,0,0,2,2022-01-07T18:33:35.568Z
2022-01-07,1:30 PM,1,0,0,0,0,1,2022-01-07T21:50:30.633Z
2022-01-07,2:30 PM,0,0,0,0,0,0,2022-01-07T21:50:50.569Z
2022-01-07,3:30 PM,1,0,0,0,3,4,2022-01-07T21:51:08.448Z
2022-01-07,4:30 PM,1,0,0,0,0,1,2022-01-07T22:35:11.622Z
2022-01-10,7:30 AM,0,0,0,0,0,0,2022-01-10T13:32:23.815Z
2022-01-10,8:30 AM,1,0,0,0,0,1,2022-01-10T14:30:01.945Z
2022-01-10,9:30 AM,2,0,0,0,0,2,2022-01-10T15:30:06.479Z
2022-01-10,10:30 AM,1,0,0,0,0,1,2022-01-10T16:29:09.679Z
2022-01-10,11:30 AM,3,0,0,0,0,3,2022-01-10T17:37:44.531Z
2022-01-10,12:30 PM,5,0,0,0,0,5,2022-01-10T18:29:29.666Z
2022-01-10,12:30 PM,4,0,0,0,0,4,2022-01-10T18:34:32.888Z
2022-01-10,1:30 PM,2,0,1,0,0,3,2022-01-10T19:28:57.514Z
2022-01-10,2:30 PM,2,0,0,0,1,3,2022-01-10T20:41:18.406Z
2022-01-10,3:30 PM,3,0,0,0,0,3,2022-01-10T21:45:04.818Z
2022-01-10,4:30 PM,1,0,0,0,0,1,2022-01-10T22:46:13.261Z
2022-01-11,7:30 AM,0,0,0,0,1,1,2022-01-11T13:32:35.268Z
2022-01-11,8:30 AM,0,0,0,0,0,0,2022-01-11T14:25:50.743Z
2022-01-11,9:30 AM,1,0,0,0,0,1,2022-01-11T15:30:22.892Z
2022-01-11,10:30 AM,1,0,0,0,0,1,2022-01-11T16:32:24.886Z
2022-01-11,12:30 PM,2,0,2,0,0,4,2022-01-11T18:31:26.442Z
2022-01-11,12:30 PM,1,0,0,0,1,2,2022-01-11T20:31:29.771Z
2022-01-11,2:30 PM,2,0,0,0,0,2,2022-01-11T21:38:57.486Z
2022-01-11,3:30 PM,1,0,0,0,0,1,2022-01-11T21:39:17.493Z
2022-01-11,4:30 PM,3,0,0,0,0,3,2022-01-11T23:25:20.235Z
2022-01-11,5:30 PM,0,1,0,0,0,1,2022-01-11T23:39:04.432Z
2022-01-12,7:30 AM,2,0,0,0,0,2,2022-01-12T13:35:47.915Z
2022-01-12,8:30 AM,0,0,0,0,0,0,2022-01-12T14:30:29.620Z
2022-01-12,9:30 AM,0,0,0,0,0,0,2022-01-12T15:29:24.890Z
2022-01-12,10:30 AM,0,0,1,0,0,1,2022-01-12T16:31:16.950Z
2022-01-12,11:30 AM,0,0,1,0,0,1,2022-01-12T17:29:47.091Z
2022-01-12,2:30 PM,3,0,1,0,0,4,2022-01-12T20:48:23.494Z
2022-01-12,3:30 PM,4,0,1,0,0,5,2022-01-12T21:37:30.294Z
2022-01-12,4:30 PM,3,0,1,0,0,4,2022-01-12T23:04:06.665Z
2022-01-12,5:30 PM,3,0,0,0,2,5,2022-01-12T23:56:39.588Z
2022-01-13,7:30 AM,0,0,0,0,0,0,2022-01-13T13:32:12.121Z
2022-01-13,8:30 AM,0,0,0,0,1,1,2022-01-13T14:32:17.413Z
2022-01-13,9:30 AM,5,0,0,0,0,5,2022-01-13T15:36:59.498Z
2022-01-13,10:30 AM,0,0,1,0,2,3,2022-01-13T16:29:10.349Z
2022-01-13,11:30 AM,2,0,1,0,1,4,2022-01-13T17:30:32.601Z
2022-01-13,12:30 PM,1,0,0,0,2,3,2022-01-13T18:33:47.344Z
2022-01-13,1:30 PM,1,0,0,0,0,1,2022-01-13T19:34:24.686Z
2022-01-13,2:30 PM,2,0,0,0,0,2,2022-01-13T20:39:12.593Z
2022-01-13,3:30 PM,4,0,0,0,2,6,2022-01-13T21:44:27.705Z
2022-01-13,4:30 PM,3,0,1,0,0,4,2022-01-13T22:37:05.586Z
2022-01-13,5:30 PM,3,0,0,0,0,3,2022-01-13T23:31:07.980Z
2022-01-14,7:30 AM,1,0,0,0,0,1,2022-01-14T13:31:29.391Z
2022-01-14,8:30 AM,1,0,0,0,0,1,2022-01-14T14:28:28.492Z
2022-01-14,9:30 AM,1,0,0,0,1,2,2022-01-14T15:29:46.001Z
2022-01-14,10:30 AM,3,0,0,0,2,5,2022-01-14T16:29:55.217Z
2022-01-14,11:30 AM,1,0,1,0,1,3,2022-01-14T17:29:08.812Z
2022-01-14,12:30 PM,2,0,0,0,0,2,2022-01-14T18:41:04.496Z
2022-01-14,1:30 PM,3,0,0,1,0,4,2022-01-14T19:35:17.005Z
2022-01-14,2:30 PM,3,0,0,0,1,4,2022-01-14T20:41:09.625Z
2022-01-14,3:30 PM,3,0,1,0,2,6,2022-01-14T22:57:42.899Z
2022-01-14,4:30 PM,4,0,0,0,2,6,2022-01-14T22:58:12.083Z
2022-01-14,5:30 PM,1,0,0,0,0,1,2022-01-14T23:38:28.046Z
2022-01-18,7:30 AM,3,0,0,0,1,4,2022-01-18T13:34:10.700Z
2022-01-18,8:30 AM,5,0,0,0,1,6,2022-01-18T14:35:41.635Z
2022-01-18,10:30 AM,8,3,9,2,0,22,2022-01-18T16:51:27.739Z
2022-01-18,11:30 AM,11,2,5,1,1,20,2022-01-18T17:27:55.055Z
2022-01-18,12:30 PM,9,6,6,0,1,22,2022-01-18T18:33:03.462Z
2022-01-18,1:30 PM,13,3,6,2,1,25,2022-01-18T19:32:32.128Z
2022-01-18,2:30 PM,14,3,3,2,1,23,2022-01-18T20:30:02.233Z
2022-01-18,3:30 PM,8,2,2,0,4,16,2022-01-18T21:33:26.458Z
2022-01-18,4:30 PM,9,1,2,2,1,15,2022-01-18T22:31:53.448Z
2022-01-18,5:30 PM,7,0,1,0,0,8,2022-01-18T23:34:50.332Z
2022-01-18,6:30 PM,5,1,2,0,0,8,2022-01-19T00:33:50.850Z
2022-01-18,7:30 PM,1,1,2,0,0,4,2022-01-19T01:33:22.441Z
2022-01-19,7:30 AM,0,0,0,0,0,0,2022-01-19T13:44:54.481Z
2022-01-19,8:30 AM,3,1,2,0,0,6,2022-01-19T14:30:20.983Z
2022-01-19,9:30 AM,4,2,3,0,0,9,2022-01-19T15:30:53.923Z
2022-01-19,10:30 AM,4,1,3,2,0,10,2022-01-19T16:38:28.755Z
2022-01-19,11:30 AM,10,2,9,2,3,26,2022-01-19T17:30:02.974Z
2022-01-19,12:30 PM,11,2,2,2,7,24,2022-01-19T18:31:01.327Z
2022-01-19,1:30 PM,3,1,6,4,5,19,2022-01-19T19:33:28.779Z
2022-01-19,2:30 PM,3,1,7,3,2,16,2022-01-19T20:33:37.618Z
2022-01-19,3:30 PM,5,3,6,1,0,15,2022-01-19T21:33:11.157Z
2022-01-19,4:30 PM,8,2,6,0,0,16,2022-01-19T22:31:42.638Z
2022-01-19,5:30 PM,6,1,8,0,2,17,2022-01-19T23:45:11.218Z
2022-01-19,6:30 PM,3,1,6,0,0,10,2022-01-20T00:35:58.166Z
2022-01-19,7:30 PM,2,0,3,0,0,5,2022-01-20T01:33:29.566Z
2022-01-20,7:30 AM,0,0,1,0,0,1,2022-01-20T14:04:23.583Z
2022-01-20,10:30 AM,5,2,8,1,0,16,2022-01-20T16:31:58.250Z
2022-01-20,11:30 AM,9,2,4,0,3,18,2022-01-20T17:28:49.379Z
2022-01-20,12:30 PM,8,6,9,0,3,26,2022-01-20T18:32:05.802Z
2022-01-20,1:30 PM,4,4,9,2,1,20,2022-01-20T19:39:31.031Z
2022-01-20,2:30 PM,3,2,8,2,2,17,2022-01-20T20:29:55.911Z
2022-01-20,3:30 PM,7,3,7,4,2,23,2022-01-20T21:33:21.366Z
2022-01-20,4:30 PM,4,5,4,1,2,16,2022-01-20T22:33:36.719Z
2022-01-20,6:30 PM,5,3,1,1,0,10,2022-01-21T00:37:14.628Z
2022-01-20,7:30 PM,5,1,2,0,0,8,2022-01-21T01:32:22.484Z
2022-01-21,7:30 AM,1,0,0,0,0,1,2022-01-21T13:48:53.509Z
2022-01-21,10:30 AM,2,1,4,2,1,10,2022-01-21T16:32:27.556Z
2022-01-21,11:30 AM,2,1,4,2,1,10,2022-01-21T17:31:42.733Z
2022-01-21,12:30 PM,2,0,5,2,4,13,2022-01-21T18:31:26.849Z
2022-01-21,1:30 PM,3,0,4,2,2,11,2022-01-21T19:29:24.924Z
2022-01-21,2:30 PM,4,0,5,2,0,11,2022-01-21T20:32:18.705Z
2022-01-21,3:30 PM,8,0,1,0,0,9,2022-01-21T21:34:20.224Z
2022-01-21,5:30 PM,1,2,0,0,0,3,2022-01-21T23:32:42.169Z
2022-01-21,6:30 PM,1,3,0,0,0,4,2022-01-22T00:33:31.786Z
2022-01-21,7:30 PM,1,1,0,0,0,2,2022-01-22T01:36:21.816Z
2022-01-22,10:30 AM,2,1,1,0,0,4,2022-01-22T16:26:45.484Z
2022-01-22,11:30 PM,1,1,1,0,0,3,2022-01-22T18:26:08.812Z
2022-01-22,12:30 PM,5,4,0,1,0,10,2022-01-22T18:33:14.091Z
2022-01-22,1:30 PM,5,4,0,1,0,10,2022-01-22T19:31:28.184Z
2022-01-22,3:30 PM,5,4,1,1,0,11,2022-01-22T21:20:10.000Z
2022-01-24,9:30 AM,6,4,8,2,0,20,2022-01-24T15:52:23.927Z
2022-01-24,10:30 AM,6,2,8,2,0,18,2022-01-24T16:47:42.632Z
2022-01-24,11:30 AM,4,3,7,1,2,17,2022-01-24T17:29:29.388Z
2022-01-24,12:30 PM,7,5,8,0,4,24,2022-01-24T18:32:13.400Z
2022-01-24,1:30 PM,8,5,10,4,1,28,2022-01-24T19:31:03.995Z
2022-01-24,2:30 PM,11,2,13,4,2,32,2022-01-24T20:32:17.086Z
2022-01-24,3:30 PM,11,2,6,5,0,24,2022-01-24T21:36:39.329Z
2022-01-24,4:30 PM,5,1,4,1,0,11,2022-01-24T22:35:55.908Z
2022-01-24,5:30 PM,5,0,5,0,1,11,2022-01-24T23:35:17.390Z
2022-01-24,7:30 PM,3,1,2,1,0,7,2022-01-25T01:32:53.334Z
2022-01-25,9:30 AM,7,3,5,1,0,16,2022-01-25T15:44:06.922Z
2022-01-25,10:30 AM,12,5,8,1,0,26,2022-01-25T16:42:04.915Z
2022-01-25,11:30 AM,10,4,11,5,0,30,2022-01-25T17:32:05.843Z
2022-01-25,12:30 PM,10,3,9,5,3,30,2022-01-25T18:30:31.804Z
2022-01-25,1:30 PM,8,1,10,3,4,26,2022-01-25T19:33:29.476Z
2022-01-25,2:30 PM,5,2,5,1,2,15,2022-01-25T20:26:28.884Z
2022-01-25,3:30 PM,10,1,4,1,2,18,2022-01-25T21:30:49.527Z
2022-01-25,4:30 PM,8,0,3,0,0,11,2022-01-25T23:00:37.387Z
2022-01-25,5:30 PM,6,0,4,2,2,14,2022-01-25T23:55:12.554Z
2022-01-25,6:30 PM,2,2,0,1,4,9,2022-01-26T00:46:36.169Z
2022-01-25,8:30 PM,2,2,1,2,1,8,2022-01-26T02:05:52.342Z
2022-01-26,8:30 AM,3,1,0,0,1,5,2022-01-26T14:32:19.988Z
2022-01-26,9:30 AM,2,8,7,1,0,18,2022-01-26T15:45:55.256Z
2022-01-26,10:30 AM,3,6,11,0,0,20,2022-01-26T16:34:28.303Z
2022-01-26,11:30 AM,5,2,12,4,1,24,2022-01-26T17:37:50.800Z
2022-01-26,12:30 PM,7,3,8,0,4,22,2022-01-26T18:29:08.024Z
2022-01-26,1:30 PM,7,1,8,2,1,19,2022-01-26T19:29:54.658Z
2022-01-26,2:30 PM,8,2,4,1,2,17,2022-01-26T20:30:20.743Z
2022-01-26,3:30 PM,6,0,3,1,1,11,2022-01-26T21:50:33.291Z
2022-01-26,5:30 PM,6,0,4,1,1,12,2022-01-26T23:43:40.614Z
2022-01-26,6:30 PM,5,2,4,0,0,11,2022-01-27T00:26:17.150Z
2022-01-26,7:30 PM,2,1,4,0,0,7,2022-01-27T01:33:53.294Z
2022-01-26,8:30 PM,3,2,1,0,0,6,2022-01-27T02:30:37.440Z
2022-01-27,8:30 AM,1,1,2,0,0,4,2022-01-27T14:28:23.881Z
2022-01-27,9:30 AM,2,4,7,0,0,13,2022-01-27T15:29:54.023Z
2022-01-27,10:30 AM,2,5,8,0,0,15,2022-01-27T16:28:19.307Z
2022-01-27,11:30 AM,8,3,4,0,1,16,2022-01-27T17:30:49.188Z
2022-01-27,12:30 PM,7,4,4,0,3,18,2022-01-27T18:28:42.752Z
2022-01-27,1:30 PM,4,3,5,3,2,17,2022-01-27T19:30:17.127Z
2022-01-27,2:30 PM,6,1,3,0,1,11,2022-01-27T20:26:36.783Z
2022-01-27,3:30 PM,4,0,4,1,1,10,2022-01-27T21:34:02.347Z
2022-01-27,4:30 PM,7,0,3,2,1,13,2022-01-27T22:58:02.534Z
2022-01-27,5:30 PM,6,3,1,2,0,12,2022-01-27T23:49:07.453Z
2022-01-27,7:30 PM,5,0,3,0,2,10,2022-01-28T01:36:06.059Z
2022-01-28,8:30 AM,0,2,0,0,0,2,2022-01-28T14:29:26.789Z
2022-01-28,9:30 AM,2,3,3,0,0,8,2022-01-28T15:31:23.994Z
2022-01-28,11:30 AM,3,3,6,3,3,18,2022-01-28T17:30:08.019Z
2022-01-28,12:30 PM,4,0,4,3,0,11,2022-01-28T18:28:06.646Z
2022-01-28,1:30 PM,3,2,6,2,0,13,2022-01-28T19:35:43.734Z
2022-01-28,2:30 PM,6,1,4,2,1,14,2022-01-28T20:38:17.146Z
2022-01-28,5:30 PM,3,2,6,1,0,12,2022-01-28T23:31:13.464Z
2022-01-28,6:30 PM,8,1,2,3,1,15,2022-01-29T00:33:21.075Z
2022-01-28,7:30 PM,3,1,1,0,0,5,2022-01-29T01:32:45.529Z
2022-01-29,9:30 AM,1,0,1,0,0,2,2022-01-29T15:37:11.577Z
2022-01-29,10:30 AM,2,0,1,0,0,3,2022-01-29T16:42:49.527Z
2022-01-29,12:30 PM,2,0,0,0,0,2,2022-01-29T18:20:47.460Z
2022-01-29,2:30 PM,3,0,0,0,0,3,2022-01-29T20:42:44.425Z
2022-01-29,3:30 PM,8,0,1,1,0,10,2022-01-29T21:09:35.286Z
2022-01-29,4:30 PM,4,0,0,3,0,7,2022-01-29T22:29:14.528Z
2022-01-31,8:30 AM,1,1,1,0,0,3,2022-01-31T14:29:13.317Z
2022-01-31,9:30 AM,2,3,4,1,0,10,2022-01-31T15:36:44.561Z
2022-01-31,10:30 AM,7,6,7,1,0,21,2022-01-31T16:29:32.965Z
2022-01-31,11:30 AM,7,2,13,2,1,25,2022-01-31T17:31:44.967Z
2022-01-31,12:30 PM,12,2,11,3,0,28,2022-01-31T18:34:01.347Z
2022-01-31,1:30 PM,10,1,5,2,2,20,2022-01-31T19:37:50.608Z
2022-01-31,2:30 PM,8,0,4,0,0,12,2022-01-31T21:31:26.356Z
2022-01-31,3:30 PM,7,1,4,0,0,12,2022-01-31T21:31:52.274Z
2022-01-31,4:30 PM,6,2,2,3,2,15,2022-01-31T22:40:31.271Z
2022-01-31,6:30 PM,3,0,2,0,1,6,2022-02-01T00:47:52.334Z
2022-01-31,7:30 PM,3,0,0,0,0,3,2022-02-01T01:38:34.493Z
2022-02-01,8:30 AM,2,5,0,0,0,7,2022-02-01T14:33:23.771Z
2022-02-01,9:30 AM,6,8,6,2,0,22,2022-02-01T15:36:30.695Z
2022-02-01,10:30 AM,9,6,7,5,0,27,2022-02-01T16:30:11.020Z
2022-02-01,11:30 AM,5,2,8,2,1,18,2022-02-01T17:40:59.654Z
2022-02-01,12:30 PM,7,0,12,4,4,27,2022-02-01T18:31:56.114Z
2022-02-01,1:30 PM,8,0,7,0,2,17,2022-02-01T19:40:18.544Z
2022-02-01,2:30 PM,9,1,4,4,0,18,2022-02-01T20:25:45.999Z
2022-02-01,3:30 PM,3,1,2,2,1,9,2022-02-01T21:38:03.333Z
2022-02-01,5:30 PM,1,3,2,0,0,6,2022-02-01T23:36:06.181Z
2022-02-01,7:30 PM,2,1,1,0,0,4,2022-02-02T01:32:00.400Z
2022-02-07,8:30 AM,3,2,0,0,0,5,2022-02-07T14:30:51.188Z
2022-02-07,9:30 AM,6,5,3,0,0,14,2022-02-07T15:38:34.736Z
2022-02-07,10:30 AM,6,5,3,0,0,14,2022-02-07T16:32:55.151Z
2022-02-07,11:30 AM,7,3,10,8,3,31,2022-02-07T17:37:37.207Z
2022-02-07,12:30 PM,16,1,12,4,0,33,2022-02-07T18:32:46.373Z
2022-02-07,1:30 PM,14,1,8,2,1,26,2022-02-07T19:36:30.227Z
2022-02-07,2:30 PM,9,1,3,2,5,20,2022-02-07T20:30:30.748Z
2022-02-07,3:30 PM,6,1,3,0,2,12,2022-02-07T21:53:00.846Z
2022-02-07,4:30 PM,12,1,6,7,0,26,2022-02-07T22:36:34.379Z
2022-02-07,5:30 PM,9,4,7,2,0,22,2022-02-07T23:33:46.490Z
2022-02-07,7:30 PM,3,4,2,0,0,9,2022-02-08T01:30:48.857Z
2022-02-08,8:30 AM,0,3,2,0,0,5,2022-02-08T14:31:30.776Z
2022-02-08,9:30 AM,4,5,5,1,0,15,2022-02-08T15:33:58.435Z
2022-02-08,11:30 AM,2,2,4,0,0,8,2022-02-08T17:32:34.142Z
2022-02-08,12:30 PM,4,2,10,2,3,21,2022-02-08T18:30:04.865Z
2022-02-08,1:30 PM,8,6,8,2,0,24,2022-02-08T19:32:38.616Z
2022-02-08,3:30 PM,7,1,6,5,1,20,2022-02-08T21:50:52.944Z
2022-02-08,5:30 PM,4,1,4,0,2,11,2022-02-08T23:33:51.983Z
2022-02-08,7:30 PM,0,2,5,1,0,8,2022-02-09T01:32:50.837Z
2022-02-09,8:30 AM,0,1,1,0,0,2,2022-02-09T14:32:08.584Z
2022-02-09,9:30 AM,1,1,5,0,0,7,2022-02-09T15:34:38.778Z
2022-02-09,10:30 AM,3,4,5,1,0,13,2022-02-09T16:30:03.019Z
2022-02-09,11:30 AM,10,2,7,0,1,20,2022-02-09T17:29:59.267Z
2022-02-09,12:30 PM,7,3,6,2,6,24,2022-02-09T18:33:28.945Z
2022-02-09,1:30 PM,3,4,5,3,1,16,2022-02-09T19:29:56.754Z
2022-02-09,2:30 PM,4,2,6,1,1,14,2022-02-09T20:33:11.688Z
2022-02-09,4:30 PM,7,3,6,2,3,21,2022-02-09T22:37:50.688Z
2022-02-09,6:30 PM,6,1,3,2,2,14,2022-02-10T00:35:42.017Z
2022-02-09,7:30 PM,7,1,4,0,4,16,2022-02-10T01:40:41.156Z
2022-02-10,8:30 AM,2,4,1,1,0,8,2022-02-10T14:32:40.862Z
2022-02-10,9:30 AM,6,5,9,0,0,20,2022-02-10T15:50:02.389Z
2022-02-10,10:30 AM,4,5,9,0,0,18,2022-02-10T16:35:19.444Z
2022-02-10,11:30 AM,4,0,7,0,0,11,2022-02-10T17:33:16.775Z
2022-02-10,12:30 PM,5,2,4,1,0,12,2022-02-10T18:37:28.421Z
2022-02-10,1:30 PM,7,2,9,0,1,19,2022-02-10T19:29:19.666Z
2022-02-10,2:30 PM,7,2,6,1,0,16,2022-02-10T20:27:28.723Z
2022-02-10,3:30 PM,7,1,4,1,2,15,2022-02-10T22:55:28.557Z
2022-02-10,4:30 PM,4,1,3,0,0,8,2022-02-10T22:55:53.953Z
2022-02-10,5:30 PM,6,1,5,0,0,12,2022-02-10T23:40:24.512Z
2022-02-10,6:30 PM,6,1,6,2,1,16,2022-02-11T00:44:36.942Z
2022-02-10,7:30 PM,5,2,3,2,1,13,2022-02-11T01:31:26.953Z
2022-02-11,8:30 AM,0,2,0,0,0,2,2022-02-11T14:35:14.468Z
2022-02-11,9:30 AM,1,4,1,2,0,8,2022-02-11T15:31:58.676Z
2022-02-11,11:30 AM,3,1,6,3,1,14,2022-02-11T17:30:44.058Z
2022-02-11,12:30 PM,4,1,6,5,0,16,2022-02-11T18:35:58.642Z
2022-02-11,1:30 PM,5,0,6,5,0,16,2022-02-11T19:31:54.255Z
2022-02-11,2:30 PM,3,1,6,3,1,14,2022-02-11T20:28:29.210Z
2022-02-11,3:30 PM,7,1,3,2,0,13,2022-02-11T22:59:53.312Z
2022-02-11,4:30 PM,4,0,2,0,1,7,2022-02-11T23:00:08.960Z
2022-02-11,5:30 PM,4,1,1,2,0,8,2022-02-11T23:33:00.523Z
2022-02-11,6:30 PM,4,0,2,0,0,6,2022-02-12T00:35:03.093Z
2022-02-11,7:30 PM,6,0,1,0,0,7,2022-02-12T01:32:55.057Z
2022-02-12,10:30 AM,1,1,0,0,0,2,2022-02-12T16:21:29.205Z
2022-02-12,9:30 AM,0,1,0,0,0,1,2022-02-12T16:33:33.128Z
2022-02-12,10:30 AM,1,1,2,0,0,4,2022-02-12T16:34:14.752Z
2022-02-12,12:30 PM,1,1,3,0,0,5,2022-02-12T18:04:05.615Z
2022-02-12,12:30 PM,3,1,2,1,1,8,2022-02-12T18:44:13.277Z
2022-02-12,1:30 PM,2,1,3,0,0,6,2022-02-12T19:31:56.757Z
2022-02-12,2:30 PM,4,1,2,1,1,9,2022-02-12T20:30:32.440Z
2022-02-14,8:30 AM,0,4,0,0,0,4,2022-02-14T14:32:09.798Z
2022-02-14,9:30 AM,2,4,4,1,0,11,2022-02-14T15:35:51.458Z
2022-02-14,10:30 AM,7,5,10,3,0,25,2022-02-14T16:34:17.510Z
2022-02-14,11:30 AM,9,2,7,0,0,18,2022-02-14T17:40:00.665Z
2022-02-14,1:30 PM,10,5,12,2,3,32,2022-02-14T19:32:40.870Z
2022-02-14,2:30 PM,7,1,5,2,1,16,2022-02-14T21:01:46.483Z
2022-02-14,3:30 PM,7,0,4,0,0,11,2022-02-15T02:34:30.511Z
2022-02-14,4:30 PM,5,1,4,1,0,11,2022-02-15T02:35:24.152Z
2022-02-14,5:30 PM,3,1,5,1,0,10,2022-02-15T02:35:51.119Z
2022-02-14,6:30 PM,3,1,5,0,0,9,2022-02-15T02:36:12.192Z
2022-02-14,7:30 PM,2,1,3,0,0,6,2022-02-15T02:36:33.888Z
2022-02-14,8:30 PM,1,0,2,0,1,4,2022-02-15T02:47:09.211Z
2022-02-15,8:30 AM,3,3,1,1,0,8,2022-02-15T14:36:15.979Z
2022-02-15,9:30 AM,6,2,5,2,0,15,2022-02-15T15:34:05.562Z
2022-02-15,12:30 AM,0,5,6,2,0,13,2022-02-15T16:30:56.609Z
2022-02-15,1:30 PM,6,0,7,0,0,13,2022-02-15T19:32:11.862Z
2022-02-15,2:30 PM,5,0,4,0,2,11,2022-02-15T21:21:28.947Z
2022-02-15,3:30 PM,4,0,3,2,0,9,2022-02-15T22:58:42.864Z
2022-02-15,4:30 PM,3,0,4,2,0,9,2022-02-15T22:59:08.871Z
2022-02-15,5:30 PM,7,2,4,2,2,17,2022-02-15T23:38:41.308Z
2022-02-15,6:30 PM,3,2,3,3,5,16,2022-02-16T00:36:42.324Z
2022-02-15,7:30 PM,4,1,1,3,7,16,2022-02-16T01:35:27.611Z
2022-02-16,8:30 AM,0,3,0,0,0,3,2022-02-16T14:32:57.217Z
2022-02-16,9:30 AM,3,2,3,0,0,8,2022-02-16T15:33:09.150Z
2022-02-16,10:30 AM,2,3,7,2,0,14,2022-02-16T16:26:07.671Z
2022-02-16,11:30 AM,7,4,13,0,0,24,2022-02-16T17:28:00.991Z
2022-02-16,1:30 PM,7,1,9,0,2,19,2022-02-16T19:45:00.660Z
2022-02-16,2:30 PM,7,0,5,0,2,14,2022-02-16T20:56:57.771Z
2022-02-16,3:30 PM,8,0,5,0,1,14,2022-02-16T21:50:12.672Z
2022-02-16,4:30 PM,3,2,9,3,0,17,2022-02-16T22:35:59.704Z
2022-02-16,5:30 PM,5,1,3,2,0,11,2022-02-16T23:42:14.271Z
2022-02-16,7:30 PM,4,0,3,0,0,7,2022-02-17T01:39:15.422Z
2022-02-17,8:30 AM,0,3,0,1,0,4,2022-02-17T14:31:07.941Z
2022-02-17,9:30 AM,2,4,5,0,0,11,2022-02-17T15:34:27.194Z
2022-02-17,10:30 AM,3,2,9,0,0,14,2022-02-17T16:40:57.565Z
2022-02-17,12:30 PM,2,3,12,2,2,21,2022-02-17T18:30:38.974Z
2022-02-17,1:30 PM,5,1,3,1,0,10,2022-02-17T21:34:04.614Z
2022-02-17,2:30 PM,5,0,2,0,0,7,2022-02-17T21:34:31.728Z
2022-02-17,3:30 PM,4,2,2,2,2,12,2022-02-17T21:36:25.208Z
2022-02-17,4:30 PM,4,1,3,0,0,8,2022-02-17T22:53:54.582Z
2022-02-17,5:30 PM,4,1,2,1,0,8,2022-02-17T23:33:52.122Z
2022-02-17,6:30 PM,6,1,2,2,2,13,2022-02-18T00:33:08.438Z
2022-02-17,7:30 PM,4,1,3,0,2,10,2022-02-18T01:40:13.415Z
2022-02-18,8:30 AM,0,1,0,0,0,1,2022-02-18T14:33:38.105Z
2022-02-18,9:30 AM,1,1,2,0,0,4,2022-02-18T15:32:24.801Z
2022-02-18,10:30 AM,1,1,3,2,0,7,2022-02-18T16:37:34.108Z
2022-02-18,11:30 AM,9,1,3,2,0,15,2022-02-18T17:38:00.684Z
2022-02-18,12:30 PM,4,2,5,1,0,12,2022-02-18T18:34:26.030Z
2022-02-18,1:30 PM,6,1,5,0,1,13,2022-02-18T19:30:02.472Z
2022-02-18,2:30 PM,4,1,5,0,0,10,2022-02-18T22:58:29.785Z
2022-02-18,3:30 PM,4,1,2,0,1,8,2022-02-18T22:58:48.738Z
2022-02-18,4:30 PM,6,1,0,0,0,7,2022-02-18T22:59:17.049Z
2022-02-18,5:30 PM,4,0,1,1,0,6,2022-02-18T23:38:45.886Z
2022-02-18,6:30 PM,4,0,1,2,0,7,2022-02-19T00:34:14.547Z
2022-02-18,7:30 PM,3,0,1,0,0,4,2022-02-19T01:39:36.788Z
2022-02-19,9:30 AM,2,0,0,0,0,2,2022-02-19T15:27:48.482Z
2022-02-19,10:30 AM,3,2,1,0,0,6,2022-02-19T16:37:28.289Z
2022-02-19,11:30 AM,4,0,2,0,0,6,2022-02-19T17:45:58.544Z
2022-02-19,12:30 PM,4,1,2,1,0,8,2022-02-19T19:09:14.178Z
2022-02-19,1:30 PM,4,1,3,1,0,9,2022-02-19T19:57:21.129Z
2022-02-21,8:30 AM,0,2,0,0,0,2,2022-02-21T14:35:19.907Z
2022-02-21,9:30 AM,2,6,8,0,0,16,2022-02-21T15:32:08.774Z
2022-02-21,10:30 AM,3,7,7,0,0,17,2022-02-21T16:42:10.321Z
2022-02-21,11:30 AM,9,5,8,2,0,24,2022-02-21T17:32:53.440Z
2022-02-21,12:30 PM,13,5,15,7,0,40,2022-02-21T18:33:27.606Z
2022-02-21,1:30 PM,8,5,7,4,1,25,2022-02-21T19:34:07.531Z
2022-02-21,2:30 PM,5,3,6,4,0,18,2022-02-21T20:54:11.674Z
2022-02-21,4:30 PM,10,0,5,4,0,19,2022-02-21T22:37:53.644Z
2022-02-21,5:30 PM,9,5,3,1,3,21,2022-02-21T23:36:10.283Z
2022-02-21,6:30 PM,5,6,6,3,1,21,2022-02-22T00:36:43.071Z
2022-02-21,7:30 PM,2,2,5,4,1,14,2022-02-22T01:33:30.848Z
2022-02-22,8:30 AM,1,2,0,1,0,4,2022-02-22T14:41:50.120Z
2022-02-22,9:30 AM,3,4,3,1,0,11,2022-02-22T15:33:57.841Z
2022-02-22,10:30 AM,4,3,8,3,0,18,2022-02-22T16:38:36.500Z
2022-02-22,12:30 PM,7,2,9,0,2,20,2022-02-22T18:30:00.320Z
2022-02-22,1:30 PM,5,1,4,1,0,11,2022-02-22T22:57:52.959Z
2022-02-22,2:30 PM,5,0,2,0,0,7,2022-02-22T22:58:36.062Z
2022-02-22,3:30 PM,3,2,2,0,0,7,2022-02-22T22:59:04.486Z
2022-02-22,4:30 PM,2,2,1,0,0,5,2022-02-22T22:59:36.255Z
2022-02-22,5:30 PM,2,4,0,3,0,9,2022-02-22T23:34:06.722Z
2022-02-22,6:30 PM,5,2,2,0,0,9,2022-02-23T00:33:16.528Z
2022-02-22,7:30 PM,5,2,0,0,0,7,2022-02-23T01:31:43.511Z
2022-02-28,8:30 AM,0,3,0,0,0,3,2022-02-28T14:35:27.268Z
2022-02-28,9:30 AM,6,3,1,1,0,11,2022-02-28T15:32:31.127Z
2022-02-28,10:30 AM,5,2,8,1,0,16,2022-02-28T16:35:52.925Z
2022-02-28,11:30 AM,5,1,6,1,0,13,2022-02-28T17:30:35.952Z
2022-02-28,12:30 PM,13,4,9,3,2,31,2022-02-28T18:34:31.436Z
2022-02-28,1:30 PM,6,3,9,3,1,22,2022-02-28T19:31:48.519Z
2022-02-28,2:30 PM,6,3,9,3,1,22,2022-02-28T20:35:00.407Z
2022-02-28,3:30 PM,5,3,6,2,2,18,2022-02-28T21:34:33.106Z
2022-02-28,4:30 PM,7,3,5,3,0,18,2022-02-28T22:34:40.413Z
2022-02-28,5:30 PM,6,3,5,0,0,14,2022-02-28T23:37:05.445Z
2022-02-28,6:30 PM,10,4,5,0,1,20,2022-03-01T00:34:20.399Z
2022-02-28,7:30 PM,6,2,2,1,0,11,2022-03-01T01:37:08.353Z
2022-03-01,9:30 AM,5,2,6,0,0,13,2022-03-01T15:48:00.954Z
2022-03-01,10:30 AM,5,4,10,0,0,19,2022-03-01T16:33:01.579Z
2022-03-01,12:30 PM,6,2,8,2,1,19,2022-03-01T18:45:54.526Z
2022-03-01,1:30 PM,3,2,8,4,0,17,2022-03-01T19:34:25.712Z
2022-03-01,2:30 PM,7,0,4,3,1,15,2022-03-01T20:31:57.414Z
2022-03-01,3:30 PM,5,3,6,2,2,18,2022-03-01T21:56:19.911Z
2022-03-01,4:30 PM,3,3,1,2,0,9,2022-03-01T22:34:07.072Z
2022-03-01,5:30 PM,2,1,3,0,0,6,2022-03-01T23:35:21.318Z
2022-03-01,6:30 PM,5,4,2,1,4,16,2022-03-02T00:39:55.329Z
2022-03-01,7:30 PM,2,2,2,0,4,10,2022-03-02T01:35:27.815Z
2022-03-02,8:30 AM,1,1,2,0,0,4,2022-03-02T14:32:27.039Z
2022-03-02,9:30 AM,2,3,5,1,0,11,2022-03-02T15:42:09.169Z
2022-03-02,10:30 AM,2,4,9,1,0,16,2022-03-02T16:35:24.012Z
2022-03-02,11:30 AM,5,5,9,1,0,20,2022-03-02T17:27:59.086Z
2022-03-02,12:30 PM,13,4,9,8,2,36,2022-03-02T18:33:23.573Z
2022-03-02,1:30 PM,5,3,6,5,1,20,2022-03-02T19:32:48.762Z
2022-03-02,2:30 PM,6,2,6,2,0,16,2022-03-02T20:34:21.711Z
2022-03-02,3:30 PM,5,3,5,3,4,20,2022-03-02T21:33:03.856Z
2022-03-02,4:30 PM,4,2,4,3,0,13,2022-03-02T22:42:25.534Z
2022-03-02,5:30 PM,7,4,1,0,0,12,2022-03-02T23:37:27.998Z
2022-03-02,6:30 PM,4,1,3,0,2,10,2022-03-03T00:36:36.002Z
2022-03-02,7:30 PM,1,1,2,0,0,4,2022-03-03T01:35:36.022Z
2022-03-03,8:30 AM,1,3,0,1,0,5,2022-03-03T14:32:29.775Z
2022-03-03,9:30 AM,1,2,4,1,0,8,2022-03-03T15:31:44.639Z
2022-03-03,10:30 AM,6,6,4,1,0,17,2022-03-03T16:34:08.912Z
2022-03-03,12:30 PM,5,1,6,2,1,15,2022-03-03T18:34:57.926Z
2022-03-03,1:30 PM,3,0,3,0,2,8,2022-03-03T19:57:55.371Z
2022-03-03,2:30 PM,4,1,4,0,2,11,2022-03-03T20:32:58.764Z
2022-03-03,3:30 PM,3,0,3,0,0,6,2022-03-03T22:58:29.415Z
2022-03-03,4:30 PM,3,0,5,0,0,8,2022-03-03T22:58:47.422Z
2022-03-03,5:30 PM,0,0,4,1,0,5,2022-03-03T23:36:23.340Z
2022-03-03,6:30 PM,1,0,1,0,0,2,2022-03-04T00:33:44.199Z
2022-03-03,7:30 PM,3,1,1,0,0,5,2022-03-04T01:37:15.216Z
2022-03-04,8:30 AM,0,1,0,0,0,1,2022-03-04T14:29:41.296Z
2022-03-04,9:30 AM,0,1,1,0,0,2,2022-03-04T15:30:11.328Z
2022-03-04,10:30 AM,1,2,5,0,0,8,2022-03-04T16:44:09.801Z
2022-03-04,11:30 AM,5,2,2,1,0,10,2022-03-04T17:44:20.371Z
2022-03-04,12:30 PM,6,2,4,1,0,13,2022-03-04T18:31:08.483Z
2022-03-04,1:30 PM,5,0,5,0,0,10,2022-03-04T19:33:07.395Z
2022-03-04,2:30 PM,3,0,5,0,0,8,2022-03-04T21:13:19.292Z
2022-03-04,3:30 PM,2,0,1,0,0,3,2022-03-04T22:06:54.273Z
2022-03-04,5:30 PM,2,0,0,0,0,2,2022-03-04T23:32:23.960Z
2022-03-04,6:30 PM,2,0,1,0,2,5,2022-03-05T00:33:16.006Z
2022-03-04,7:30 PM,3,0,1,0,2,6,2022-03-05T01:48:05.057Z
2022-03-05,9:30 AM,1,0,0,0,0,1,2022-03-05T15:33:52.008Z
2022-03-05,10:30 AM,4,0,1,0,0,5,2022-03-05T16:38:34.222Z
2022-03-05,11:30 AM,5,1,1,0,0,7,2022-03-05T17:59:29.543Z
2022-03-05,12:30 PM,4,1,3,0,0,8,2022-03-05T18:33:11.731Z
2022-03-05,1:30 PM,9,1,4,0,0,14,2022-03-05T19:25:32.237Z
2022-03-05,1:30 PM,7,0,3,2,0,12,2022-03-05T19:33:40.469Z
2022-03-07,8:30 AM,1,5,0,2,0,8,2022-03-07T14:32:37.289Z
2022-03-07,9:30 AM,3,5,5,1,0,14,2022-03-07T15:36:23.726Z
2022-03-07,10:30 AM,3,6,6,3,0,18,2022-03-07T16:30:52.362Z
2022-03-07,11:30 AM,11,1,7,3,0,22,2022-03-07T17:28:04.133Z
2022-03-07,12:30 PM,15,5,12,7,3,42,2022-03-07T18:33:13.915Z
2022-03-07,1:30 PM,8,5,12,5,0,30,2022-03-07T19:47:32.344Z
2022-03-07,2:30 PM,6,1,4,0,0,11,2022-03-07T22:05:43.770Z
2022-03-07,3:30 PM,5,2,5,2,0,14,2022-03-07T22:06:09.984Z
2022-03-07,4:30 PM,8,4,5,1,1,19,2022-03-07T22:33:03.373Z
2022-03-07,5:30 PM,8,2,6,0,1,17,2022-03-07T23:35:43.221Z
2022-03-07,6:30 PM,3,1,4,0,1,9,2022-03-08T00:32:52.921Z
2022-03-07,7:30 PM,6,0,7,0,1,14,2022-03-08T01:33:23.978Z
2022-03-08,9:30 AM,2,5,6,1,0,14,2022-03-08T15:00:15.140Z
2022-03-08,9:30 AM,3,2,6,1,0,12,2022-03-08T15:33:25.588Z
2022-03-08,10:30 AM,6,7,6,1,0,20,2022-03-08T16:33:21.336Z
2022-03-08,12:30 PM,8,4,8,2,3,25,2022-03-08T18:32:38.589Z
2022-03-08,1:30 PM,7,2,6,2,0,17,2022-03-08T20:09:25.797Z
2022-03-08,2:30 PM,5,1,4,0,0,10,2022-03-08T22:58:42.746Z
2022-03-08,3:30 PM,5,1,3,2,0,11,2022-03-08T22:59:04.082Z
2022-03-08,4:30 PM,3,0,5,0,0,8,2022-03-08T22:59:23.050Z
2022-03-08,5:30 PM,2,1,4,1,0,8,2022-03-08T23:34:37.390Z
2022-03-08,6:30 PM,2,0,3,1,3,9,2022-03-09T00:35:37.683Z
2022-03-08,7:30 PM,2,0,2,1,3,8,2022-03-09T01:37:17.119Z
2022-03-09,8:30 AM,0,3,1,0,0,4,2022-03-09T14:32:29.607Z
2022-03-09,9:30 AM,0,2,5,2,0,9,2022-03-09T15:32:20.615Z
2022-03-09,10:30 AM,1,7,5,2,0,15,2022-03-09T16:31:56.406Z
2022-03-09,11:30 AM,10,9,11,6,0,36,2022-03-09T17:30:45.426Z
2022-03-09,12:30 PM,14,5,15,6,4,44,2022-03-09T18:29:20.538Z
2022-03-09,1:30 PM,8,2,2,5,2,19,2022-03-09T19:32:59.073Z
2022-03-09,2:30 PM,9,1,2,3,2,17,2022-03-09T20:29:35.144Z
2022-03-09,3:30 PM,8,0,1,3,0,12,2022-03-09T21:34:48.988Z
2022-03-09,4:30 PM,7,0,3,3,3,16,2022-03-09T22:35:16.909Z
2022-03-09,5:30 PM,5,1,2,1,2,11,2022-03-09T23:36:07.554Z
2022-03-09,6:30 PM,4,4,1,2,2,13,2022-03-10T00:37:30.658Z
2022-03-09,7:30 PM,5,1,0,2,3,11,2022-03-10T01:31:51.226Z
2022-03-10,9:30 AM,1,4,6,2,0,13,2022-03-10T15:34:52.514Z
2022-03-10,10:30 AM,4,4,10,2,0,20,2022-03-10T16:33:21.957Z
2022-03-10,1:30 PM,5,0,3,0,0,8,2022-03-10T19:31:20.850Z
2022-03-10,2:30 PM,5,2,3,0,0,10,2022-03-10T20:49:15.457Z
2022-03-10,3:30 PM,10,3,5,3,2,23,2022-03-10T21:34:46.900Z
2022-03-10,4:30 PM,5,2,2,0,0,9,2022-03-10T22:59:07.803Z
2022-03-10,5:30 PM,7,1,0,0,0,8,2022-03-10T23:36:40.092Z
2022-03-10,6:30 PM,4,0,1,1,0,6,2022-03-11T00:31:24.126Z
2022-03-10,7:30 PM,2,0,0,1,0,3,2022-03-11T01:33:28.053Z
2022-03-10,8:30 PM,1,0,0,0,0,1,2022-03-11T02:24:20.898Z
2022-03-11,8:30 AM,0,2,0,0,0,2,2022-03-11T14:31:51.528Z
2022-03-11,9:30 AM,0,2,0,0,1,3,2022-03-11T15:37:21.217Z
2022-03-11,10:30 AM,0,2,0,0,0,2,2022-03-11T16:33:14.017Z
2022-03-11,11:30 AM,1,1,1,0,0,3,2022-03-11T19:07:41.827Z
2022-03-11,12:30 PM,2,0,3,0,0,5,2022-03-11T19:08:14.314Z
2022-03-11,1:30 PM,3,0,6,0,0,9,2022-03-11T19:46:42.912Z
2022-03-12,9:30 AM,1,0,0,0,0,1,2022-03-12T15:30:37.354Z
2022-03-12,10:30 PM,1,2,0,0,1,4,2022-03-12T19:35:24.660Z
2022-03-12,11:30 PM,2,0,0,0,0,2,2022-03-12T19:35:37.491Z
2022-03-12,12:30 PM,2,2,0,0,0,4,2022-03-12T19:35:53.292Z
2022-03-12,1:30 PM,3,2,0,0,0,5,2022-03-12T19:36:05.748Z
2022-03-12,2:30 PM,4,0,1,0,0,5,2022-03-12T20:12:25.950Z
2022-03-12,3:30 PM,1,0,1,0,0,2,2022-03-12T21:30:03.317Z
2022-03-14,10:30 AM,6,1,1,0,0,8,2022-03-14T15:36:37.586Z
2022-03-14,12:30 PM,2,2,2,0,2,8,2022-03-14T17:35:53.518Z
2022-03-14,1:30 PM,2,0,0,11,0,13,2022-03-14T18:32:31.824Z
2022-03-14,1:30 PM,2,2,4,2,2,12,2022-03-14T18:56:18.391Z
2022-03-14,2:30 PM,2,1,5,0,2,10,2022-03-14T19:54:58.166Z
2022-03-14,3:30 PM,2,1,2,0,1,6,2022-03-14T20:42:16.368Z
2022-03-14,4:30 PM,0,1,1,1,0,3,2022-03-14T21:40:58.598Z
2022-03-14,5:30 PM,1,0,1,0,1,3,2022-03-14T22:37:16.087Z
2022-03-15,9:30 AM,2,0,1,0,0,3,2022-03-15T14:32:20.710Z
2022-03-15,10:30 AM,2,0,1,2,1,6,2022-03-15T15:29:05.338Z
2022-03-15,11:30 AM,3,0,1,2,0,6,2022-03-15T16:32:38.540Z
2022-03-15,12:30 PM,3,3,3,1,0,10,2022-03-15T17:37:04.664Z
2022-03-15,1:30 PM,3,0,1,1,0,5,2022-03-15T18:36:22.367Z
2022-03-15,2:30 PM,3,0,2,0,0,5,2022-03-15T19:34:01.145Z
2022-03-15,3:30 PM,2,0,7,3,0,12,2022-03-15T20:26:29.236Z
2022-03-15,4:30 PM,1,0,0,1,0,2,2022-03-15T21:45:10.511Z
2022-03-16,11:30 AM,4,1,2,3,0,10,2022-03-16T16:40:30.340Z
2022-03-16,12:30 PM,3,2,1,3,0,9,2022-03-16T17:33:23.750Z
2022-03-16,9:30 PM,5,0,4,1,1,11,2022-03-16T17:34:16.795Z
2022-03-16,10:30 PM,5,0,0,0,0,5,2022-03-16T17:34:33.069Z
2022-03-16,1:30 PM,4,1,1,2,1,9,2022-03-16T18:51:28.257Z
2022-03-16,2:30 PM,2,2,4,0,2,10,2022-03-16T19:38:41.608Z
2022-03-16,3:30 PM,3,0,2,1,0,6,2022-03-16T20:41:55.394Z
2022-03-16,4:30 PM,4,1,1,1,0,7,2022-03-16T21:51:17.718Z
2022-03-17,9:30 AM,1,0,1,0,0,2,2022-03-17T14:34:14.325Z
2022-03-17,10:30 AM,3,0,1,0,0,4,2022-03-17T15:46:58.696Z
2022-03-17,11:30 AM,5,0,1,0,0,6,2022-03-17T16:36:06.950Z
2022-03-17,12:30 PM,1,0,2,1,0,4,2022-03-17T17:31:41.667Z
2022-03-17,1:30 PM,2,1,2,0,1,6,2022-03-17T18:34:03.633Z
2022-03-17,2:30 PM,3,2,2,0,0,7,2022-03-17T19:50:08.147Z
2022-03-17,3:30 PM,2,1,2,0,0,5,2022-03-17T20:44:25.070Z
2022-03-17,4:30 PM,1,1,1,0,0,3,2022-03-17T21:40:28.971Z
2022-03-18,9:30 AM,1,0,1,0,0,2,2022-03-18T14:31:39.944Z
2022-03-18,10:30 AM,6,1,2,0,0,9,2022-03-18T15:44:46.090Z
2022-03-18,11:30 AM,5,1,2,1,0,9,2022-03-18T16:42:23.942Z
2022-03-18,12:30 PM,10,1,2,1,0,14,2022-03-18T17:38:30.940Z
2022-03-18,1:30 PM,4,1,2,0,0,7,2022-03-18T18:37:17.621Z
2022-03-18,2:30 PM,4,1,2,0,1,8,2022-03-18T19:57:04.615Z
2022-03-18,3:30 PM,8,0,3,0,0,11,2022-03-18T20:31:31.853Z
2022-03-18,4:30 PM,4,0,2,0,0,6,2022-03-18T21:34:25.202Z
2022-03-21,8:30 AM,3,3,1,0,0,7,2022-03-21T13:29:47.174Z
2022-03-21,9:30 AM,8,3,5,1,1,18,2022-03-21T14:41:08.264Z
2022-03-21,10:30 AM,12,2,12,1,0,27,2022-03-21T15:29:53.663Z
2022-03-21,11:30 AM,10,2,6,5,0,23,2022-03-21T16:29:26.000Z
2022-03-21,12:30 PM,14,6,8,12,2,42,2022-03-21T17:32:15.150Z
2022-03-21,1:30 PM,7,3,7,3,2,22,2022-03-21T18:33:54.121Z
2022-03-21,2:30 PM,4,2,5,2,2,15,2022-03-21T19:32:31.514Z
2022-03-21,3:30 PM,8,2,3,0,1,14,2022-03-21T20:32:15.262Z
2022-03-21,4:30 PM,5,1,5,2,0,13,2022-03-21T21:36:10.447Z
2022-03-21,5:30 PM,6,1,4,1,1,13,2022-03-21T22:35:17.912Z
2022-03-21,6:30 PM,0,2,2,0,3,7,2022-03-21T23:59:12.892Z
2022-03-22,7:30 AM,2,0,0,0,0,2,2022-03-22T12:59:27.660Z
2022-03-22,8:30 AM,0,1,0,1,0,2,2022-03-22T13:33:55.578Z
2022-03-22,9:30 AM,4,2,3,2,0,11,2022-03-22T14:31:02.618Z
2022-03-22,10:30 AM,14,2,8,2,0,26,2022-03-22T15:31:00.984Z
2022-03-22,11:30 PM,6,2,4,0,0,12,2022-03-22T17:50:44.997Z
2022-03-22,12:30 PM,8,2,6,0,0,16,2022-03-22T17:51:32.544Z
2022-03-22,1:30 PM,6,1,4,2,0,13,2022-03-22T18:40:02.443Z
2022-03-22,2:30 PM,3,2,7,2,0,14,2022-03-22T19:31:33.126Z
2022-03-22,3:30 PM,5,2,4,1,0,12,2022-03-22T20:29:37.635Z
2022-03-22,4:30 PM,6,2,2,1,0,11,2022-03-22T21:36:42.063Z
2022-03-22,5:30 PM,3,2,2,0,0,7,2022-03-22T22:34:19.117Z
2022-03-22,6:30 PM,2,1,0,0,0,3,2022-03-22T23:33:11.494Z
2022-03-22,7:30 PM,2,1,0,1,0,4,2022-03-23T00:36:06.937Z
2022-03-23,8:30 AM,1,2,0,0,0,3,2022-03-23T13:34:03.558Z
2022-03-23,9:30 AM,5,1,3,1,0,10,2022-03-23T14:36:52.150Z
2022-03-23,10:30 AM,3,3,7,1,0,14,2022-03-23T15:35:30.140Z
2022-03-23,11:30 AM,3,2,9,4,0,18,2022-03-23T16:29:02.400Z
2022-03-23,1:30 PM,7,6,14,4,2,33,2022-03-23T18:32:28.021Z
2022-03-23,2:30 PM,5,0,4,2,0,11,2022-03-23T20:33:30.438Z
2022-03-23,3:30 PM,4,1,5,0,0,10,2022-03-23T20:34:36.574Z
2022-03-23,4:30 PM,2,3,10,2,3,20,2022-03-23T21:38:18.308Z
2022-03-23,5:30 PM,4,4,3,0,0,11,2022-03-23T22:44:50.612Z
2022-03-23,6:30 PM,4,4,3,1,1,13,2022-03-23T23:32:15.949Z
2022-03-23,7:30 PM,3,1,2,2,2,10,2022-03-24T00:32:44.906Z
2022-03-24,8:30 AM,0,3,0,0,0,3,2022-03-24T13:33:34.292Z
2022-03-24,10:30 AM,1,2,6,2,0,11,2022-03-24T15:31:52.888Z
2022-03-24,1:30 PM,2,0,8,4,0,14,2022-03-24T18:32:41.284Z
2022-03-24,2:30 PM,7,1,4,2,0,14,2022-03-24T20:35:30.015Z
2022-03-24,3:30 PM,6,1,1,1,0,9,2022-03-24T20:35:57.454Z
2022-03-24,4:30 PM,4,2,3,0,0,9,2022-03-24T22:19:23.764Z
2022-03-24,5:30 PM,2,4,5,0,0,11,2022-03-24T22:37:38.930Z
2022-03-24,6:30 PM,2,1,4,1,1,9,2022-03-24T23:37:38.528Z
2022-03-24,7:30 PM,2,0,0,0,3,5,2022-03-25T00:32:24.435Z
2022-03-25,8:30 AM,1,2,0,0,0,3,2022-03-25T13:40:28.240Z
2022-03-25,10:30 AM,1,2,3,0,0,6,2022-03-25T15:35:06.512Z
2022-03-25,1:30 PM,1,2,8,1,0,12,2022-03-25T18:30:00.446Z
2022-03-25,5:30 PM,1,0,1,0,2,4,2022-03-25T22:31:22.113Z
2022-03-25,6:30 PM,0,1,0,0,0,1,2022-03-25T23:32:25.418Z
2022-03-25,7:30 PM,0,1,0,0,0,1,2022-03-26T00:37:17.600Z
2022-03-26,9:30 AM,0,0,0,0,0,0,2022-03-26T15:16:12.897Z
2022-03-26,10:30 AM,2,0,1,0,0,3,2022-03-26T15:46:13.125Z
2022-03-26,11:30 AM,3,0,3,0,0,6,2022-03-26T16:40:29.379Z
2022-03-26,12:30 PM,3,0,3,1,1,8,2022-03-26T18:30:23.412Z
2022-03-26,1:30 PM,1,0,2,0,1,4,2022-03-26T18:30:45.227Z
2022-03-28,8:30 AM,2,3,0,0,0,5,2022-03-28T13:32:23.924Z
2022-03-28,9:30 AM,7,5,6,0,0,18,2022-03-28T14:30:50.385Z
2022-03-28,10:30 AM,5,6,8,0,0,19,2022-03-28T15:32:37.592Z
2022-03-28,11:30 AM,10,3,6,4,0,23,2022-03-28T16:31:51.365Z
2022-03-28,12:30 PM,12,3,6,4,0,25,2022-03-28T17:30:53.973Z
2022-03-28,1:30 PM,9,4,8,2,1,24,2022-03-28T18:24:33.344Z
2022-03-28,2:30 PM,5,5,7,2,0,19,2022-03-28T19:32:17.744Z
2022-03-28,3:30 PM,6,4,3,2,0,15,2022-03-28T20:31:19.664Z
2022-03-28,4:30 PM,5,2,2,2,4,15,2022-03-28T21:52:36.393Z
2022-03-28,5:30 PM,3,1,2,2,2,10,2022-03-28T22:34:17.941Z
2022-03-28,6:30 PM,3,2,3,2,1,11,2022-03-28T23:41:03.115Z
2022-03-28,7:30 PM,4,1,5,2,2,14,2022-03-29T00:36:22.599Z
2022-03-29,8:30 AM,0,5,2,2,0,9,2022-03-29T13:34:22.799Z
2022-03-29,9:30 AM,5,3,3,2,0,13,2022-03-29T14:34:28.295Z
2022-03-29,10:30 AM,2,2,6,5,0,15,2022-03-29T15:31:35.392Z
2022-03-29,11:30 AM,3,3,5,2,0,13,2022-03-29T16:29:56.090Z
2022-03-29,12:30 PM,6,1,11,4,1,23,2022-03-29T17:30:06.526Z
2022-03-29,1:30 PM,3,1,9,3,1,17,2022-03-29T18:31:01.917Z
2022-03-29,2:30 PM,4,2,10,3,0,19,2022-03-29T19:31:25.954Z
2022-03-29,5:30 PM,2,2,3,1,4,12,2022-03-29T22:33:10.799Z
2022-03-29,6:30 PM,2,2,1,1,3,9,2022-03-29T23:33:25.897Z
2022-03-29,7:30 PM,0,1,0,0,0,1,2022-03-30T00:32:17.078Z
2022-03-30,8:30 AM,2,2,0,1,0,5,2022-03-30T13:32:04.565Z
2022-03-30,9:30 AM,1,2,3,1,0,7,2022-03-30T14:40:07.136Z
2022-03-30,10:30 AM,2,3,5,4,0,14,2022-03-30T15:36:31.131Z
2022-03-30,11:30 AM,7,1,9,3,4,24,2022-03-30T16:31:13.407Z
2022-03-30,12:30 PM,8,3,12,4,0,27,2022-03-30T17:32:34.857Z
2022-03-30,1:30 PM,4,2,12,5,2,25,2022-03-30T18:31:15.116Z
2022-03-30,2:30 PM,10,3,9,5,2,29,2022-03-30T19:30:12.069Z
2022-03-30,4:30 PM,8,0,4,2,0,14,2022-03-30T21:00:20.798Z
2022-03-30,5:30 PM,5,1,4,0,0,10,2022-03-31T01:43:51.181Z
2022-03-30,6:30 PM,4,0,4,2,0,10,2022-03-31T01:44:26.923Z
2022-03-30,7:30 PM,4,0,2,0,0,6,2022-03-31T01:44:55.275Z
2022-03-30,8:30 PM,2,0,1,0,2,5,2022-03-31T01:45:22.115Z
2022-03-31,8:30 AM,2,0,1,0,0,3,2022-03-31T13:29:50.707Z
2022-03-31,10:30 AM,6,1,8,1,0,16,2022-03-31T15:36:22.006Z
2022-03-31,11:30 AM,3,1,9,2,1,16,2022-03-31T16:27:11.882Z
2022-03-31,12:30 PM,3,4,8,2,1,18,2022-03-31T17:31:50.243Z
2022-03-31,1:30 PM,4,1,10,2,1,18,2022-03-31T18:28:57.883Z
2022-03-31,2:30 PM,5,2,4,2,0,13,2022-03-31T19:27:21.562Z
2022-03-31,5:30 PM,4,1,3,0,5,13,2022-03-31T22:36:58.347Z
2022-03-31,6:30 PM,3,0,3,2,5,13,2022-03-31T23:31:51.362Z
2022-03-31,7:30 PM,1,2,2,2,5,12,2022-04-01T00:34:36.771Z
2022-04-01,8:30 AM,0,1,0,0,0,1,2022-04-01T14:00:01.178Z
2022-04-01,9:30 AM,0,2,1,0,0,3,2022-04-01T14:32:27.633Z
2022-04-01,11:30 AM,4,1,3,2,0,10,2022-04-01T16:25:52.368Z
2022-04-01,12:30 PM,5,0,2,1,4,12,2022-04-01T17:25:15.412Z
2022-04-01,1:30 PM,2,1,3,2,3,11,2022-04-01T18:28:10.936Z
2022-04-01,2:30 PM,5,2,3,1,0,11,2022-04-01T19:25:36.731Z
2022-04-01,3:30 PM,4,0,2,0,0,6,2022-04-01T22:08:21.923Z
2022-04-01,4:30 PM,2,0,1,0,0,3,2022-04-01T22:08:46.818Z
2022-04-01,5:30 PM,1,0,2,1,1,5,2022-04-01T22:34:43.065Z
2022-04-01,6:30 PM,2,0,1,2,1,6,2022-04-01T23:35:04.962Z
2022-04-01,7:30 PM,1,0,2,1,1,5,2022-04-02T00:33:20.819Z
2022-04-02,2:30 PM,3,1,6,2,0,12,2022-04-02T19:33:21.844Z
2022-04-02,3:30 PM,4,2,7,2,0,15,2022-04-02T20:33:26.850Z
2022-04-02,4:30 PM,3,0,3,1,0,7,2022-04-02T21:30:10.359Z
2022-04-04,8:30 AM,1,4,0,0,0,5,2022-04-04T13:44:59.528Z
2022-04-04,9:30 AM,3,4,6,1,0,14,2022-04-04T14:31:04.648Z
2022-04-04,10:30 AM,3,3,7,2,0,15,2022-04-04T15:33:06.926Z
2022-04-04,11:30 AM,8,2,10,4,0,24,2022-04-04T16:30:51.547Z
2022-04-04,1:30 PM,6,1,4,5,0,16,2022-04-04T18:31:01.281Z
2022-04-04,2:30 PM,5,0,4,2,0,11,2022-04-04T21:35:24.148Z
2022-04-04,3:30 PM,6,2,6,4,2,20,2022-04-04T21:35:47.923Z
2022-04-04,4:30 PM,11,1,6,2,0,20,2022-04-04T21:36:19.899Z
2022-04-04,5:30 PM,11,0,5,2,3,21,2022-04-04T22:34:23.740Z
2022-04-04,6:30 PM,3,1,3,1,1,9,2022-04-04T23:33:46.355Z
2022-04-04,7:30 PM,1,1,2,2,1,7,2022-04-05T00:37:46.525Z
2022-04-05,8:30 AM,1,2,2,0,0,5,2022-04-05T13:32:09.055Z
2022-04-05,9:30 AM,1,5,5,1,0,12,2022-04-05T14:31:53.329Z
2022-04-05,10:30 AM,6,6,3,1,0,16,2022-04-05T15:55:05.838Z
2022-04-05,11:30 AM,5,3,5,1,0,14,2022-04-05T16:26:13.770Z
2022-04-05,12:30 PM,6,5,7,2,2,22,2022-04-05T17:28:40.511Z
2022-04-05,1:30 PM,5,5,9,1,1,21,2022-04-05T18:36:57.391Z
2022-04-05,2:30 PM,3,2,1,8,2,16,2022-04-05T19:29:29.223Z
2022-04-05,5:30 PM,5,0,4,1,6,16,2022-04-05T22:37:55.928Z
2022-04-05,6:30 PM,5,1,4,1,1,12,2022-04-05T23:36:43.095Z
2022-04-05,7:30 PM,1,2,1,2,0,6,2022-04-06T00:33:35.052Z
2022-04-06,8:30 AM,1,2,1,0,0,4,2022-04-06T13:31:57.860Z
2022-04-06,9:30 AM,4,1,4,1,0,10,2022-04-06T14:32:49.546Z
2022-04-06,10:30 AM,0,4,7,2,0,13,2022-04-06T15:30:17.279Z
2022-04-06,11:30 AM,6,4,7,1,2,20,2022-04-06T16:29:57.766Z
2022-04-06,12:30 PM,9,3,11,2,3,28,2022-04-06T17:30:51.354Z
2022-04-06,1:30 PM,7,2,8,2,1,20,2022-04-06T18:30:26.952Z
2022-04-06,2:30 PM,6,2,4,2,2,16,2022-04-06T19:28:02.647Z
2022-04-06,3:30 PM,6,3,9,0,0,18,2022-04-06T20:33:22.508Z
2022-04-06,7:30 PM,0,2,2,0,0,4,2022-04-07T00:39:26.455Z
2022-04-06,8:30 PM,0,0,0,0,0,0,2022-04-07T01:34:14.448Z
2022-04-07,8:30 AM,1,3,0,1,0,5,2022-04-07T13:40:40.400Z
2022-04-07,9:30 AM,3,3,2,0,0,8,2022-04-07T14:31:56.208Z
2022-04-07,10:30 AM,2,6,7,2,0,17,2022-04-07T15:39:30.475Z
2022-04-07,11:30 AM,5,1,10,0,1,17,2022-04-07T16:29:10.170Z
2022-04-07,12:30 PM,4,2,10,2,1,19,2022-04-07T17:28:47.782Z
2022-04-07,1:30 PM,2,3,10,2,2,19,2022-04-07T18:29:41.206Z
2022-04-07,2:30 PM,0,3,4,2,2,11,2022-04-07T19:28:38.762Z
2022-04-07,5:30 PM,1,0,6,2,2,11,2022-04-07T22:36:40.915Z
2022-04-07,6:30 PM,1,1,2,2,1,7,2022-04-07T23:31:28.829Z
2022-04-07,7:30 PM,2,1,2,0,1,6,2022-04-08T00:33:48.781Z
2022-04-08,8:30 AM,1,2,0,0,0,3,2022-04-08T13:35:17.822Z
2022-04-08,9:30 AM,0,3,2,0,0,5,2022-04-08T14:31:30.029Z
2022-04-08,11:30 AM,2,3,2,0,0,7,2022-04-08T16:01:29.620Z
2022-04-08,11:30 AM,2,2,5,0,0,9,2022-04-08T16:28:07.372Z
2022-04-08,12:30 PM,4,2,3,0,0,9,2022-04-08T17:29:18.911Z
2022-04-08,1:30 PM,6,1,3,2,1,13,2022-04-08T18:29:02.928Z
2022-04-08,2:30 PM,2,2,0,1,0,5,2022-04-08T19:34:23.634Z
2022-04-08,4:30 PM,2,1,2,1,0,6,2022-04-08T21:36:09.789Z
2022-04-08,5:30 PM,5,0,2,1,0,8,2022-04-08T22:32:40.563Z
2022-04-08,6:30 PM,0,1,2,0,0,3,2022-04-08T23:34:02.790Z
2022-04-08,7:30 PM,0,1,1,0,0,2,2022-04-09T00:41:58.854Z
2022-04-09,9:30 AM,1,0,0,0,0,1,2022-04-09T18:29:48.043Z
2022-04-09,10:30 AM,1,0,0,0,1,2,2022-04-09T18:30:05.018Z
2022-04-09,11:30 AM,2,0,0,0,1,3,2022-04-09T18:30:25.274Z
2022-04-09,12:30 AM,3,0,0,0,3,6,2022-04-09T18:30:44.530Z
2022-04-09,1:30 PM,1,0,2,0,0,3,2022-04-09T18:31:11.090Z
2022-04-11,8:30 AM,2,2,3,0,0,7,2022-04-11T13:31:46.280Z
2022-04-11,9:30 AM,3,2,5,1,0,11,2022-04-11T14:32:18.358Z
2022-04-11,10:30 AM,7,1,9,4,0,21,2022-04-11T15:33:30.433Z
2022-04-11,11:30 AM,6,1,9,0,0,16,2022-04-11T16:28:47.736Z
2022-04-11,12:30 PM,7,1,9,4,1,22,2022-04-11T17:29:00.976Z
2022-04-11,1:30 PM,5,3,9,2,2,21,2022-04-11T18:29:31.675Z
2022-04-11,2:30 PM,9,1,5,4,1,20,2022-04-11T19:28:13.402Z
2022-04-11,3:30 PM,7,3,4,0,5,19,2022-04-11T20:53:29.383Z
2022-04-11,4:30 PM,1,4,5,1,5,16,2022-04-11T21:36:03.076Z
2022-04-11,5:30 PM,3,0,3,0,5,11,2022-04-11T22:38:07.565Z
2022-04-11,6:30 PM,2,0,1,1,5,9,2022-04-11T23:50:48.991Z
2022-04-12,8:30 AM,1,4,2,1,0,8,2022-04-12T13:34:02.261Z
2022-04-12,9:30 AM,3,3,2,0,0,8,2022-04-12T14:30:52.360Z
2022-04-12,10:30 AM,10,6,4,0,0,20,2022-04-12T15:36:45.485Z
2022-04-12,11:30 AM,4,1,6,2,0,13,2022-04-12T16:28:24.715Z
2022-04-12,12:30 PM,9,0,6,1,3,19,2022-04-12T17:29:49.303Z
2022-04-12,1:30 PM,7,0,5,2,1,15,2022-04-12T18:28:01.226Z
2022-04-12,2:30 PM,6,0,5,2,4,17,2022-04-12T19:37:32.189Z
2022-04-12,3:30 PM,5,2,4,2,0,13,2022-04-12T22:31:00.843Z
2022-04-12,4:30 PM,4,1,3,0,0,8,2022-04-12T22:31:25.114Z
2022-04-12,5:30 PM,3,3,3,2,1,12,2022-04-12T22:34:50.954Z
2022-04-12,6:30 PM,2,2,2,1,2,9,2022-04-12T23:34:57.456Z
2022-04-12,7:30 PM,0,2,0,0,0,2,2022-04-13T00:44:01.548Z
2022-04-13,8:30 AM,2,1,6,0,0,9,2022-04-13T13:48:33.453Z
2022-04-13,9:30 AM,1,1,7,1,0,10,2022-04-13T14:33:18.207Z
2022-04-13,10:30 AM,2,3,3,1,0,9,2022-04-13T15:45:17.488Z
2022-04-13,11:30 AM,4,3,3,3,0,13,2022-04-13T16:23:06.489Z
2022-04-13,12:30 PM,5,2,7,1,0,15,2022-04-13T17:29:01.572Z
2022-04-13,1:30 PM,0,3,9,3,0,15,2022-04-13T18:29:00.911Z
2022-04-13,2:30 PM,1,3,6,3,0,13,2022-04-13T19:28:56.690Z
2022-04-13,4:30 PM,4,3,3,4,6,20,2022-04-13T21:35:35.954Z
2022-04-13,5:30 PM,3,2,1,2,6,14,2022-04-13T22:39:21.643Z
2022-04-13,6:30 PM,1,1,1,2,2,7,2022-04-13T23:38:23.788Z
2022-04-13,7:30 PM,4,1,0,1,2,8,2022-04-14T00:38:45.586Z
2022-04-14,8:30 AM,3,2,0,0,0,5,2022-04-14T13:33:17.895Z
2022-04-14,9:30 AM,2,2,4,2,0,10,2022-04-14T14:34:00.456Z
2022-04-14,10:30 AM,5,3,5,3,0,16,2022-04-14T15:31:37.332Z
2022-04-14,11:30 AM,2,4,7,3,2,18,2022-04-14T16:29:27.101Z
2022-04-14,12:30 PM,6,2,6,3,1,18,2022-04-14T17:28:07.076Z
2022-04-14,1:30 PM,2,2,4,2,0,10,2022-04-14T18:28:39.409Z
2022-04-14,2:30 PM,2,1,4,2,0,9,2022-04-14T19:29:05.557Z
2022-04-14,5:30 PM,3,1,2,1,1,8,2022-04-14T22:45:46.475Z
2022-04-14,7:30 PM,6,1,0,2,0,9,2022-04-15T00:31:42.808Z
2022-04-15,8:30 AM,0,3,0,1,0,4,2022-04-15T13:30:59.686Z
2022-04-15,10:30 AM,2,2,1,1,0,6,2022-04-15T15:33:55.941Z
2022-04-15,9:30 AM,0,3,0,0,0,3,2022-04-15T15:35:03.886Z
2022-04-15,11:30 AM,2,2,3,3,1,11,2022-04-15T16:32:39.647Z
2022-04-15,12:30 PM,4,3,1,2,0,10,2022-04-15T17:28:16.384Z
2022-04-15,1:30 PM,4,0,4,2,0,10,2022-04-15T18:28:54.458Z
2022-04-15,2:30 PM,3,3,7,2,0,15,2022-04-15T19:28:39.109Z
2022-04-15,3:30 PM,3,1,2,2,0,8,2022-04-15T22:03:49.582Z
2022-04-15,4:30 PM,2,0,1,0,0,3,2022-04-15T22:04:10.837Z
2022-04-15,5:30 PM,3,1,3,0,0,7,2022-04-15T22:33:49.391Z
2022-04-15,6:30 PM,1,2,3,0,0,6,2022-04-15T23:34:44.718Z
2022-04-15,7:30 PM,1,2,3,1,0,7,2022-04-16T00:32:03.430Z
2022-04-16,9:30 AM,2,0,2,0,0,4,2022-04-16T18:31:05.541Z
2022-04-16,10:30 AM,2,0,3,0,2,7,2022-04-16T18:31:27.437Z
2022-04-16,11:30 AM,1,0,2,0,0,3,2022-04-16T18:31:46.784Z
2022-04-16,12:30 PM,1,0,2,0,0,3,2022-04-16T18:32:04.252Z
2022-04-16,1:30 PM,0,0,0,0,0,0,2022-04-16T18:32:27.710Z
2022-04-18,8:30 AM,1,2,0,0,0,3,2022-04-18T13:46:34.503Z
2022-04-18,9:30 AM,3,2,3,0,0,8,2022-04-18T14:30:43.831Z
2022-04-18,10:30 AM,5,4,5,0,0,14,2022-04-18T15:33:48.181Z
2022-04-18,11:30 AM,9,0,6,3,0,18,2022-04-18T16:29:09.461Z
2022-04-18,12:30 PM,8,1,12,2,3,26,2022-04-18T17:34:20.520Z
2022-04-18,1:30 PM,5,2,7,1,1,16,2022-04-18T18:29:12.185Z
2022-04-18,2:30 PM,5,3,7,7,2,24,2022-04-18T19:29:41.072Z
2022-04-18,4:30 PM,8,2,4,4,0,18,2022-04-18T22:31:02.660Z
2022-04-18,5:30 PM,5,1,5,3,0,14,2022-04-18T22:31:21.340Z
2022-04-18,6:30 PM,5,0,5,2,0,12,2022-04-18T23:37:49.644Z
2022-04-18,7:30 PM,4,0,1,1,1,7,2022-04-19T00:32:25.168Z
2022-04-19,8:30 AM,1,2,1,0,0,4,2022-04-19T13:31:58.883Z
2022-04-19,9:30 AM,2,1,4,0,0,7,2022-04-19T14:29:44.612Z
2022-04-19,10:30 AM,7,4,4,2,0,17,2022-04-19T15:31:40.319Z
2022-04-19,11:30 AM,6,3,6,2,4,21,2022-04-19T16:28:42.581Z
2022-04-19,12:30 PM,5,1,12,5,3,26,2022-04-19T17:29:19.805Z
2022-04-19,1:30 PM,2,1,5,1,0,9,2022-04-19T18:31:00.608Z
2022-04-19,2:30 PM,0,2,6,4,3,15,2022-04-19T19:29:11.578Z
2022-04-19,3:30 PM,4,3,7,2,0,16,2022-04-19T20:24:28.285Z
2022-04-19,5:30 PM,2,1,4,3,1,11,2022-04-19T22:35:02.861Z
2022-04-19,6:30 PM,4,1,2,3,4,14,2022-04-19T23:33:53.445Z
2022-04-19,7:30 PM,3,0,3,0,0,6,2022-04-20T00:31:30.638Z
2022-04-20,8:30 AM,0,0,2,0,0,2,2022-04-20T13:31:12.331Z
2022-04-20,9:30 AM,5,0,6,0,0,11,2022-04-20T14:31:04.547Z
2022-04-20,10:30 AM,4,0,8,0,0,12,2022-04-20T15:33:13.415Z
2022-04-20,11:30 AM,4,0,11,1,3,19,2022-04-20T16:29:09.692Z
2022-04-20,12:30 PM,5,2,2,5,1,15,2022-04-20T17:28:13.231Z
2022-04-20,1:30 PM,8,3,8,3,1,23,2022-04-20T18:35:30.019Z
2022-04-20,2:30 PM,3,4,8,3,1,19,2022-04-20T19:29:52.527Z
2022-04-20,3:30 PM,5,2,2,9,3,21,2022-04-20T20:53:39.022Z
2022-04-20,4:30 PM,5,0,5,4,1,15,2022-04-20T21:33:01.709Z
2022-04-20,5:30 PM,5,0,1,1,2,9,2022-04-20T22:53:59.300Z
2022-04-20,6:30 PM,2,0,1,0,1,4,2022-04-20T23:34:45.001Z
2022-04-20,7:30 PM,2,0,2,0,2,6,2022-04-21T00:32:26.235Z
2022-04-21,8:30 AM,2,2,0,0,0,4,2022-04-21T13:31:16.110Z
2022-04-21,9:30 AM,3,2,2,1,0,8,2022-04-21T14:31:45.387Z
2022-04-21,10:30 AM,4,5,7,2,0,18,2022-04-21T15:35:20.002Z
2022-04-21,11:30 AM,7,1,7,0,0,15,2022-04-21T16:28:28.029Z
2022-04-21,12:30 PM,8,2,7,0,5,22,2022-04-21T17:29:32.297Z
2022-04-21,1:30 PM,11,3,9,0,2,25,2022-04-21T18:30:57.398Z
2022-04-21,2:30 PM,6,1,5,1,2,15,2022-04-21T19:29:57.781Z
2022-04-21,3:30 PM,3,1,8,0,0,12,2022-04-21T20:34:18.367Z
2022-04-21,4:30 PM,6,1,3,0,0,10,2022-04-21T22:29:43.844Z
2022-04-21,5:30 PM,7,3,3,2,0,15,2022-04-21T22:33:41.165Z
2022-04-21,6:30 PM,3,1,1,0,0,5,2022-04-21T23:31:52.821Z
2022-04-22,8:30 AM,1,3,0,0,0,4,2022-04-22T13:31:57.644Z
2022-04-22,9:30 AM,3,2,2,0,0,7,2022-04-22T14:31:29.391Z
2022-04-22,10:30 AM,4,2,1,3,0,10,2022-04-22T15:47:24.434Z
2022-04-22,11:30 AM,7,1,1,4,0,13,2022-04-22T16:30:34.475Z
2022-04-22,12:30 PM,6,0,4,3,2,15,2022-04-22T17:30:34.493Z
2022-04-22,1:30 PM,6,0,5,0,0,11,2022-04-22T18:29:41.385Z
2022-04-22,2:30 PM,4,4,2,0,0,10,2022-04-22T19:31:10.830Z
2022-04-22,5:30 PM,2,1,2,1,2,8,2022-04-22T22:36:09.887Z
2022-04-22,6:30 PM,2,1,2,2,0,7,2022-04-22T23:47:33.255Z
2022-04-22,7:30 PM,0,0,4,1,0,5,2022-04-23T00:33:37.251Z
2022-04-23,9:30 AM,1,0,0,0,0,1,2022-04-23T18:33:35.896Z
2022-04-23,10:30 AM,2,0,1,0,0,3,2022-04-23T18:33:53.008Z
2022-04-23,11:30 AM,3,0,2,2,1,8,2022-04-23T18:34:10.745Z
2022-04-23,12:30 PM,3,0,2,0,0,5,2022-04-23T18:34:28.208Z
2022-04-23,1:30 PM,0,0,1,0,1,2,2022-04-23T18:34:46.327Z
2022-04-25,8:30 AM,1,1,2,1,0,5,2022-04-25T13:33:38.352Z
2022-04-25,9:30 AM,3,1,3,1,0,8,2022-04-25T14:31:58.533Z
2022-04-25,10:30 AM,4,3,9,3,0,19,2022-04-25T15:31:20.694Z
2022-04-25,11:30 AM,7,3,6,5,1,22,2022-04-25T16:29:48.109Z
2022-04-25,12:30 PM,7,7,3,6,2,25,2022-04-25T17:29:26.191Z
2022-04-25,1:30 PM,7,3,9,5,2,26,2022-04-25T18:29:51.401Z
2022-04-25,2:30 PM,3,3,12,5,0,23,2022-04-25T19:26:45.705Z
2022-04-25,4:30 PM,7,2,6,4,0,19,2022-04-25T21:35:17.489Z
2022-04-25,5:30 PM,7,2,6,1,6,22,2022-04-25T22:36:46.263Z
2022-04-25,6:30 PM,7,3,5,2,5,22,2022-04-25T23:38:05.973Z
2022-04-25,7:30 PM,6,3,3,1,5,18,2022-04-26T00:31:08.532Z
2022-04-26,8:30 AM,0,3,2,0,0,5,2022-04-26T13:32:27.427Z
2022-04-26,9:30 AM,2,5,4,1,0,12,2022-04-26T14:35:48.226Z
2022-04-26,10:30 AM,5,5,8,1,0,19,2022-04-26T15:32:00.371Z
2022-04-26,11:30 AM,5,0,5,3,0,13,2022-04-26T16:29:46.097Z
2022-04-26,12:30 PM,4,3,11,3,0,21,2022-04-26T17:29:03.354Z
2022-04-26,1:30 PM,4,3,10,3,0,20,2022-04-26T18:30:38.267Z
2022-04-26,2:30 PM,3,1,7,2,0,13,2022-04-26T19:31:01.443Z
2022-04-26,3:30 PM,4,1,3,0,1,9,2022-04-26T21:15:14.990Z
2022-04-26,4:30 PM,2,2,1,2,0,7,2022-04-26T22:31:53.894Z
2022-04-26,5:30 PM,3,1,3,1,1,9,2022-04-26T22:32:24.277Z
2022-04-26,6:30 PM,4,0,2,0,0,6,2022-04-26T23:46:25.614Z
2022-04-26,7:30 PM,1,1,1,0,1,4,2022-04-27T00:49:36.074Z
2022-04-27,8:30 AM,1,3,1,0,0,5,2022-04-27T13:30:44.519Z
2022-04-27,9:30 AM,5,4,3,0,0,12,2022-04-27T14:30:49.132Z
2022-04-27,10:30 AM,5,4,7,0,0,16,2022-04-27T15:30:57.234Z
2022-04-27,11:30 AM,9,1,6,5,0,21,2022-04-27T16:29:57.293Z
2022-04-27,12:30 PM,7,1,9,3,0,20,2022-04-27T17:29:49.501Z
2022-04-27,1:30 PM,5,3,6,3,1,18,2022-04-27T18:30:57.769Z
2022-04-27,2:30 PM,6,3,6,2,0,17,2022-04-27T19:29:55.875Z
2022-04-27,4:30 PM,7,0,1,2,6,16,2022-04-27T21:34:08.892Z
2022-04-27,5:30 PM,4,2,1,2,0,9,2022-04-27T22:44:27.936Z
2022-04-27,7:30 PM,1,0,1,0,1,3,2022-04-28T01:02:38.176Z
2022-04-28,8:30 AM,2,2,0,0,0,4,2022-04-28T13:37:19.106Z
2022-04-28,9:30 AM,3,5,2,0,0,10,2022-04-28T14:31:31.112Z
2022-04-28,10:30 AM,3,3,3,0,0,9,2022-04-28T15:32:27.678Z
2022-04-28,11:30 AM,7,3,9,2,0,21,2022-04-28T16:29:41.201Z
2022-04-28,12:30 PM,7,4,9,0,2,22,2022-04-28T17:28:28.080Z
2022-04-28,1:30 PM,3,4,6,0,0,13,2022-04-28T18:29:18.254Z
2022-04-28,4:30 PM,3,0,3,0,0,6,2022-04-28T21:31:25.477Z
2022-04-28,5:30 PM,1,0,3,2,2,8,2022-04-28T22:46:06.549Z
2022-04-28,6:30 PM,0,0,1,2,1,4,2022-04-28T23:39:10.957Z
2022-04-28,7:30 PM,1,0,0,0,1,2,2022-04-29T00:38:24.399Z
2022-04-29,9:30 AM,0,1,1,0,0,2,2022-04-29T14:14:53.510Z
2022-04-29,10:30 AM,1,3,2,0,0,6,2022-04-29T15:53:12.596Z
2022-04-29,11:30 AM,2,1,4,0,1,8,2022-04-29T16:28:36.981Z
2022-04-29,12:30 PM,6,0,4,2,0,12,2022-04-29T17:29:45.396Z
2022-04-29,1:30 PM,5,3,4,1,0,13,2022-04-29T18:29:18.689Z
2022-04-29,2:30 PM,4,3,2,5,0,14,2022-04-29T19:31:13.146Z
2022-04-29,3:30 PM,3,1,3,0,2,9,2022-04-29T21:19:36.814Z
2022-04-29,5:30 PM,2,2,2,0,0,6,2022-04-29T22:41:54.674Z
2022-04-29,5:30 PM,2,1,2,0,0,5,2022-04-30T01:30:57.027Z
2022-04-29,6:30 PM,3,1,1,0,0,5,2022-04-30T01:31:21.482Z
2022-04-29,7:30 PM,1,1,0,0,0,2,2022-04-30T01:31:46.339Z
2022-04-29,8:30 PM,1,1,0,0,0,2,2022-04-30T01:32:01.763Z
2022-04-30,9:30 AM,0,0,1,0,0,1,2022-04-30T14:41:52.597Z
2022-04-30,10:30 AM,1,0,2,0,0,3,2022-04-30T16:44:56.464Z
2022-04-30,11:30 AM,1,0,1,0,3,5,2022-04-30T16:45:17.459Z
2022-04-30,12:30 PM,1,0,2,0,0,3,2022-04-30T18:30:47.728Z
2022-04-30,1:30 PM,0,0,3,0,1,4,2022-04-30T18:31:09.904Z
2022-05-02,9:30 AM,2,1,4,0,0,7,2022-05-02T14:33:58.313Z
2022-05-02,10:30 AM,4,3,9,2,0,18,2022-05-02T15:32:45.339Z
2022-05-02,11:30 AM,4,3,6,3,2,18,2022-05-02T16:30:07.363Z
2022-05-02,12:30 PM,8,1,8,3,1,21,2022-05-02T17:28:37.884Z
2022-05-02,1:30 PM,5,3,6,2,0,16,2022-05-02T18:30:06.376Z
2022-05-02,2:30 PM,5,0,7,3,0,15,2022-05-02T19:32:01.984Z
2022-05-02,4:30 PM,2,2,4,2,5,15,2022-05-02T21:34:33.681Z
2022-05-02,3:30 PM,2,1,4,0,0,7,2022-05-02T22:17:52.673Z
2022-05-02,5:30 PM,4,0,2,1,3,10,2022-05-02T22:33:49.774Z
2022-05-02,6:30 PM,3,0,1,1,4,9,2022-05-02T23:41:45.857Z
2022-05-02,7:30 PM,1,0,1,2,3,7,2022-05-03T00:35:37.108Z
2022-05-03,8:30 AM,0,1,1,0,0,2,2022-05-03T13:34:57.097Z
2022-05-03,9:30 AM,3,3,3,2,0,11,2022-05-03T14:32:33.433Z
2022-05-03,10:30 AM,5,4,5,1,0,15,2022-05-03T15:30:54.307Z
2022-05-03,11:30 AM,4,1,3,3,0,11,2022-05-03T16:29:34.827Z
2022-05-03,12:30 PM,9,2,8,3,2,24,2022-05-03T17:29:21.831Z
2022-05-03,1:30 PM,6,1,7,2,0,16,2022-05-03T18:31:23.851Z
2022-05-03,2:30 PM,5,3,6,0,2,16,2022-05-03T19:33:59.807Z
2022-05-03,3:30 PM,4,2,4,1,0,11,2022-05-03T22:12:45.895Z
2022-05-03,4:30 PM,5,2,2,1,0,10,2022-05-03T22:13:23.782Z
2022-05-03,5:30 PM,5,2,3,2,1,13,2022-05-03T22:34:48.380Z
2022-05-03,7:30 PM,6,0,4,1,3,14,2022-05-04T00:32:43.879Z
2022-05-04,8:30 AM,2,0,0,0,0,2,2022-05-04T13:34:31.609Z
2022-05-04,9:30 AM,3,0,2,0,0,5,2022-05-04T14:38:22.180Z
2022-05-04,10:30 AM,6,4,5,2,0,17,2022-05-04T15:32:54.717Z
2022-05-04,11:30 AM,7,2,5,2,2,18,2022-05-04T16:30:19.509Z
2022-05-04,12:30 PM,7,2,5,4,0,18,2022-05-04T17:28:23.884Z
2022-05-04,1:30 PM,5,0,7,3,0,15,2022-05-04T18:29:45.463Z
2022-05-04,2:30 PM,4,4,5,0,2,15,2022-05-04T19:30:28.355Z
2022-05-04,4:30 PM,7,5,3,4,7,26,2022-05-04T21:33:05.242Z
2022-05-04,5:30 PM,8,1,3,2,1,15,2022-05-04T22:37:47.346Z
2022-05-04,6:30 PM,3,0,2,1,1,7,2022-05-04T23:39:58.110Z
2022-05-04,7:30 PM,4,0,0,0,2,6,2022-05-05T00:41:56.206Z
2022-05-04,8:30 PM,1,0,0,0,0,1,2022-05-05T01:42:41.181Z
2022-05-05,8:30 AM,1,2,0,0,0,3,2022-05-05T13:30:09.342Z
2022-05-05,9:30 AM,4,4,3,1,0,12,2022-05-05T14:30:10.133Z
2022-05-05,10:30 AM,5,5,7,1,0,18,2022-05-05T15:33:38.158Z
2022-05-05,11:30 AM,7,4,3,5,0,19,2022-05-05T16:29:24.462Z
2022-05-05,5:30 PM,6,3,5,1,2,17,2022-05-05T22:44:01.079Z
2022-05-05,6:30 PM,3,4,2,1,2,12,2022-05-05T23:32:22.046Z
2022-05-05,7:30 PM,4,1,5,0,2,12,2022-05-06T00:50:59.069Z
2022-05-06,8:30 AM,0,4,0,0,0,4,2022-05-06T13:32:26.291Z
2022-05-06,9:30 AM,4,3,0,0,0,7,2022-05-06T14:31:18.533Z
2022-05-06,10:30 AM,4,2,1,0,0,7,2022-05-06T15:59:53.381Z
2022-05-06,5:30 PM,6,0,2,1,0,9,2022-05-06T22:06:35.589Z
2022-05-06,6:30 PM,3,1,6,1,1,12,2022-05-06T23:34:29.740Z
2022-05-06,7:30 PM,3,0,2,1,0,6,2022-05-07T00:36:06.507Z
2022-05-09,8:30 AM,2,2,0,1,0,5,2022-05-09T13:33:07.575Z
2022-05-09,9:30 AM,3,4,2,1,0,10,2022-05-09T14:32:34.677Z
2022-05-09,10:30 AM,3,4,3,2,0,12,2022-05-09T15:30:30.374Z
2022-05-09,11:30 AM,5,1,8,6,1,21,2022-05-09T16:32:22.322Z
2022-05-09,12:30 PM,6,0,11,8,0,25,2022-05-09T17:31:16.005Z
2022-05-09,1:30 PM,7,1,12,6,1,27,2022-05-09T18:30:42.103Z
2022-05-09,2:30 PM,5,1,6,3,2,17,2022-05-09T19:30:34.425Z
2022-05-09,4:30 PM,8,1,7,0,3,19,2022-05-09T21:37:26.446Z
2022-05-09,5:30 PM,5,2,6,2,0,15,2022-05-09T22:33:41.510Z
2022-05-09,6:30 PM,6,1,2,1,1,11,2022-05-09T23:35:27.617Z
2022-05-09,7:30 PM,3,0,5,0,1,9,2022-05-10T00:39:19.401Z
2022-05-10,8:30 AM,2,2,0,1,0,5,2022-05-10T13:37:39.792Z
2022-05-10,9:30 AM,4,3,1,1,0,9,2022-05-10T14:46:25.508Z
2022-05-10,10:30 AM,3,3,5,3,0,14,2022-05-10T15:31:42.302Z
2022-05-10,11:30 AM,7,0,8,4,3,22,2022-05-10T16:29:24.528Z
2022-05-10,12:30 PM,8,8,0,2,2,20,2022-05-10T17:30:32.045Z
2022-05-10,1:30 PM,8,2,6,0,0,16,2022-05-10T18:30:08.689Z
2022-05-10,2:30 PM,4,1,6,2,1,14,2022-05-10T19:32:32.783Z
2022-05-10,5:30 PM,5,0,4,0,0,9,2022-05-10T22:35:30.148Z
2022-05-10,6:30 PM,3,0,3,0,5,11,2022-05-10T23:32:16.037Z
2022-05-10,7:30 PM,5,0,2,0,5,12,2022-05-11T00:37:12.318Z
2022-05-11,8:30 AM,1,1,1,0,0,3,2022-05-11T13:32:26.269Z
2022-05-11,9:30 AM,1,0,0,0,0,1,2022-05-11T14:30:17.051Z
2022-05-11,10:30 AM,3,2,4,1,0,10,2022-05-11T15:33:10.901Z
2022-05-11,11:30 AM,4,2,6,2,2,16,2022-05-11T16:29:10.449Z
2022-05-11,12:30 PM,7,3,6,1,0,17,2022-05-11T17:30:55.589Z
2022-05-11,1:30 PM,7,9,2,3,1,22,2022-05-11T18:31:53.345Z
2022-05-11,2:30 PM,7,2,6,6,0,21,2022-05-11T19:29:31.628Z
2022-05-11,4:30 PM,7,1,2,1,10,21,2022-05-11T21:37:01.055Z
2022-05-11,5:30 PM,4,1,1,1,1,8,2022-05-11T22:36:58.502Z
2022-05-11,6:30 PM,6,0,2,0,1,9,2022-05-11T23:37:59.873Z
2022-05-11,7:30 PM,0,1,3,0,0,4,2022-05-12T00:37:29.701Z
2022-05-12,8:30 AM,0,0,1,0,0,1,2022-05-12T13:42:38.237Z
2022-05-12,9:30 AM,2,0,0,0,0,2,2022-05-12T14:34:30.357Z
2022-05-12,10:30 AM,4,3,5,0,0,12,2022-05-12T15:32:39.512Z
2022-05-12,11:30 AM,3,0,4,2,1,10,2022-05-12T16:27:55.069Z
2022-05-12,12:30 PM,0,1,8,2,1,12,2022-05-12T17:29:54.518Z
2022-05-12,1:30 PM,3,0,5,1,0,9,2022-05-12T18:30:32.487Z
2022-05-12,2:30 PM,4,2,4,1,1,12,2022-05-12T19:30:31.359Z
2022-05-12,5:30 PM,3,1,1,0,0,5,2022-05-12T22:38:13.566Z
2022-05-12,6:30 PM,2,0,1,1,2,6,2022-05-12T23:34:55.378Z
2022-05-12,7:30 PM,3,0,3,1,1,8,2022-05-13T00:39:53.991Z
2022-05-13,8:30 AM,0,3,0,0,0,3,2022-05-13T13:49:14.749Z
2022-05-13,9:30 AM,2,3,0,1,0,6,2022-05-13T14:29:43.798Z
2022-05-13,10:30 AM,2,4,1,0,0,7,2022-05-13T15:30:49.439Z
2022-05-13,11:30 AM,8,0,2,1,2,13,2022-05-13T16:30:08.141Z
2022-05-13,12:30 PM,4,0,2,1,0,7,2022-05-13T17:32:46.515Z
2022-05-13,1:30 PM,5,0,1,0,2,8,2022-05-13T18:29:30.173Z
2022-05-13,2:30 PM,5,0,1,0,1,7,2022-05-13T19:29:45.187Z
2022-05-13,5:30 PM,1,0,2,1,0,4,2022-05-13T22:06:40.057Z
2022-05-13,6:30 PM,1,1,2,1,0,5,2022-05-13T23:35:30.506Z
2022-05-13,7:30 PM,1,1,1,0,0,3,2022-05-14T00:34:46.697Z
2022-05-16,8:30 AM,1,1,0,0,0,2,2022-05-16T13:31:04.959Z
2022-05-16,9:30 AM,2,1,0,0,0,3,2022-05-16T14:32:48.757Z
2022-05-16,10:30 AM,1,1,0,1,0,3,2022-05-16T15:25:47.578Z
2022-05-16,11:30 AM,1,0,0,0,2,3,2022-05-16T16:29:25.544Z
2022-05-16,12:30 PM,2,0,0,0,0,2,2022-05-16T17:30:15.609Z
2022-05-16,1:30 PM,2,0,0,0,0,2,2022-05-16T18:31:36.681Z
2022-05-16,2:30 PM,3,0,3,0,0,6,2022-05-16T19:30:50.919Z
2022-05-16,3:30 PM,4,0,2,0,0,6,2022-05-16T20:32:50.074Z
2022-05-17,8:30 AM,1,0,0,0,0,1,2022-05-17T13:31:01.755Z
2022-05-17,9:30 AM,2,0,0,0,0,2,2022-05-17T14:30:10.589Z
2022-05-17,10:30 AM,1,1,2,0,0,4,2022-05-17T15:35:10.224Z
2022-05-17,11:30 AM,5,1,3,0,0,9,2022-05-17T16:30:20.526Z
2022-05-17,12:30 PM,2,2,2,0,0,6,2022-05-17T17:30:43.012Z
2022-05-17,1:30 PM,0,1,1,0,0,2,2022-05-17T18:30:29.224Z
2022-05-17,2:30 PM,1,0,0,0,1,2,2022-05-17T19:29:50.796Z
2022-05-17,3:30 PM,0,1,0,0,0,1,2022-05-17T20:55:30.305Z
2022-05-17,4:30 PM,0,2,0,0,0,2,2022-05-17T21:32:07.328Z
2022-05-18,8:30 AM,0,0,0,0,0,0,2022-05-18T13:28:51.107Z
2022-05-18,9:30 AM,1,0,1,0,0,2,2022-05-18T14:30:08.500Z
2022-05-18,10:30 AM,0,0,0,0,0,0,2022-05-18T15:29:54.916Z
2022-05-18,11:30 AM,1,0,1,0,0,2,2022-05-18T16:29:21.289Z
2022-05-18,12:30 PM,3,0,2,0,0,5,2022-05-18T17:32:35.516Z
2022-05-18,1:30 PM,3,0,2,0,0,5,2022-05-18T18:30:33.836Z
2022-05-18,2:30 PM,1,1,1,0,1,4,2022-05-18T19:30:34.670Z
2022-05-18,3:30 PM,0,0,1,1,1,3,2022-05-18T20:48:58.759Z
2022-05-18,4:30 PM,0,0,0,0,0,0,2022-05-18T21:44:22.701Z
2022-05-19,8:30 AM,0,1,0,0,0,1,2022-05-19T13:33:24.049Z
2022-05-19,9:30 AM,1,0,1,0,0,2,2022-05-19T14:40:23.496Z
2022-05-19,10:30 AM,0,0,0,0,0,0,2022-05-19T15:34:24.419Z
2022-05-19,11:30 AM,0,1,0,0,1,2,2022-05-19T16:29:16.106Z
2022-05-19,12:30 PM,0,1,1,0,0,2,2022-05-19T17:29:31.803Z
2022-05-19,2:30 PM,1,1,3,0,0,5,2022-05-19T19:28:12.850Z
2022-05-19,2:30 PM,1,0,1,0,0,2,2022-05-19T22:48:33.163Z
2022-05-19,3:30 PM,1,0,0,0,0,1,2022-05-19T22:48:47.979Z
2022-05-19,4:30 PM,1,0,1,0,0,2,2022-05-19T22:49:13.005Z
2022-05-19,5:30 PM,1,0,2,0,0,3,2022-05-19T22:49:31.260Z
2022-05-20,8:30 AM,0,1,0,0,0,1,2022-05-20T13:33:11.559Z
2022-05-20,9:30 AM,1,1,0,0,0,2,2022-05-20T14:25:58.187Z
2022-05-20,10:30 AM,1,1,0,0,0,2,2022-05-20T15:29:04.197Z
2022-05-20,12:30 PM,2,0,1,0,1,4,2022-05-20T17:36:06.257Z
2022-05-20,1:30 PM,2,0,1,0,0,3,2022-05-20T18:29:56.893Z
2022-05-20,2:30 PM,2,1,1,0,0,4,2022-05-20T19:30:43.440Z
2022-05-20,3:30 PM,0,0,1,0,0,1,2022-05-20T20:39:11.351Z
2022-05-20,4:30 PM,1,0,0,0,0,1,2022-05-20T21:36:53.112Z
2022-05-23,8:30 AM,1,1,0,0,0,2,2022-05-23T13:33:23.932Z
2022-05-23,9:30 AM,2,1,0,0,0,3,2022-05-23T14:27:16.480Z
2022-05-23,10:30 AM,1,2,0,0,0,3,2022-05-23T15:34:39.119Z
2022-05-23,11:30 AM,0,0,1,0,1,2,2022-05-23T16:29:31.972Z
2022-05-23,12:30 PM,1,1,1,0,0,3,2022-05-23T17:30:22.826Z
2022-05-23,1:30 PM,2,0,2,0,0,4,2022-05-23T18:35:51.054Z
2022-05-23,2:30 PM,1,1,3,0,0,5,2022-05-23T19:30:28.009Z
2022-05-24,8:30 AM,3,0,0,0,0,3,2022-05-24T13:33:41.887Z
2022-05-24,9:30 AM,0,0,0,0,0,0,2022-05-24T14:30:33.243Z
2022-05-24,10:30 AM,0,2,1,0,0,3,2022-05-24T15:30:55.175Z
2022-05-24,11:30 AM,2,0,1,0,0,3,2022-05-24T16:31:21.702Z
2022-05-24,12:30 PM,2,0,1,0,1,4,2022-05-24T17:30:55.804Z
2022-05-24,1:30 PM,3,0,1,0,0,4,2022-05-24T18:34:33.942Z
2022-05-24,2:30 PM,1,0,0,0,0,1,2022-05-24T19:29:04.014Z
2022-05-24,3:30 PM,1,0,0,0,1,2,2022-05-24T22:33:27.573Z
2022-05-24,4:30 PM,1,0,0,0,0,1,2022-05-24T22:33:45.356Z
2022-05-24,5:30 PM,0,0,0,0,0,0,2022-05-24T22:34:02.829Z
2022-05-25,8:30 AM,1,1,0,0,0,2,2022-05-25T13:39:25.536Z
2022-05-25,9:30 AM,1,1,0,0,0,2,2022-05-25T14:29:44.714Z
2022-05-25,10:30 AM,1,0,0,0,0,1,2022-05-25T15:30:14.164Z
2022-05-25,11:30 AM,0,0,0,1,0,1,2022-05-25T16:30:48.928Z
2022-05-25,12:30 PM,0,0,0,0,1,1,2022-05-25T17:35:28.542Z
2022-05-25,1:30 PM,1,0,0,0,0,1,2022-05-25T18:29:56.254Z
2022-05-25,2:30 PM,3,0,0,0,2,5,2022-05-25T19:35:59.718Z
2022-05-26,8:30 AM,0,0,0,0,0,0,2022-05-26T13:47:20.562Z
2022-05-26,9:30 AM,1,1,0,0,0,2,2022-05-26T14:32:32.579Z
2022-05-26,10:30 AM,1,0,0,0,0,1,2022-05-26T15:31:15.101Z
2022-05-26,11:30 AM,2,0,0,0,0,2,2022-05-26T16:33:34.271Z
2022-05-26,11:30 AM,3,0,0,0,0,3,2022-05-26T16:34:54.843Z
2022-05-26,12:30 PM,2,1,0,0,0,3,2022-05-26T17:29:40.516Z
2022-05-26,1:30 PM,0,0,0,0,0,0,2022-05-26T18:30:23.430Z
2022-05-26,2:30 PM,2,0,1,0,1,4,2022-05-26T19:31:43.522Z
2022-05-26,3:30 PM,2,1,3,0,0,6,2022-05-26T22:55:23.073Z
2022-05-26,4:30 PM,2,1,2,0,0,5,2022-05-26T22:55:44.362Z
2022-05-26,5:30 PM,1,1,0,0,0,2,2022-05-26T22:56:01.337Z
2022-05-27,8:30 AM,0,1,0,0,0,1,2022-05-27T13:32:59.105Z
2022-05-27,9:30 AM,1,1,0,0,0,2,2022-05-27T14:31:46.682Z
2022-05-27,10:30 AM,1,1,1,0,0,3,2022-05-27T15:32:23.479Z
2022-05-27,11:30 AM,1,0,1,0,1,3,2022-05-27T16:28:59.046Z
2022-05-27,12:30 PM,1,0,1,0,0,2,2022-05-27T17:29:18.378Z
2022-05-27,1:30 PM,2,0,0,3,0,5,2022-05-27T18:29:57.007Z
2022-05-27,2:30 PM,0,1,2,0,1,4,2022-05-27T19:32:19.122Z
2022-05-31,8:30 AM,0,0,0,0,0,0,2022-05-31T13:31:40.589Z
2022-05-31,9:30 AM,1,0,0,0,0,1,2022-05-31T14:28:41.736Z
2022-05-31,10:30 AM,2,1,1,0,0,4,2022-05-31T15:25:58.368Z
2022-05-31,11:30 AM,1,0,1,0,2,4,2022-05-31T16:29:29.769Z
2022-05-31,12:30 PM,2,0,1,0,3,6,2022-05-31T17:29:31.535Z
2022-05-31,1:30 PM,2,0,1,0,3,6,2022-05-31T18:31:39.131Z
2022-05-31,2:30 PM,0,0,1,0,3,4,2022-05-31T19:29:58.673Z
2022-05-31,3:30 PM,2,0,0,0,0,2,2022-05-31T21:30:45.871Z
2022-05-31,4:30 PM,2,0,1,0,0,3,2022-05-31T21:31:00.621Z
2022-06-01,8:30 AM,1,0,0,0,0,1,2022-06-01T13:31:01.964Z
2022-06-01,9:30 AM,1,0,0,0,0,1,2022-06-01T14:32:59.236Z
2022-06-01,10:30 AM,2,0,0,0,0,2,2022-06-01T15:28:29.893Z
2022-06-01,11:30 AM,2,0,0,5,0,7,2022-06-01T16:34:54.290Z
2022-06-01,12:30 PM,1,0,1,4,0,6,2022-06-01T17:32:38.271Z
2022-06-01,1:30 PM,0,0,2,0,1,3,2022-06-01T18:33:14.955Z
2022-06-01,2:30 PM,2,0,1,0,0,3,2022-06-01T19:31:06.941Z
2022-06-01,3:30 PM,2,0,1,0,1,4,2022-06-01T20:44:43.453Z
2022-06-02,8:30 AM,0,0,0,0,0,0,2022-06-02T13:31:59.825Z
2022-06-02,9:30 AM,0,0,0,0,0,0,2022-06-02T14:32:14.471Z
2022-06-02,10:30 AM,1,0,0,0,0,1,2022-06-02T15:30:20.824Z
2022-06-02,11:30 AM,0,0,3,0,1,4,2022-06-02T16:30:30.341Z
2022-06-02,12:30 PM,0,0,3,0,0,3,2022-06-02T17:29:17.990Z
2022-06-02,2:30 PM,4,1,1,0,0,6,2022-06-02T19:30:08.379Z
2022-06-02,3:30 PM,4,1,0,0,0,5,2022-06-02T20:31:51.659Z
2022-06-03,9:30 AM,1,1,1,0,0,3,2022-06-03T14:34:51.216Z
2022-06-03,8:30 AM,1,1,0,0,0,2,2022-06-03T14:35:18.079Z
2022-06-03,10:30 AM,1,1,1,0,0,3,2022-06-03T15:28:51.150Z
2022-06-03,11:30 AM,3,0,1,3,0,7,2022-06-03T16:30:06.062Z
2022-06-03,12:30 PM,2,0,0,0,0,2,2022-06-03T17:30:16.339Z
2022-06-03,1:30 PM,3,0,0,0,0,3,2022-06-03T18:30:48.542Z
2022-06-03,2:30 PM,0,0,1,0,0,1,2022-06-03T19:31:04.039Z
2022-06-03,3:30 PM,2,0,1,0,1,4,2022-06-03T20:31:36.920Z
2022-06-03,4:30 PM,2,0,1,0,1,4,2022-06-03T21:37:07.808Z
2022-06-06,8:30 AM,1,1,1,0,0,3,2022-06-06T13:31:32.682Z
2022-06-06,9:30 AM,0,1,1,1,0,3,2022-06-06T14:31:52.044Z
2022-06-06,10:30 AM,1,1,2,1,0,5,2022-06-06T15:31:17.428Z
2022-06-06,11:30 AM,8,1,3,1,1,14,2022-06-06T16:34:23.968Z
2022-06-06,12:30 PM,11,1,2,0,0,14,2022-06-06T17:29:23.932Z
2022-06-06,1:30 PM,4,0,2,0,0,6,2022-06-06T18:31:27.704Z
2022-06-06,2:30 PM,3,0,2,0,0,5,2022-06-06T19:30:16.207Z
2022-06-06,3:30 PM,4,2,3,0,1,10,2022-06-06T20:30:18.435Z
2022-06-06,4:30 PM,4,0,4,0,0,8,2022-06-06T22:14:06.709Z
2022-06-06,5:30 PM,5,0,4,0,1,10,2022-06-06T22:41:47.945Z
2022-06-06,6:30 PM,5,0,3,0,0,8,2022-06-06T23:50:47.572Z
2022-06-07,8:30 AM,1,0,1,0,0,2,2022-06-07T13:29:36.417Z
2022-06-07,9:30 AM,0,0,1,0,0,1,2022-06-07T14:31:17.175Z
2022-06-07,10:30 AM,3,1,3,0,0,7,2022-06-07T15:30:41.700Z
2022-06-07,11:30 AM,4,1,3,0,1,9,2022-06-07T16:31:48.861Z
2022-06-07,12:30 PM,1,0,4,0,1,6,2022-06-07T17:30:12.793Z
2022-06-07,1:30 PM,2,0,3,0,0,5,2022-06-07T18:29:29.050Z
2022-06-07,1:30 PM,3,0,1,0,0,4,2022-06-07T18:33:02.958Z
2022-06-07,2:30 PM,4,0,2,0,1,7,2022-06-07T19:29:44.515Z
2022-06-07,3:30 PM,5,0,3,0,1,9,2022-06-07T20:30:42.545Z
2022-06-07,4:30 PM,3,0,3,1,2,9,2022-06-07T21:37:47.916Z
2022-06-07,5:30 PM,6,0,2,1,2,11,2022-06-07T22:31:38.532Z
2022-06-07,6:30 PM,3,0,0,0,0,3,2022-06-07T23:42:09.603Z
2022-06-08,8:30 AM,2,0,1,0,0,3,2022-06-08T13:32:29.197Z
2022-06-08,9:30 AM,0,0,1,1,0,2,2022-06-08T14:32:23.746Z
2022-06-08,10:30 AM,2,0,1,0,0,3,2022-06-08T15:30:10.871Z
2022-06-08,11:30 AM,3,0,0,0,0,3,2022-06-08T16:38:02.011Z
2022-06-08,12:30 PM,2,0,1,0,2,5,2022-06-08T17:32:28.565Z
2022-06-08,1:30 PM,2,0,2,0,0,4,2022-06-08T18:30:09.988Z
2022-06-08,2:30 PM,2,0,2,0,2,6,2022-06-08T19:30:15.082Z
2022-06-08,3:30 PM,2,0,2,0,0,4,2022-06-08T20:29:27.878Z
2022-06-08,4:30 PM,0,0,1,0,0,1,2022-06-08T21:40:02.758Z
2022-06-08,6:30 PM,4,0,0,0,0,4,2022-06-08T23:38:47.676Z
2022-06-09,8:30 AM,3,0,1,0,0,4,2022-06-09T13:27:35.833Z
2022-06-09,9:30 AM,2,0,2,0,0,4,2022-06-09T14:31:37.371Z
2022-06-09,10:30 AM,2,2,2,0,0,6,2022-06-09T15:30:53.347Z
2022-06-09,12:30 PM,9,0,1,1,2,13,2022-06-09T17:29:09.077Z
2022-06-09,1:30 PM,4,0,3,0,0,7,2022-06-09T18:30:37.864Z
2022-06-09,2:30 PM,4,0,3,0,0,7,2022-06-09T19:30:29.219Z
2022-06-09,3:30 PM,4,0,2,0,0,6,2022-06-09T20:28:46.363Z
2022-06-09,5:30 PM,7,1,2,0,1,11,2022-06-09T22:33:09.900Z
2022-06-10,8:30 AM,0,2,1,0,0,3,2022-06-10T13:29:58.386Z
2022-06-10,9:30 AM,0,2,1,0,0,3,2022-06-10T14:32:21.385Z
2022-06-10,10:30 AM,0,3,2,3,0,8,2022-06-10T15:31:26.609Z
2022-06-10,11:30 AM,3,1,1,3,0,8,2022-06-10T16:34:14.624Z
2022-06-10,12:30 PM,3,0,4,0,0,7,2022-06-10T17:29:50.631Z
2022-06-10,1:30 PM,4,1,1,0,0,6,2022-06-10T18:42:54.302Z
2022-06-10,2:30 PM,3,0,2,0,1,6,2022-06-10T19:33:01.641Z
2022-06-10,3:30 PM,3,0,1,0,1,5,2022-06-10T20:37:35.756Z
2022-06-13,8:30 AM,1,1,1,0,0,3,2022-06-13T13:30:43.787Z
2022-06-13,9:30 AM,2,2,1,0,0,5,2022-06-13T14:30:13.499Z
2022-06-13,10:30 AM,4,3,2,1,0,10,2022-06-13T15:34:56.381Z
2022-06-13,11:30 AM,9,0,2,1,0,12,2022-06-13T16:34:50.775Z
2022-06-13,12:30 PM,9,1,3,0,0,13,2022-06-13T17:34:51.694Z
2022-06-13,2:30 PM,4,1,3,0,0,8,2022-06-13T19:36:21.118Z
2022-06-13,3:30 PM,2,0,3,0,1,6,2022-06-13T20:30:04.188Z
2022-06-13,4:30 PM,0,1,3,0,2,6,2022-06-13T21:31:06.169Z
2022-06-13,5:30 PM,3,1,4,0,2,10,2022-06-13T22:28:25.196Z
2022-06-13,6:30 PM,2,0,4,0,1,7,2022-06-13T23:30:36.441Z
2022-06-14,8:30 AM,1,0,0,0,0,1,2022-06-14T13:31:37.582Z
2022-06-14,9:30 AM,1,4,1,0,0,6,2022-06-14T14:36:18.293Z
2022-06-14,10:30 AM,1,3,2,3,0,9,2022-06-14T15:31:26.642Z
2022-06-14,11:30 PM,5,1,3,0,0,9,2022-06-14T17:38:24.985Z
2022-06-14,12:30 PM,3,1,5,0,0,9,2022-06-14T17:39:25.714Z
2022-06-14,2:30 PM,1,1,6,0,2,10,2022-06-14T19:33:12.409Z
2022-06-14,3:30 PM,1,0,4,1,2,8,2022-06-14T20:30:33.886Z
2022-06-14,4:30 PM,2,0,4,2,0,8,2022-06-14T21:31:18.038Z
2022-06-14,5:30 PM,3,0,0,0,0,3,2022-06-14T22:35:38.866Z
2022-06-14,6:30 PM,0,0,1,2,3,6,2022-06-14T23:45:03.802Z
2022-06-15,8:30 AM,0,0,0,0,0,0,2022-06-15T13:31:25.279Z
2022-06-15,9:30 AM,1,0,2,0,0,3,2022-06-15T14:31:32.901Z
2022-06-15,10:30 AM,1,0,1,0,0,2,2022-06-15T15:31:21.662Z
2022-06-15,11:30 AM,3,1,0,0,0,4,2022-06-15T18:46:16.196Z
2022-06-15,12:30 PM,3,1,2,0,0,6,2022-06-15T18:46:39.426Z
2022-06-15,1:30 PM,3,1,2,1,0,7,2022-06-15T18:46:54.898Z
2022-06-15,2:30 PM,2,0,2,0,2,6,2022-06-15T19:31:05.753Z
2022-06-15,3:30 PM,2,1,2,2,0,7,2022-06-15T20:29:47.863Z
2022-06-15,4:30 PM,3,0,4,3,1,11,2022-06-15T21:30:27.975Z
2022-06-15,5:30 PM,2,1,3,1,1,8,2022-06-15T22:29:12.563Z
2022-06-15,6:30 PM,3,1,1,1,0,6,2022-06-15T23:41:55.170Z
2022-06-16,8:30 AM,3,0,0,0,0,3,2022-06-16T13:30:16.182Z
2022-06-16,9:30 AM,2,0,0,0,0,2,2022-06-16T14:35:33.416Z
2022-06-16,10:30 AM,2,1,4,0,0,7,2022-06-16T15:32:01.550Z
2022-06-16,11:30 AM,4,0,3,0,0,7,2022-06-16T16:34:39.379Z
2022-06-16,2:30 PM,1,1,3,1,0,6,2022-06-16T19:32:16.164Z
2022-06-16,3:30 PM,3,0,4,3,0,10,2022-06-16T20:34:17.103Z
2022-06-16,4:30 PM,0,0,4,4,0,8,2022-06-16T21:30:48.058Z
2022-06-16,5:30 PM,5,0,1,0,0,6,2022-06-16T22:31:25.585Z
2022-06-16,6:30 PM,3,1,2,0,0,6,2022-06-16T23:51:13.127Z
2022-06-17,8:30 AM,0,1,1,0,0,2,2022-06-17T13:28:47.755Z
2022-06-17,9:30 AM,2,1,2,0,0,5,2022-06-17T14:29:35.144Z
2022-06-17,10:30 AM,1,1,2,0,0,4,2022-06-17T15:31:36.399Z
2022-06-17,11:30 AM,3,0,4,0,2,9,2022-06-17T16:30:15.264Z
2022-06-17,12:30 PM,1,0,1,0,0,2,2022-06-17T17:30:22.954Z
2022-06-21,8:30 AM,0,1,1,0,0,2,2022-06-21T13:30:14.779Z
2022-06-21,9:30 AM,4,1,1,0,0,6,2022-06-21T14:32:04.343Z
2022-06-21,10:30 AM,3,2,1,2,0,8,2022-06-21T15:29:54.004Z
2022-06-21,11:30 AM,7,1,1,0,0,9,2022-06-21T18:41:04.054Z
2022-06-21,12:30 PM,11,0,1,0,0,12,2022-06-21T18:41:26.854Z
2022-06-21,1:30 PM,4,0,1,0,1,6,2022-06-21T18:41:58.374Z
2022-06-21,2:30 PM,5,2,3,1,0,11,2022-06-21T19:30:38.052Z
2022-06-21,3:30 PM,5,1,1,1,1,9,2022-06-21T20:27:57.769Z
2022-06-21,4:30 PM,5,0,2,3,0,10,2022-06-21T21:29:36.377Z
2022-06-21,5:30 PM,4,0,1,1,1,7,2022-06-21T22:33:25.777Z
2022-06-21,6:30 PM,1,2,0,2,0,5,2022-06-21T23:44:40.800Z
2022-06-22,8:30 AM,1,0,0,0,0,1,2022-06-22T13:31:12.973Z
2022-06-22,9:30 AM,2,0,0,0,0,2,2022-06-22T14:30:59.103Z
2022-06-22,10:30 AM,3,0,1,0,0,4,2022-06-22T15:29:38.194Z
2022-06-22,11:30 AM,6,1,3,0,0,10,2022-06-22T16:33:02.595Z
2022-06-22,12:30 PM,5,0,4,0,0,9,2022-06-22T17:38:58.279Z
2022-06-22,1:30 PM,1,0,3,0,0,4,2022-06-22T18:31:17.719Z
2022-06-22,2:30 PM,3,1,1,0,2,7,2022-06-22T19:29:41.302Z
2022-06-22,3:30 PM,2,0,2,1,3,8,2022-06-22T20:30:51.600Z
2022-06-22,4:30 PM,3,1,3,0,3,10,2022-06-22T21:29:34.256Z
2022-06-22,5:30 PM,4,0,1,1,3,9,2022-06-22T22:27:52.790Z
2022-06-23,8:30 AM,0,1,0,1,0,2,2022-06-23T13:31:14.229Z
2022-06-23,9:30 AM,3,0,0,2,0,5,2022-06-23T14:30:03.634Z
2022-06-23,10:30 AM,2,1,1,2,0,6,2022-06-23T15:31:00.852Z
2022-06-23,11:30 AM,3,0,2,0,0,5,2022-06-23T17:30:56.516Z
2022-06-23,12:30 PM,6,1,4,0,1,12,2022-06-23T17:31:30.283Z
2022-06-23,1:30 PM,4,0,3,0,0,7,2022-06-23T18:59:51.531Z
2022-06-23,2:30 PM,4,1,2,0,5,12,2022-06-23T19:30:52.597Z
2022-06-23,3:30 PM,5,3,5,1,4,18,2022-06-23T20:28:54.680Z
2022-06-23,4:30 PM,3,2,1,0,0,6,2022-06-23T21:28:30.814Z
2022-06-23,5:30 PM,4,2,1,1,0,8,2022-06-23T22:28:11.339Z
2022-06-23,6:30 PM,0,0,0,1,0,1,2022-06-23T23:34:15.219Z
2022-06-24,8:30 AM,1,1,1,0,0,3,2022-06-24T13:31:07.982Z
2022-06-24,9:30 AM,1,1,3,1,0,6,2022-06-24T14:30:24.080Z
2022-06-24,10:30 AM,1,1,3,2,0,7,2022-06-24T15:30:53.071Z
2022-06-24,11:30 AM,1,0,2,1,2,6,2022-06-24T16:29:56.593Z
2022-06-24,12:30 PM,2,0,3,0,0,5,2022-06-24T17:29:07.057Z
2022-06-24,1:30 PM,3,1,1,0,0,5,2022-06-24T18:44:44.096Z
2022-06-24,2:30 PM,3,3,1,0,1,8,2022-06-24T19:40:50.508Z
2022-06-27,7:30 AM,1,0,0,0,0,1,2022-06-27T12:34:38.317Z
2022-06-27,8:30 AM,1,0,0,0,0,1,2022-06-27T13:40:06.869Z
2022-06-27,9:30 AM,4,0,0,0,0,4,2022-06-27T14:31:57.768Z
2022-06-27,10:30 AM,3,0,2,0,0,5,2022-06-27T15:33:17.658Z
2022-06-27,11:30 AM,3,1,5,1,0,10,2022-06-27T16:36:10.380Z
2022-06-27,12:30 PM,10,1,5,1,0,17,2022-06-27T17:40:25.852Z
2022-06-27,1:30 PM,4,1,2,1,0,8,2022-06-27T18:50:32.994Z
2022-06-27,2:30 PM,5,3,4,0,0,12,2022-06-27T19:30:54.352Z
2022-06-27,3:30 PM,4,3,2,0,3,12,2022-06-27T20:27:37.851Z
2022-06-27,4:30 PM,4,1,3,0,0,8,2022-06-27T21:31:08.153Z
2022-06-27,5:30 PM,3,1,3,0,1,8,2022-06-27T22:30:27.653Z
2022-06-27,6:30 PM,2,0,3,0,0,5,2022-06-27T23:40:01.492Z
2022-06-28,7:30 AM,0,0,0,0,0,0,2022-06-28T13:04:40.150Z
2022-06-28,8:30 AM,2,0,0,0,1,3,2022-06-28T13:59:24.628Z
2022-06-28,9:30 AM,1,0,1,0,0,2,2022-06-28T14:54:19.050Z
2022-06-28,10:30 AM,6,0,2,0,0,8,2022-06-28T18:31:41.328Z
2022-06-28,11:30 AM,5,1,0,0,0,6,2022-06-28T18:32:07.695Z
2022-06-28,12:30 PM,3,0,2,1,0,6,2022-06-28T18:32:44.993Z
2022-06-28,1:30 PM,3,0,3,1,0,7,2022-06-28T18:33:15.496Z
2022-06-28,2:30 PM,4,0,5,1,3,13,2022-06-28T19:25:58.262Z
2022-06-28,3:30 PM,3,0,4,3,3,13,2022-06-28T20:29:43.397Z
2022-06-28,4:30 PM,4,0,3,1,1,9,2022-06-28T21:29:50.802Z
2022-06-28,5:30 PM,5,0,2,0,2,9,2022-06-28T22:29:22.236Z
2022-06-29,7:30 AM,0,0,0,0,0,0,2022-06-29T13:57:15.937Z
2022-06-29,8:30 AM,0,0,0,0,0,0,2022-06-29T13:57:28.496Z
2022-06-29,9:30 AM,0,0,1,0,0,1,2022-06-29T14:36:27.086Z
2022-06-29,10:30 AM,2,0,1,0,0,3,2022-06-29T15:40:26.463Z
2022-06-29,11:30 AM,0,1,3,2,0,6,2022-06-29T16:32:44.157Z
2022-06-29,12:30 PM,1,1,4,2,2,10,2022-06-29T17:30:35.902Z
2022-06-29,1:30 PM,2,1,4,2,0,9,2022-06-29T18:58:05.796Z
2022-06-29,2:30 PM,1,2,2,2,3,10,2022-06-29T19:28:18.501Z
2022-06-29,3:30 PM,3,1,3,0,4,11,2022-06-29T20:34:33.654Z
2022-06-29,4:30 PM,2,0,0,0,0,2,2022-06-29T21:29:38.067Z
2022-06-29,5:30 PM,0,1,0,0,1,2,2022-06-29T22:31:32.175Z
2022-06-29,6:30 PM,2,0,0,0,0,2,2022-06-29T23:43:49.632Z
2022-06-30,7:30 AM,0,0,0,0,0,0,2022-06-30T12:54:36.597Z
2022-06-30,8:30 AM,3,0,0,0,0,3,2022-06-30T13:43:10.654Z
2022-06-30,9:30 AM,1,0,1,0,0,2,2022-06-30T14:32:46.608Z
2022-06-30,10:30 AM,4,2,3,2,0,11,2022-06-30T15:34:02.564Z
2022-06-30,11:30 AM,5,1,3,1,0,10,2022-06-30T16:56:39.684Z
2022-06-30,12:30 PM,4,1,3,1,1,10,2022-06-30T17:36:38.990Z
2022-06-30,2:30 PM,1,0,4,0,0,5,2022-06-30T19:33:17.795Z
2022-06-30,3:30 PM,2,0,4,0,2,8,2022-06-30T20:28:38.585Z
2022-06-30,4:30 PM,4,1,3,0,0,8,2022-06-30T21:29:38.798Z
2022-06-30,5:30 PM,2,0,2,0,0,4,2022-06-30T22:29:34.868Z
2022-06-30,6:30 PM,3,1,0,0,2,6,2022-06-30T23:35:40.583Z
2022-07-01,7:30 AM,1,0,0,0,0,1,2022-07-01T12:37:21.681Z
2022-07-01,8:30 AM,2,0,1,0,0,3,2022-07-01T13:34:56.640Z
2022-07-01,9:30 AM,3,0,3,0,1,7,2022-07-01T14:29:37.742Z
2022-07-01,10:30 AM,4,0,1,3,1,9,2022-07-01T15:29:17.786Z
2022-07-01,11:30 AM,2,0,1,3,1,7,2022-07-01T16:28:58.374Z
2022-07-01,12:30 PM,4,0,0,0,0,4,2022-07-01T17:29:03.726Z
2022-07-01,2:30 PM,4,1,2,1,2,10,2022-07-01T19:35:21.648Z
2022-07-01,3:30 PM,2,1,2,4,2,11,2022-07-01T20:36:28.067Z
2022-07-05,8:30 AM,0,0,0,0,0,0,2022-07-05T13:30:59.422Z
2022-07-05,9:30 AM,0,0,0,0,0,0,2022-07-05T14:30:44.332Z
2022-07-05,10:30 AM,5,3,0,0,0,8,2022-07-05T15:31:27.036Z
2022-07-05,11:30 AM,6,1,2,0,0,9,2022-07-05T16:34:35.604Z
2022-07-05,12:30 PM,6,0,3,1,0,10,2022-07-05T19:32:17.796Z
2022-07-05,1:30 PM,5,0,3,0,0,8,2022-07-05T19:33:02.756Z
2022-07-05,2:30 PM,7,0,2,0,0,9,2022-07-05T19:33:27.372Z
2022-07-05,3:30 PM,8,1,1,0,2,12,2022-07-05T20:32:20.404Z
2022-07-05,4:30 PM,7,3,1,0,0,11,2022-07-05T21:32:50.841Z
2022-07-05,5:30 PM,3,2,2,2,0,9,2022-07-05T22:45:11.739Z
2022-07-05,6:30 PM,4,0,1,1,0,6,2022-07-05T23:43:46.658Z
2022-07-06,8:30 AM,1,0,0,0,0,1,2022-07-06T13:32:38.577Z
2022-07-06,9:30 AM,1,0,0,0,0,1,2022-07-06T14:33:08.583Z
2022-07-06,10:30 AM,1,1,0,0,0,2,2022-07-06T15:31:27.184Z
2022-07-06,11:30 AM,2,1,0,0,0,3,2022-07-06T16:38:06.789Z
2022-07-06,12:30 PM,2,1,0,0,2,5,2022-07-06T17:43:17.593Z
2022-07-06,1:30 PM,2,2,0,0,0,4,2022-07-06T18:41:06.215Z
2022-07-06,2:30 PM,2,1,1,0,1,5,2022-07-06T19:32:03.033Z
2022-07-06,3:30 PM,3,1,4,0,1,9,2022-07-06T20:28:43.848Z
2022-07-06,4:30 PM,2,2,2,0,1,7,2022-07-06T21:27:21.398Z
2022-07-07,8:30 AM,0,0,0,0,0,0,2022-07-07T13:31:26.166Z
2022-07-07,9:30 AM,4,0,1,0,0,5,2022-07-07T14:35:53.130Z
2022-07-07,10:30 AM,2,0,3,0,0,5,2022-07-07T15:30:24.663Z
2022-07-07,11:30 AM,2,0,4,0,0,6,2022-07-07T16:34:49.882Z
2022-07-07,12:30 PM,5,0,6,0,3,14,2022-07-07T17:31:17.199Z
2022-07-07,1:30 PM,5,0,4,3,1,13,2022-07-07T18:30:38.533Z
2022-07-07,2:30 PM,4,4,2,3,0,13,2022-07-07T19:32:01.171Z
2022-07-07,3:30 PM,4,2,3,0,0,9,2022-07-07T20:28:29.315Z
2022-07-07,4:30 PM,5,4,2,0,2,13,2022-07-07T21:28:56.714Z
2022-07-07,5:30 PM,4,2,2,0,2,10,2022-07-07T22:29:35.423Z
2022-07-08,8:30 AM,0,1,1,0,0,2,2022-07-08T13:30:17.039Z
2022-07-08,9:30 AM,3,2,1,0,0,6,2022-07-08T14:35:53.128Z
2022-07-08,10:30 AM,0,1,1,1,0,3,2022-07-08T15:30:09.326Z
2022-07-08,11:30 AM,1,0,1,0,3,5,2022-07-08T16:29:27.684Z
2022-07-08,12:30 PM,2,0,1,0,2,5,2022-07-08T17:30:00.976Z
2022-07-08,2:30 PM,1,1,1,0,1,4,2022-07-08T19:38:57.180Z
2022-07-08,3:30 PM,1,1,0,0,2,4,2022-07-08T20:41:10.937Z
2022-07-11,8:30 AM,0,1,1,0,0,2,2022-07-11T13:31:09.382Z
2022-07-11,9:30 AM,0,2,1,0,0,3,2022-07-11T14:31:35.335Z
2022-07-11,10:30 AM,2,1,1,2,0,6,2022-07-11T15:29:59.220Z
2022-07-11,11:30 AM,5,0,1,2,1,9,2022-07-11T16:33:20.979Z
2022-07-11,12:30 PM,6,0,2,2,0,10,2022-07-11T17:31:20.710Z
2022-07-11,2:30 PM,2,3,4,2,1,12,2022-07-11T19:30:04.914Z
2022-07-11,3:30 PM,2,2,4,1,2,11,2022-07-11T20:31:03.986Z
2022-07-11,4:30 PM,1,1,0,1,2,5,2022-07-11T21:30:38.801Z
2022-07-11,5:30 PM,1,0,1,0,2,4,2022-07-11T22:30:16.568Z
2022-07-11,6:30 PM,0,0,0,0,0,0,2022-07-11T23:26:53.757Z
2022-07-12,8:30 AM,0,0,0,0,0,0,2022-07-12T13:33:07.097Z
2022-07-12,9:30 AM,0,0,1,0,0,1,2022-07-12T14:30:41.499Z
2022-07-12,10:30 AM,3,0,1,1,0,5,2022-07-12T15:30:46.860Z
2022-07-12,11:30 AM,5,1,2,2,4,14,2022-07-12T16:33:30.506Z
2022-07-12,12:30 PM,10,2,5,1,1,19,2022-07-12T17:31:43.276Z
2022-07-12,1:30 PM,0,3,7,0,1,11,2022-07-12T18:30:01.857Z
2022-07-12,2:30 PM,2,0,10,0,0,12,2022-07-12T19:29:31.452Z
2022-07-12,3:30 PM,3,2,9,0,4,18,2022-07-12T20:28:14.037Z
2022-07-12,4:30 PM,8,2,3,3,1,17,2022-07-12T21:29:30.612Z
2022-07-12,5:30 PM,4,0,2,3,2,11,2022-07-12T22:30:48.628Z
2022-07-12,6:30 PM,1,1,2,0,0,4,2022-07-12T23:38:19.816Z
2022-07-13,8:30 AM,0,0,0,0,0,0,2022-07-13T13:32:09.921Z
2022-07-13,9:30 AM,2,0,0,1,0,3,2022-07-13T14:33:27.176Z
2022-07-13,10:30 AM,4,0,2,1,0,7,2022-07-13T15:29:20.186Z
2022-07-13,11:30 AM,5,1,3,2,0,11,2022-07-13T16:33:25.819Z
2022-07-13,12:30 PM,3,1,3,1,1,9,2022-07-13T17:36:24.501Z
2022-07-13,2:30 PM,4,1,5,0,0,10,2022-07-13T19:32:31.592Z
2022-07-13,3:30 PM,4,1,3,0,3,11,2022-07-13T20:31:23.799Z
2022-07-13,4:30 PM,3,1,3,0,2,9,2022-07-13T21:29:37.180Z
2022-07-13,5:30 PM,3,1,3,0,0,7,2022-07-13T22:39:47.635Z
2022-07-13,6:30 PM,4,1,1,0,0,6,2022-07-13T23:35:51.707Z
2022-07-14,8:30 AM,0,1,0,0,0,1,2022-07-14T13:33:54.402Z
2022-07-14,9:30 AM,5,0,0,0,0,5,2022-07-14T14:31:14.846Z
2022-07-14,10:30 AM,0,0,1,0,0,1,2022-07-14T15:27:05.943Z
2022-07-14,11:30 AM,1,0,4,1,0,6,2022-07-14T16:31:24.250Z
2022-07-14,12:30 PM,4,0,3,0,0,7,2022-07-14T17:35:58.827Z
2022-07-14,1:30 PM,3,1,2,1,0,7,2022-07-14T18:59:35.701Z
2022-07-14,2:30 PM,3,1,3,0,0,7,2022-07-14T19:36:17.677Z
2022-07-14,3:30 PM,3,1,2,0,0,6,2022-07-14T20:43:37.616Z
2022-07-14,4:30 PM,3,0,0,0,0,3,2022-07-14T21:35:00.379Z
2022-07-14,5:30 PM,2,0,2,0,1,5,2022-07-14T22:29:39.396Z
2022-07-14,6:30 PM,2,0,1,0,2,5,2022-07-14T23:35:38.915Z
2022-07-15,8:30 AM,1,0,0,0,0,1,2022-07-15T13:28:20.074Z
2022-07-15,9:30 AM,0,0,2,0,0,2,2022-07-15T14:30:23.673Z
2022-07-15,10:30 AM,1,1,1,0,0,3,2022-07-15T15:31:10.665Z
2022-07-15,11:30 AM,2,1,3,1,0,7,2022-07-15T16:36:49.625Z
2022-07-15,1:30 PM,5,1,3,1,0,10,2022-07-15T18:05:43.335Z
2022-07-15,1:30 PM,2,1,1,0,0,4,2022-07-15T18:33:17.450Z
2022-07-15,2:30 PM,1,4,1,0,0,6,2022-07-15T19:47:07.972Z
2022-07-15,3:30 PM,0,4,0,0,0,4,2022-07-15T20:34:07.067Z
2022-07-18,8:30 AM,0,1,1,0,0,2,2022-07-18T13:31:30.753Z
2022-07-18,9:30 AM,0,1,1,0,0,2,2022-07-18T14:30:01.040Z
2022-07-18,10:30 AM,4,1,2,0,0,7,2022-07-18T15:31:19.826Z
2022-07-18,11:30 AM,1,0,1,1,0,3,2022-07-18T16:47:09.836Z
2022-07-18,12:30 PM,2,1,2,1,1,7,2022-07-18T18:53:37.372Z
2022-07-18,1:30 PM,2,1,3,1,0,7,2022-07-18T18:53:59.643Z
2022-07-18,3:30 PM,2,0,2,0,4,8,2022-07-18T20:35:25.935Z
2022-07-18,4:30 PM,2,0,2,0,3,7,2022-07-18T21:30:56.090Z
2022-07-18,5:30 PM,1,0,1,0,0,2,2022-07-18T22:32:26.972Z
2022-07-19,8:30 AM,0,0,0,0,0,0,2022-07-19T13:31:21.051Z
2022-07-19,9:30 AM,0,0,0,0,0,0,2022-07-19T14:31:24.077Z
2022-07-19,10:30 AM,2,1,0,0,0,3,2022-07-19T15:30:34.660Z
2022-07-19,11:30 AM,5,1,1,0,0,7,2022-07-19T16:31:36.072Z
2022-07-19,12:30 PM,6,1,2,0,1,10,2022-07-19T17:46:46.720Z
2022-07-19,1:30 PM,2,1,3,0,0,6,2022-07-19T18:31:09.504Z
2022-07-19,2:30 PM,3,0,3,0,0,6,2022-07-19T19:30:48.412Z
2022-07-19,3:30 PM,6,1,0,0,0,7,2022-07-19T20:30:29.297Z
2022-07-19,5:30 PM,3,0,0,2,0,5,2022-07-19T22:33:00.478Z
2022-07-19,6:30 PM,1,1,1,1,0,4,2022-07-19T23:38:50.766Z
2022-07-20,8:30 AM,0,0,0,0,0,0,2022-07-20T13:30:41.140Z
2022-07-20,9:30 AM,1,0,1,0,0,2,2022-07-20T14:35:44.842Z
2022-07-20,10:30 AM,0,0,1,0,0,1,2022-07-20T15:33:04.802Z
2022-07-20,11:30 AM,1,0,1,0,0,2,2022-07-20T16:33:50.964Z
2022-07-20,12:30 PM,3,1,3,0,0,7,2022-07-20T18:59:36.555Z
2022-07-20,1:30 PM,4,1,2,0,0,7,2022-07-20T19:00:00.826Z
2022-07-20,2:30 PM,6,0,1,1,0,8,2022-07-20T19:32:05.312Z
2022-07-20,3:30 PM,5,0,3,1,0,9,2022-07-20T20:33:17.089Z
2022-07-20,4:30 PM,3,1,3,1,0,8,2022-07-20T21:35:37.377Z
2022-07-20,5:30 PM,3,0,2,0,0,5,2022-07-20T22:30:30.371Z
2022-07-20,6:30 PM,3,0,2,0,2,7,2022-07-20T23:31:14.911Z
2022-07-21,8:30 AM,0,2,0,0,0,2,2022-07-21T13:31:20.192Z
2022-07-21,9:30 AM,0,1,0,0,0,1,2022-07-21T14:30:36.111Z
2022-07-21,10:30 AM,1,1,0,0,0,2,2022-07-21T15:32:29.631Z
2022-07-21,11:30 AM,2,1,3,0,1,7,2022-07-21T16:32:56.642Z
2022-07-21,12:30 PM,6,0,4,4,1,15,2022-07-21T17:38:41.652Z
2022-07-21,3:30 PM,4,1,3,0,0,8,2022-07-21T20:33:11.769Z
2022-07-21,4:30 PM,2,0,5,0,0,7,2022-07-21T21:34:05.463Z
2022-07-21,5:30 PM,2,0,5,1,0,8,2022-07-21T22:29:44.194Z
2022-07-21,6:30 PM,3,0,1,0,0,4,2022-07-21T23:35:58.562Z
2022-07-22,8:30 AM,0,1,0,1,0,2,2022-07-22T13:28:44.626Z
2022-07-22,9:30 AM,1,1,0,1,0,3,2022-07-22T14:29:06.088Z
2022-07-22,10:30 AM,2,1,0,0,0,3,2022-07-22T15:30:17.642Z
2022-07-22,11:30 AM,1,0,0,0,0,1,2022-07-22T16:31:40.066Z
2022-07-22,12:30 PM,3,0,0,0,1,4,2022-07-22T17:29:38.661Z
2022-07-22,1:30 PM,2,0,1,0,0,3,2022-07-22T18:33:20.954Z
2022-07-22,2:30 PM,4,0,2,1,1,8,2022-07-22T20:18:05.717Z
2022-07-22,3:30 PM,2,1,3,0,1,7,2022-07-22T20:33:17.307Z
2022-07-25,9:30 AM,3,1,0,0,0,4,2022-07-25T14:33:07.839Z
2022-07-25,10:30 AM,3,1,1,0,0,5,2022-07-25T16:00:17.021Z
2022-07-25,11:30 AM,2,2,3,1,1,9,2022-07-25T16:33:20.243Z
2022-07-25,12:30 PM,8,2,1,1,0,12,2022-07-25T17:39:13.783Z
2022-07-25,1:30 PM,2,2,3,1,0,8,2022-07-25T18:35:26.624Z
2022-07-25,2:30 PM,3,0,4,1,0,8,2022-07-25T19:30:35.567Z
2022-07-25,3:30 PM,4,0,0,1,0,5,2022-07-25T20:32:55.027Z
2022-07-25,4:30 PM,4,0,1,0,2,7,2022-07-25T21:29:33.321Z
2022-07-25,5:30 PM,4,0,3,0,0,7,2022-07-25T22:33:00.224Z
2022-07-25,7:30 AM,1,0,0,0,0,1,2022-07-26T12:46:22.601Z
2022-07-25,8:30 AM,1,0,0,0,0,1,2022-07-26T12:46:47.624Z
2022-07-25,9:30 AM,2,0,1,0,0,3,2022-07-26T12:47:11.538Z
2022-07-26,7:30 AM,0,0,0,0,0,0,2022-07-26T12:46:03.128Z
2022-07-26,8:30 AM,0,0,0,0,0,0,2022-07-26T13:31:02.176Z
2022-07-26,9:30 AM,0,1,1,0,0,2,2022-07-26T14:29:58.796Z
2022-07-26,11:30 AM,0,1,1,0,0,2,2022-07-26T16:02:51.168Z
2022-07-26,12:30 PM,2,1,3,0,0,6,2022-07-26T17:31:08.573Z
2022-07-26,1:30 PM,2,1,3,0,0,6,2022-07-26T19:00:22.080Z
2022-07-26,2:30 PM,3,0,3,1,4,11,2022-07-26T19:30:21.111Z
2022-07-26,3:30 PM,4,2,5,0,0,11,2022-07-26T20:28:47.361Z
2022-07-26,4:30 PM,0,0,3,0,0,3,2022-07-26T21:31:49.697Z
2022-07-26,5:30 PM,2,0,3,0,2,7,2022-07-26T22:29:47.378Z
2022-07-26,6:30 PM,0,1,3,0,0,4,2022-07-26T23:35:56.674Z
2022-07-27,7:30 AM,0,0,0,0,0,0,2022-07-27T12:39:29.659Z
2022-07-27,8:30 AM,2,0,0,0,0,2,2022-07-27T13:57:27.683Z
2022-07-27,9:30 AM,5,0,0,0,0,5,2022-07-27T14:31:59.412Z
2022-07-27,10:30 AM,4,1,1,0,0,6,2022-07-27T15:32:04.410Z
2022-07-27,11:30 AM,5,1,1,0,0,7,2022-07-27T16:31:13.669Z
2022-07-27,12:30 PM,2,1,3,0,1,7,2022-07-27T17:51:35.181Z
2022-07-27,1:30 PM,1,1,3,0,0,5,2022-07-27T18:53:13.274Z
2022-07-27,3:30 PM,2,0,3,0,2,7,2022-07-27T20:32:07.200Z
2022-07-27,4:30 PM,4,0,5,0,0,9,2022-07-27T21:30:16.625Z
2022-07-27,5:30 PM,3,0,3,0,0,6,2022-07-27T22:32:06.246Z
2022-07-27,6:30 PM,5,0,1,0,0,6,2022-07-27T23:38:37.614Z
2022-07-28,7:30 AM,0,0,0,0,0,0,2022-07-28T12:42:13.899Z
2022-07-28,9:30 AM,4,1,1,0,0,6,2022-07-28T14:44:53.004Z
2022-07-28,10:30 AM,4,1,1,1,0,7,2022-07-28T15:31:03.810Z
2022-07-28,11:30 AM,4,1,4,0,2,11,2022-07-28T16:33:48.891Z
2022-07-28,12:30 PM,6,1,5,0,0,12,2022-07-28T17:48:44.665Z
2022-07-28,1:30 PM,5,1,3,0,0,9,2022-07-28T18:33:40.484Z
2022-07-28,2:30 PM,3,0,3,0,0,6,2022-07-28T19:31:10.005Z
2022-07-28,3:30 PM,3,0,2,0,0,5,2022-07-28T20:27:39.991Z
2022-07-28,4:30 PM,4,0,3,0,0,7,2022-07-28T21:25:59.201Z
2022-07-28,5:30 PM,6,0,3,1,0,10,2022-07-28T22:28:40.929Z
2022-07-28,6:30 PM,4,0,2,0,0,6,2022-07-28T23:28:47.563Z
2022-07-29,7:30 AM,1,0,0,0,0,1,2022-07-29T12:34:29.808Z
2022-07-29,9:30 AM,2,1,0,0,0,3,2022-07-29T14:31:54.665Z
2022-07-29,10:30 AM,2,0,0,0,2,4,2022-07-29T15:30:55.650Z
2022-07-29,11:30 AM,2,1,3,0,2,8,2022-07-29T16:31:00.848Z
2022-07-29,12:30 PM,3,0,2,0,0,5,2022-07-29T17:31:04.200Z
2022-07-29,2:30 PM,1,5,4,1,0,11,2022-07-29T19:47:25.464Z
2022-07-29,3:30 PM,2,4,4,1,0,11,2022-07-29T20:33:02.197Z
2022-08-01,9:30 AM,3,0,0,0,1,4,2022-08-01T14:39:14.466Z
2022-08-01,10:30 AM,1,0,0,0,1,2,2022-08-01T18:17:28.059Z
2022-08-01,11:30 AM,2,0,0,1,0,3,2022-08-01T18:17:49.794Z
2022-08-01,12:30 PM,3,0,2,1,0,6,2022-08-01T18:18:21.251Z
2022-08-01,1:30 PM,2,0,2,2,0,6,2022-08-01T18:31:50.070Z
2022-08-01,2:30 PM,2,0,1,1,0,4,2022-08-01T19:31:28.212Z
2022-08-02,7:30 AM,0,0,0,0,0,0,2022-08-02T12:33:17.778Z
2022-08-02,8:30 AM,2,0,0,0,0,2,2022-08-02T13:31:40.072Z
2022-08-02,9:30 AM,2,0,1,0,0,3,2022-08-02T14:36:38.857Z
2022-08-02,10:30 AM,1,1,0,0,0,2,2022-08-02T15:32:22.628Z
2022-08-02,11:30 AM,1,1,0,0,3,5,2022-08-02T17:45:28.810Z
2022-08-02,12:30 PM,4,1,1,0,0,6,2022-08-02T17:45:55.412Z
2022-08-02,1:30 PM,6,1,1,0,0,8,2022-08-02T18:38:29.126Z
2022-08-02,3:30 PM,2,1,2,0,3,8,2022-08-02T20:32:11.645Z
2022-08-02,4:30 PM,1,2,2,0,2,7,2022-08-02T21:36:28.438Z
2022-08-03,7:30 AM,0,0,0,0,0,0,2022-08-03T16:04:54.377Z
2022-08-03,8:30 AM,0,0,1,0,0,1,2022-08-03T16:05:17.569Z
2022-08-03,9:30 AM,1,0,1,0,0,2,2022-08-03T16:05:37.905Z
2022-08-03,10:30 AM,1,0,1,0,0,2,2022-08-03T16:06:04.961Z
2022-08-03,11:30 AM,3,0,1,0,0,4,2022-08-03T16:36:02.576Z
2022-08-03,12:30 PM,2,0,2,0,0,4,2022-08-03T17:28:23.643Z
2022-08-03,1:30 PM,4,1,2,0,0,7,2022-08-03T18:37:04.076Z
2022-08-03,2:30 PM,3,0,3,0,0,6,2022-08-03T19:30:28.986Z
2022-08-03,3:30 PM,4,0,4,0,0,8,2022-08-03T20:31:29.264Z
2022-08-03,4:30 PM,3,0,2,0,0,5,2022-08-03T21:31:06.008Z
2022-08-03,5:30 PM,1,0,0,0,0,1,2022-08-03T22:28:27.124Z
2022-08-04,8:30 AM,0,0,0,0,0,0,2022-08-04T13:36:33.323Z
2022-08-04,10:30 AM,0,0,0,0,0,0,2022-08-04T15:32:06.046Z
2022-08-04,11:30 AM,0,0,0,0,2,2,2022-08-04T16:28:24.174Z
2022-08-04,12:30 PM,0,0,0,0,3,3,2022-08-04T17:29:07.112Z
2022-08-04,1:30 PM,0,0,3,0,1,4,2022-08-04T18:40:39.284Z
2022-08-04,2:30 PM,2,0,1,0,1,4,2022-08-04T19:29:31.114Z
2022-08-04,3:30 PM,1,1,1,0,0,3,2022-08-04T20:47:18.511Z
2022-08-04,4:30 PM,1,0,2,0,0,3,2022-08-04T21:34:27.461Z
2022-08-05,8:30 AM,1,0,0,0,0,1,2022-08-05T13:47:27.659Z
2022-08-05,9:30 AM,2,0,0,0,1,3,2022-08-05T14:31:39.192Z
2022-08-05,10:30 AM,2,0,0,0,0,2,2022-08-05T15:33:17.627Z
2022-08-05,11:30 AM,1,0,1,0,0,2,2022-08-05T16:30:03.171Z
2022-08-05,12:30 PM,4,0,4,0,0,8,2022-08-05T17:23:54.431Z
2022-08-05,1:30 PM,4,0,3,0,0,7,2022-08-05T18:32:32.843Z
2022-08-05,2:30 PM,3,0,3,0,0,6,2022-08-05T19:31:32.057Z
2022-08-05,3:30 PM,2,0,1,0,0,3,2022-08-05T20:32:22.546Z
2022-08-05,4:30 PM,1,0,2,0,0,3,2022-08-05T21:31:36.693Z
2022-08-08,8:30 AM,0,1,0,0,0,1,2022-08-08T13:32:30.711Z
2022-08-08,9:30 AM,1,1,0,0,0,2,2022-08-08T14:32:10.019Z
2022-08-08,10:30 AM,2,1,1,1,0,5,2022-08-08T15:30:50.288Z
2022-08-08,11:30 AM,2,0,1,0,0,3,2022-08-08T18:33:15.005Z
2022-08-08,12:30 PM,3,0,2,1,0,6,2022-08-08T18:33:48.179Z
2022-08-08,1:30 PM,4,1,1,0,0,6,2022-08-08T18:34:12.565Z
2022-08-08,3:30 PM,2,2,1,2,0,7,2022-08-08T20:34:53.875Z
2022-08-08,4:30 PM,4,1,2,0,0,7,2022-08-08T21:35:02.384Z
2022-08-09,8:30 AM,2,0,0,0,1,3,2022-08-09T13:36:08.737Z
2022-08-09,9:30 AM,1,0,0,0,0,1,2022-08-09T14:31:11.592Z
2022-08-09,11:30 AM,9,1,4,0,3,17,2022-08-09T16:34:54.062Z
2022-08-09,12:30 PM,2,0,1,0,0,3,2022-08-09T17:31:26.157Z
2022-08-09,1:30 PM,4,0,3,0,1,8,2022-08-09T18:35:33.084Z
2022-08-09,4:30 PM,2,2,2,0,0,6,2022-08-09T21:33:41.801Z
2022-08-10,7:30 AM,0,0,0,0,0,0,2022-08-10T12:35:06.960Z
2022-08-10,8:30 AM,2,0,0,0,2,4,2022-08-10T13:29:37.257Z
2022-08-10,9:30 AM,3,0,0,0,0,3,2022-08-10T14:36:56.098Z
2022-08-10,10:30 AM,1,0,0,0,0,1,2022-08-10T15:48:29.552Z
2022-08-10,11:30 AM,5,0,4,0,1,10,2022-08-10T16:34:17.551Z
2022-08-10,11:30 AM,5,0,2,0,0,7,2022-08-10T16:36:05.504Z
2022-08-10,12:30 PM,4,0,3,0,0,7,2022-08-10T17:33:21.600Z
2022-08-10,1:30 PM,3,0,2,0,0,5,2022-08-10T18:33:20.288Z
2022-08-10,3:30 PM,6,1,4,0,1,12,2022-08-10T20:27:11.195Z
2022-08-10,4:30 PM,3,3,1,0,0,7,2022-08-10T21:32:50.097Z
2022-08-11,7:30 AM,0,0,0,0,0,0,2022-08-11T12:37:39.467Z
2022-08-11,8:30 AM,0,0,0,0,0,0,2022-08-11T13:43:22.922Z
2022-08-11,9:30 AM,3,0,0,0,0,3,2022-08-11T15:03:23.191Z
2022-08-11,10:30 AM,1,0,0,0,0,1,2022-08-11T15:45:49.610Z
2022-08-11,2:30 PM,2,0,2,0,2,6,2022-08-11T19:29:58.346Z
2022-08-11,3:30 PM,0,0,2,0,0,2,2022-08-11T20:29:58.800Z
2022-08-11,4:30 PM,3,0,2,0,0,5,2022-08-11T21:46:02.836Z
2022-08-12,7:30 AM,0,0,0,0,0,0,2022-08-12T13:08:00.734Z
2022-08-12,8:30 AM,3,0,0,0,1,4,2022-08-12T13:25:14.326Z
2022-08-12,9:30 AM,3,1,0,1,1,6,2022-08-12T14:34:21.131Z
2022-08-12,10:30 AM,3,0,2,0,0,5,2022-08-12T15:30:39.492Z
2022-08-12,11:30 AM,8,0,1,0,1,10,2022-08-12T16:31:06.932Z
2022-08-12,12:30 PM,2,0,1,1,0,4,2022-08-12T17:51:15.890Z
2022-08-12,1:30 PM,3,0,2,0,0,5,2022-08-12T18:36:44.391Z
2022-08-12,2:30 PM,1,0,3,0,0,4,2022-08-12T19:41:02.515Z
2022-08-12,4:30 PM,2,0,2,0,0,4,2022-08-12T21:42:03.232Z
2022-08-15,8:30 AM,2,3,2,0,0,7,2022-08-15T13:38:41.598Z
2022-08-15,9:30 AM,5,1,13,0,4,23,2022-08-15T14:35:22.112Z
2022-08-15,10:30 AM,10,9,11,0,0,30,2022-08-15T15:31:00.980Z
2022-08-15,11:30 AM,5,2,10,1,3,21,2022-08-15T16:41:40.743Z
2022-08-15,12:30 PM,13,3,17,4,5,42,2022-08-15T17:34:29.905Z
2022-08-15,1:30 PM,6,2,13,5,3,29,2022-08-15T18:31:25.749Z
2022-08-15,7:30 PM,1,0,2,0,2,5,2022-08-16T00:29:28.309Z
2022-08-15,8:30 PM,6,1,7,0,1,15,2022-08-16T01:30:19.733Z
2022-08-16,8:30 AM,4,1,2,0,0,7,2022-08-16T13:31:25.093Z
2022-08-16,9:30 AM,6,2,1,0,0,9,2022-08-16T14:30:33.690Z
2022-08-16,10:30 AM,9,6,8,2,0,25,2022-08-16T15:36:11.370Z
2022-08-16,11:30 AM,7,0,11,4,0,22,2022-08-16T16:29:05.885Z
2022-08-16,12:30 PM,15,5,17,3,6,46,2022-08-16T17:30:09.254Z
2022-08-16,1:30 PM,5,3,10,3,5,26,2022-08-16T18:29:10.176Z
2022-08-16,2:30 PM,11,3,10,3,3,30,2022-08-16T19:29:54.584Z
2022-08-16,5:30 PM,6,4,3,1,2,16,2022-08-16T22:49:03.701Z
2022-08-16,6:30 PM,4,2,2,1,1,10,2022-08-16T23:31:21.746Z
2022-08-17,8:30 AM,3,2,4,1,0,10,2022-08-17T13:34:20.990Z
2022-08-17,9:30 AM,5,4,7,1,0,17,2022-08-17T14:30:21.777Z
2022-08-17,10:30 AM,6,5,15,1,0,27,2022-08-17T15:31:31.765Z
2022-08-17,11:30 AM,13,3,16,2,2,36,2022-08-17T16:29:50.576Z
2022-08-17,12:30 PM,10,3,16,3,2,34,2022-08-17T17:43:47.140Z
2022-08-17,1:30 PM,7,5,16,2,6,36,2022-08-17T18:30:19.259Z
2022-08-17,2:30 PM,7,2,8,2,2,21,2022-08-17T19:34:17.474Z
2022-08-17,4:30 PM,6,5,8,0,2,21,2022-08-17T21:36:49.188Z
2022-08-17,5:30 PM,8,2,4,0,1,15,2022-08-17T22:41:53.572Z
2022-08-17,6:30 PM,8,3,0,1,0,12,2022-08-17T23:32:56.602Z
2022-08-17,7:30 PM,6,2,1,0,0,9,2022-08-18T00:32:26.705Z
2022-08-18,8:30 AM,2,1,5,0,0,8,2022-08-18T13:30:13.924Z
2022-08-18,9:30 AM,6,4,4,0,0,14,2022-08-18T14:30:07.017Z
2022-08-18,10:30 AM,10,5,10,0,0,25,2022-08-18T15:31:12.341Z
2022-08-18,11:30 AM,8,3,12,1,1,25,2022-08-18T16:31:02.459Z
2022-08-18,12:30 PM,12,3,14,2,2,33,2022-08-18T17:38:17.416Z
2022-08-18,2:30 PM,6,0,8,0,2,16,2022-08-18T19:35:18.734Z
2022-08-18,5:30 PM,3,4,4,1,1,13,2022-08-18T22:34:57.327Z
2022-08-18,6:30 PM,1,3,7,1,1,13,2022-08-18T23:35:03.112Z
2022-08-19,8:30 AM,2,1,1,0,0,4,2022-08-19T13:29:58.493Z
2022-08-19,9:30 AM,2,1,1,0,0,4,2022-08-19T14:31:34.278Z
2022-08-19,10:30 AM,8,5,1,0,0,14,2022-08-19T15:36:50.321Z
2022-08-19,2:30 PM,5,2,6,3,0,16,2022-08-19T19:39:01.043Z
2022-08-19,4:30 PM,4,0,5,0,6,15,2022-08-19T21:41:13.995Z
2022-08-19,5:30 PM,5,1,2,1,4,13,2022-08-19T22:31:17.640Z
2022-08-20,10:30 AM,2,0,1,0,0,3,2022-08-20T15:33:09.597Z
2022-08-20,11:30 AM,4,0,2,0,0,6,2022-08-20T16:35:27.934Z
2022-08-20,12:30 PM,6,0,2,0,1,9,2022-08-20T17:30:18.397Z
2022-08-22,8:30 AM,2,2,6,0,0,10,2022-08-22T13:29:19.333Z
2022-08-22,9:30 AM,11,3,10,0,0,24,2022-08-22T14:31:51.345Z
2022-08-22,10:30 AM,5,4,11,2,0,22,2022-08-22T15:29:58.126Z
2022-08-22,11:30 AM,10,1,13,1,0,25,2022-08-22T16:42:34.963Z
2022-08-22,12:30 PM,14,3,21,3,3,44,2022-08-22T17:41:07.731Z
2022-08-22,1:30 PM,11,3,14,3,2,33,2022-08-22T18:32:21.399Z
2022-08-22,2:30 PM,12,2,11,3,2,30,2022-08-22T19:30:44.057Z
2022-08-22,4:30 PM,5,4,7,1,1,18,2022-08-22T21:35:34.231Z
2022-08-22,5:30 PM,9,2,8,2,1,22,2022-08-22T22:35:13.286Z
2022-08-22,6:30 PM,6,1,3,1,0,11,2022-08-22T23:32:56.658Z
2022-08-22,7:30 PM,6,1,3,1,0,11,2022-08-23T00:39:30.558Z
2022-08-23,8:30 AM,2,2,2,2,0,8,2022-08-23T13:30:02.768Z
2022-08-23,9:30 AM,6,4,6,0,0,16,2022-08-23T14:31:12.629Z
2022-08-23,10:30 AM,8,5,10,2,0,25,2022-08-23T15:30:23.049Z
2022-08-23,11:30 AM,9,0,10,1,2,22,2022-08-23T16:29:50.032Z
2022-08-23,12:30 PM,8,2,8,2,4,24,2022-08-23T17:32:34.953Z
2022-08-23,1:30 PM,12,3,9,0,3,27,2022-08-23T18:28:12.132Z
2022-08-23,2:30 PM,10,0,13,2,2,27,2022-08-23T19:35:39.287Z
2022-08-23,3:30 PM,14,4,10,0,4,32,2022-08-23T20:35:29.203Z
2022-08-23,4:30 PM,14,4,12,2,3,35,2022-08-23T21:35:45.955Z
2022-08-23,5:30 PM,7,1,9,3,0,20,2022-08-23T22:36:24.536Z
2022-08-23,6:30 PM,7,0,7,0,0,14,2022-08-23T23:32:22.474Z
2022-08-23,7:30 PM,6,0,5,6,0,17,2022-08-24T00:35:16.629Z
2022-08-24,8:30 AM,1,1,1,0,0,3,2022-08-24T13:30:11.830Z
2022-08-24,9:30 AM,3,5,3,0,0,11,2022-08-24T14:30:07.812Z
2022-08-24,10:30 AM,8,5,7,2,0,22,2022-08-24T15:33:15.859Z
2022-08-24,11:30 AM,11,2,19,3,0,35,2022-08-24T16:33:39.073Z
2022-08-24,12:30 PM,16,5,17,3,5,46,2022-08-24T17:29:54.754Z
2022-08-24,1:30 PM,11,4,9,1,5,30,2022-08-24T18:29:51.722Z
2022-08-24,2:30 PM,10,3,10,9,0,32,2022-08-24T19:32:10.660Z
2022-08-24,4:30 PM,6,7,11,3,8,35,2022-08-24T21:34:27.001Z
2022-08-24,5:30 PM,3,4,7,4,4,22,2022-08-24T22:33:18.806Z
2022-08-24,6:30 PM,5,3,2,1,5,16,2022-08-24T23:37:49.392Z
2022-08-24,7:30 PM,3,1,1,1,1,7,2022-08-25T00:39:00.089Z
2022-08-25,8:30 AM,4,0,2,0,0,6,2022-08-25T13:34:34.037Z
2022-08-25,9:30 AM,6,1,6,0,0,13,2022-08-25T14:32:38.741Z
2022-08-25,10:30 AM,9,3,8,2,0,22,2022-08-25T15:49:45.953Z
2022-08-25,11:30 AM,10,4,15,3,1,33,2022-08-25T16:29:45.790Z
2022-08-25,12:30 PM,19,4,19,3,2,47,2022-08-25T17:29:54.453Z
2022-08-25,1:30 PM,8,2,12,2,0,24,2022-08-25T18:29:46.921Z
2022-08-25,2:30 PM,5,2,10,1,1,19,2022-08-25T19:29:41.907Z
2022-08-25,3:30 PM,7,1,15,3,0,26,2022-08-25T20:35:00.887Z
2022-08-25,4:30 PM,10,1,7,4,2,24,2022-08-25T21:31:26.120Z
2022-08-25,5:30 PM,5,2,8,4,8,27,2022-08-25T22:32:00.250Z
2022-08-25,6:30 PM,4,1,3,4,3,15,2022-08-25T23:35:17.455Z
2022-08-26,8:30 AM,1,2,1,0,0,4,2022-08-26T13:33:49.271Z
2022-08-26,9:30 AM,1,2,0,0,0,3,2022-08-26T14:31:11.143Z
2022-08-26,10:30 AM,1,2,1,0,0,4,2022-08-26T15:31:03.361Z
2022-08-26,2:30 PM,6,2,4,1,0,13,2022-08-26T19:33:04.745Z
2022-08-26,3:30 PM,5,2,4,2,0,13,2022-08-26T20:37:35.157Z
2022-08-26,4:30 PM,7,1,3,3,4,18,2022-08-26T21:41:03.911Z
2022-08-26,5:30 PM,1,0,3,3,4,11,2022-08-26T22:49:20.545Z
2022-08-27,10:30 AM,1,0,5,0,0,6,2022-08-27T15:31:19.724Z
2022-08-27,11:30 AM,2,0,4,0,0,6,2022-08-27T16:32:33.804Z
2022-08-27,12:30 PM,3,2,5,0,0,10,2022-08-27T17:29:39.807Z
2022-08-27,2:30 PM,4,1,3,0,0,8,2022-08-27T19:29:22.255Z
2022-08-27,4:30 PM,2,0,2,0,0,4,2022-08-27T21:29:24.179Z
2022-08-29,8:30 AM,0,2,4,0,0,6,2022-08-29T13:31:52.353Z
2022-08-29,9:30 AM,11,3,10,1,0,25,2022-08-29T14:29:30.335Z
2022-08-29,10:30 AM,7,4,11,2,0,24,2022-08-29T15:32:31.583Z
2022-08-29,11:30 AM,15,3,18,2,2,40,2022-08-29T16:35:14.593Z
2022-08-29,12:30 PM,13,3,17,2,4,39,2022-08-29T17:30:09.229Z
2022-08-29,1:30 PM,8,5,15,3,2,33,2022-08-29T18:28:47.278Z
2022-08-29,2:30 PM,7,3,5,2,3,20,2022-08-29T19:30:35.340Z
2022-08-29,4:30 PM,7,3,8,3,6,27,2022-08-29T21:37:08.151Z
2022-08-29,5:30 PM,9,2,5,2,8,26,2022-08-29T23:34:28.974Z
2022-08-29,6:30 PM,4,1,4,1,3,13,2022-08-29T23:38:48.221Z
2022-08-30,8:30 AM,5,2,1,1,1,10,2022-08-30T13:31:57.308Z
2022-08-30,9:30 AM,8,3,14,1,0,26,2022-08-30T14:49:48.819Z
2022-08-30,10:30 AM,8,4,10,0,0,22,2022-08-30T15:31:23.530Z
2022-08-30,11:30 AM,5,3,11,1,0,20,2022-08-30T16:33:01.509Z
2022-08-30,12:30 PM,15,2,12,1,5,35,2022-08-30T17:40:44.866Z
2022-08-30,1:30 PM,10,3,15,2,2,32,2022-08-30T18:32:58.114Z
2022-08-30,2:30 PM,9,2,7,0,2,20,2022-08-30T19:29:40.647Z
2022-08-30,3:30 PM,7,2,10,1,1,21,2022-08-30T20:29:20.002Z
2022-08-30,4:30 PM,7,4,6,3,2,22,2022-08-30T21:32:09.507Z
2022-08-30,5:30 PM,6,2,9,0,4,21,2022-08-30T22:46:09.584Z
2022-08-30,6:30 PM,4,1,4,1,0,10,2022-08-30T23:32:03.259Z
2022-08-30,7:30 PM,4,1,3,1,0,9,2022-08-31T00:32:00.476Z
2022-08-31,8:30 AM,1,1,3,0,0,5,2022-08-31T13:29:53.403Z
2022-08-31,9:30 AM,5,3,8,2,0,18,2022-08-31T14:31:33.553Z
2022-08-31,10:30 AM,9,3,14,2,0,28,2022-08-31T15:30:05.007Z
2022-08-31,11:30 AM,10,5,10,5,3,33,2022-08-31T16:30:42.924Z
2022-08-31,12:30 PM,15,2,22,2,3,44,2022-08-31T17:34:00.943Z
2022-08-31,1:30 PM,6,3,14,2,0,25,2022-08-31T18:30:08.346Z
2022-08-31,1:30 PM,9,3,11,0,0,23,2022-08-31T18:37:05.783Z
2022-08-31,2:30 PM,10,3,9,1,0,23,2022-08-31T19:31:01.839Z
2022-08-31,5:30 PM,7,4,7,2,6,26,2022-08-31T22:38:00.479Z
2022-08-31,6:30 PM,2,2,3,0,4,11,2022-08-31T23:32:04.306Z
2022-08-31,7:30 PM,5,0,2,0,2,9,2022-09-01T00:34:51.140Z
2022-09-01,8:30 AM,2,0,2,0,0,4,2022-09-01T13:31:22.294Z
2022-09-01,9:30 AM,10,2,3,1,0,16,2022-09-01T14:39:27.925Z
2022-09-01,10:30 AM,6,3,5,2,0,16,2022-09-01T15:29:31.786Z
2022-09-01,11:30 AM,6,1,9,1,0,17,2022-09-01T16:31:11.306Z
2022-09-01,12:30 PM,12,0,14,0,2,28,2022-09-01T17:28:37.599Z
2022-09-01,1:30 PM,3,1,10,1,1,16,2022-09-01T18:37:13.589Z
2022-09-01,2:30 PM,5,0,8,0,0,13,2022-09-01T19:30:32.768Z
2022-09-01,3:30 PM,11,3,4,1,1,20,2022-09-01T20:33:08.117Z
2022-09-01,4:30 PM,8,2,4,3,1,18,2022-09-01T21:47:10.141Z
2022-09-01,5:30 PM,6,5,5,2,4,22,2022-09-01T22:34:21.743Z
2022-09-01,6:30 PM,5,1,2,1,2,11,2022-09-01T23:37:31.748Z
2022-09-01,7:30 PM,1,3,2,2,3,11,2022-09-02T00:41:27.920Z
2022-09-02,8:30 AM,1,1,1,0,0,3,2022-09-02T13:31:51.099Z
2022-09-02,9:30 AM,1,1,2,0,0,4,2022-09-02T14:29:17.926Z
2022-09-02,10:30 AM,1,2,5,0,0,8,2022-09-02T15:29:42.045Z
2022-09-02,2:30 PM,7,1,2,1,0,11,2022-09-02T19:34:17.559Z
2022-09-02,3:30 PM,3,0,4,1,1,9,2022-09-02T20:50:51.195Z
2022-09-02,4:30 PM,2,0,2,1,2,7,2022-09-02T21:42:56.306Z
2022-09-02,5:30 PM,1,0,1,0,0,2,2022-09-02T22:31:47.206Z
2022-09-03,10:30 AM,0,0,3,0,0,3,2022-09-03T15:37:52.747Z
2022-09-03,11:30 AM,4,0,1,0,0,5,2022-09-03T16:29:14.376Z
2022-09-03,12:30 PM,3,0,1,1,3,8,2022-09-03T17:28:23.476Z
2022-09-03,1:30 PM,5,2,1,2,0,10,2022-09-03T18:27:29.933Z
2022-09-03,2:30 PM,6,1,0,2,0,9,2022-09-03T19:28:41.216Z
2022-09-03,3:30 PM,5,1,0,2,0,8,2022-09-03T20:36:55.449Z
2022-09-07,8:30 AM,1,2,6,0,0,9,2022-09-07T13:29:45.078Z
2022-09-07,9:30 AM,7,6,7,1,0,21,2022-09-07T14:31:58.374Z
2022-09-07,10:30 AM,3,13,2,1,0,19,2022-09-07T15:29:22.464Z
2022-09-07,11:30 AM,11,5,16,2,1,35,2022-09-07T16:29:22.539Z
2022-09-07,12:30 PM,12,6,10,4,0,32,2022-09-07T17:36:24.958Z
2022-09-07,1:30 PM,8,5,10,1,0,24,2022-09-07T18:30:36.816Z
2022-09-07,2:30 PM,8,3,13,2,0,26,2022-09-07T19:29:49.927Z
2022-09-07,4:30 PM,5,3,8,2,6,24,2022-09-07T21:37:45.906Z
2022-09-07,5:30 PM,8,3,12,3,8,34,2022-09-07T22:30:35.314Z
2022-09-07,6:30 PM,4,1,4,1,1,11,2022-09-07T23:49:25.953Z
2022-09-07,7:30 PM,1,0,1,1,0,3,2022-09-08T00:35:41.500Z
2022-09-08,8:30 AM,4,0,0,1,0,5,2022-09-08T13:30:42.006Z
2022-09-08,9:30 AM,11,0,6,1,0,18,2022-09-08T14:30:03.604Z
2022-09-08,10:30 AM,8,1,11,4,0,24,2022-09-08T15:29:29.011Z
2022-09-08,11:30 AM,10,3,13,2,0,28,2022-09-08T16:31:11.059Z
2022-09-08,12:30 PM,15,2,13,2,3,35,2022-09-08T17:29:34.800Z
2022-09-08,1:30 PM,10,2,11,3,0,26,2022-09-08T18:30:09.228Z
2022-09-08,2:30 PM,8,0,8,0,0,16,2022-09-08T19:25:04.842Z
2022-09-08,3:30 PM,4,1,4,1,0,10,2022-09-08T20:31:25.263Z
2022-09-08,4:30 PM,8,1,4,2,0,15,2022-09-08T21:32:20.241Z
2022-09-08,5:30 PM,6,2,4,3,3,18,2022-09-08T22:39:30.901Z
2022-09-08,7:30 PM,4,4,2,1,4,15,2022-09-09T00:31:39.647Z
2022-09-09,8:30 AM,0,1,0,0,0,1,2022-09-09T13:31:53.974Z
2022-09-09,9:30 AM,1,1,1,0,0,3,2022-09-09T14:29:37.184Z
2022-09-09,10:30 AM,2,1,1,2,0,6,2022-09-09T15:32:04.549Z
2022-09-09,3:30 PM,1,1,9,1,3,15,2022-09-09T20:33:09.679Z
2022-09-09,4:30 PM,3,1,9,0,3,16,2022-09-09T21:31:32.464Z
2022-09-09,5:30 PM,1,0,4,0,3,8,2022-09-09T22:30:30.103Z
2022-09-10,10:30 AM,3,0,3,0,0,6,2022-09-10T15:33:00.859Z
2022-09-10,11:30 AM,3,0,3,0,0,6,2022-09-10T16:33:50.168Z
2022-09-10,12:30 PM,3,0,5,0,2,10,2022-09-10T17:30:50.722Z
2022-09-10,1:30 PM,1,1,6,2,0,10,2022-09-10T18:37:17.060Z
2022-09-10,2:30 PM,1,1,4,2,0,8,2022-09-10T19:35:57.676Z
2022-09-10,3:30 PM,1,0,3,2,0,6,2022-09-10T20:31:13.431Z
2022-09-12,8:30 AM,3,3,5,0,0,11,2022-09-12T13:29:58.730Z
2022-09-12,9:30 AM,3,7,9,0,0,19,2022-09-12T14:30:14.390Z
2022-09-12,10:30 AM,4,9,10,1,0,24,2022-09-12T15:34:27.769Z
2022-09-12,11:30 AM,10,5,13,3,0,31,2022-09-12T16:32:20.331Z
2022-09-12,12:30 PM,13,5,13,3,0,34,2022-09-12T17:31:12.425Z
2022-09-12,1:30 PM,9,5,13,3,0,30,2022-09-12T18:28:39.428Z
2022-09-12,2:30 PM,11,5,11,3,3,33,2022-09-12T19:29:15.742Z
2022-09-12,4:30 PM,5,3,5,2,10,25,2022-09-12T21:33:42.246Z
2022-09-12,5:30 PM,10,1,3,2,4,20,2022-09-12T22:43:58.793Z
2022-09-12,6:30 PM,12,0,14,2,2,30,2022-09-12T23:33:45.569Z
2022-09-13,8:30 AM,0,1,1,0,0,2,2022-09-13T13:31:45.623Z
2022-09-13,9:30 AM,9,2,3,1,0,15,2022-09-13T14:32:42.116Z
2022-09-13,10:30 AM,8,3,5,2,0,18,2022-09-13T15:29:33.780Z
2022-09-13,11:30 AM,10,3,14,3,0,30,2022-09-13T16:31:38.676Z
2022-09-13,12:30 PM,14,3,14,2,0,33,2022-09-13T17:32:37.395Z
2022-09-13,1:30 PM,8,3,10,2,1,24,2022-09-13T18:30:24.678Z
2022-09-13,2:30 PM,4,2,9,2,0,17,2022-09-13T19:31:44.346Z
2022-09-13,5:30 PM,6,6,8,2,1,23,2022-09-13T22:32:48.299Z
2022-09-13,6:30 PM,7,2,5,1,0,15,2022-09-13T23:33:58.477Z
2022-09-14,8:30 AM,1,1,3,0,0,5,2022-09-14T13:31:59.164Z
2022-09-14,9:30 AM,2,6,8,3,0,19,2022-09-14T14:30:44.103Z
2022-09-14,10:30 AM,6,3,11,3,0,23,2022-09-14T15:29:26.330Z
2022-09-14,11:30 AM,6,5,14,2,0,27,2022-09-14T16:42:08.962Z
2022-09-14,12:30 PM,10,5,15,3,0,33,2022-09-14T17:34:11.851Z
2022-09-14,1:30 PM,9,3,14,3,4,33,2022-09-14T18:28:53.793Z
2022-09-14,2:30 PM,7,3,10,5,9,34,2022-09-14T19:30:18.953Z
2022-09-14,4:30 PM,4,2,6,2,3,17,2022-09-14T21:38:31.657Z
2022-09-14,5:30 PM,8,1,9,1,4,23,2022-09-14T22:43:00.988Z
2022-09-14,6:30 PM,4,1,2,1,4,12,2022-09-14T23:52:51.783Z
2022-09-14,7:30 PM,3,3,2,0,5,13,2022-09-15T00:34:20.483Z
2022-09-15,8:30 AM,4,2,0,0,0,6,2022-09-15T13:28:24.766Z
2022-09-15,9:30 AM,7,1,9,0,0,17,2022-09-15T14:33:57.753Z
2022-09-15,10:30 AM,9,5,11,2,0,27,2022-09-15T15:29:23.322Z
2022-09-15,11:30 AM,8,2,15,1,2,28,2022-09-15T16:30:33.371Z
2022-09-15,12:30 PM,10,2,15,2,0,29,2022-09-15T17:30:17.320Z
2022-09-15,1:30 PM,5,2,11,2,0,20,2022-09-15T18:35:02.344Z
2022-09-15,5:30 PM,7,2,6,4,6,25,2022-09-15T22:34:55.362Z
2022-09-15,6:30 PM,6,2,3,4,5,20,2022-09-15T23:41:45.473Z
2022-09-15,7:30 PM,2,0,3,3,3,11,2022-09-16T00:46:00.453Z
2022-09-16,7:30 AM,1,0,0,0,0,1,2022-09-16T12:32:54.357Z
2022-09-16,9:30 AM,4,0,0,1,0,5,2022-09-16T14:48:04.268Z
2022-09-16,10:30 AM,1,0,2,1,1,5,2022-09-16T15:30:30.113Z
2022-09-16,2:30 PM,6,6,4,7,1,24,2022-09-16T19:12:46.943Z
2022-09-16,4:30 PM,3,1,4,0,1,9,2022-09-16T21:45:41.361Z
2022-09-16,3:30 PM,3,2,6,0,4,15,2022-09-16T21:46:45.451Z
2022-09-16,5:30 PM,2,0,2,1,2,7,2022-09-16T22:32:43.005Z
2022-09-17,10:30 AM,3,0,2,0,0,5,2022-09-17T15:31:07.809Z
2022-09-17,12:30 PM,4,1,2,0,2,9,2022-09-17T17:32:20.860Z
2022-09-17,3:30 PM,8,1,3,0,0,12,2022-09-17T20:31:29.534Z
2022-09-17,4:30 PM,4,1,1,1,0,7,2022-09-17T21:29:54.473Z
2022-09-19,8:30 AM,4,4,1,0,0,9,2022-09-19T13:31:47.623Z
2022-09-19,9:30 AM,5,3,8,1,0,17,2022-09-19T14:29:04.064Z
2022-09-19,10:30 AM,12,4,10,1,0,27,2022-09-19T15:31:41.764Z
2022-09-19,11:30 AM,7,3,13,4,1,28,2022-09-19T16:30:38.101Z
2022-09-19,12:30 PM,10,3,18,5,0,36,2022-09-19T17:30:48.163Z
2022-09-19,1:30 PM,9,2,15,3,0,29,2022-09-19T18:44:58.102Z
2022-09-19,2:30 PM,7,2,4,6,0,19,2022-09-19T19:31:31.566Z
2022-09-19,4:30 PM,6,5,9,2,4,26,2022-09-19T21:35:09.696Z
2022-09-19,5:30 PM,7,4,13,3,4,31,2022-09-19T22:32:22.410Z
2022-09-19,6:30 PM,7,0,5,1,5,18,2022-09-19T23:39:36.805Z
2022-09-19,7:30 PM,4,0,2,1,4,11,2022-09-20T00:32:31.674Z
2022-09-19,6:30 PM,6,1,5,0,0,12,2023-09-20T23:34:41.147Z
2022-09-20,8:30 AM,2,1,1,1,0,5,2022-09-20T13:28:48.995Z
2022-09-20,9:30 AM,7,0,2,1,0,10,2022-09-20T14:24:29.541Z
2022-09-20,10:30 AM,9,4,10,2,0,25,2022-09-20T15:31:55.248Z
2022-09-20,11:30 AM,5,2,10,1,0,18,2022-09-20T16:30:32.785Z
2022-09-20,12:30 PM,10,3,15,3,0,31,2022-09-20T17:36:46.798Z
2022-09-20,1:30 PM,5,2,8,2,0,17,2022-09-20T18:28:45.106Z
2022-09-20,2:30 PM,8,2,7,3,0,20,2022-09-20T19:27:58.799Z
2022-09-20,5:30 PM,9,2,5,0,1,17,2022-09-20T22:35:04.230Z
2022-09-20,6:30 PM,4,2,4,1,0,11,2022-09-20T23:35:58.869Z
2022-09-20,7:30 PM,4,1,3,3,1,12,2022-09-21T00:38:24.848Z
2022-09-21,8:30 AM,1,2,2,0,0,5,2022-09-21T13:34:53.873Z
2022-09-21,9:30 AM,2,4,6,0,0,12,2022-09-21T14:31:01.979Z
2022-09-21,10:30 AM,7,4,10,0,0,21,2022-09-21T15:40:58.678Z
2022-09-21,11:30 AM,8,5,16,6,0,35,2022-09-21T16:31:05.055Z
2022-09-21,12:30 PM,10,5,18,3,2,38,2022-09-21T17:28:02.287Z
2022-09-21,1:30 PM,8,3,10,5,0,26,2022-09-21T18:35:38.642Z
2022-09-21,2:30 PM,7,2,7,3,2,21,2022-09-21T19:30:12.030Z
2022-09-21,4:30 PM,4,2,12,1,2,21,2022-09-21T21:40:21.744Z
2022-09-21,6:30 PM,7,2,5,0,5,19,2022-09-21T23:42:56.035Z
2022-09-21,7:30 PM,5,1,6,0,0,12,2022-09-22T00:41:40.207Z
2022-09-22,8:30 AM,2,0,1,0,0,3,2022-09-22T13:30:55.739Z
2022-09-22,9:30 AM,6,1,2,0,0,9,2022-09-22T14:31:02.442Z
2022-09-22,10:30 AM,5,1,8,0,0,14,2022-09-22T15:30:07.581Z
2022-09-22,11:30 AM,4,2,10,2,1,19,2022-09-22T16:35:20.216Z
2022-09-22,12:30 PM,10,2,15,2,1,30,2022-09-22T17:34:38.248Z
2022-09-22,1:30 PM,3,3,8,1,1,16,2022-09-22T18:31:35.002Z
2022-09-22,2:30 PM,5,2,14,2,3,26,2022-09-22T19:28:15.733Z
2022-09-22,5:30 PM,5,0,5,2,15,27,2022-09-22T22:37:09.163Z
2022-09-22,6:30 PM,2,1,6,1,4,14,2022-09-22T23:39:18.471Z
2022-09-22,7:30 PM,4,0,4,0,5,13,2022-09-23T00:36:14.941Z
2022-09-23,8:30 AM,0,1,1,0,0,2,2022-09-23T13:30:20.127Z
2022-09-23,9:30 AM,0,1,5,0,0,6,2022-09-23T14:34:19.291Z
2022-09-23,10:30 AM,4,3,5,0,0,12,2022-09-23T15:53:09.951Z
2022-09-23,2:00 PM,6,0,4,1,0,11,2022-09-23T18:59:58.566Z
2022-09-23,3:30 PM,5,0,3,4,4,16,2022-09-23T20:33:03.133Z
2022-09-23,4:30 PM,4,0,3,4,8,19,2022-09-23T21:38:18.579Z
2022-09-23,5:30 PM,2,1,2,1,2,8,2022-09-23T22:32:14.881Z
2022-09-24,10:30 AM,1,0,1,0,2,4,2022-09-24T15:26:06.180Z
2022-09-24,11:30 AM,1,0,2,0,0,3,2022-09-24T16:28:13.525Z
2022-09-24,12:30 PM,2,0,2,0,0,4,2022-09-24T17:34:22.669Z
2022-09-24,3:30 PM,4,0,2,0,0,6,2022-09-24T20:48:47.852Z
2022-09-26,8:30 AM,3,5,3,1,0,12,2022-09-26T13:30:20.344Z
2022-09-26,9:30 AM,4,7,7,1,0,19,2022-09-26T14:31:02.870Z
2022-09-26,10:30 AM,8,3,8,2,0,21,2022-09-26T15:32:01.724Z
2022-09-26,11:30 AM,8,3,14,3,2,30,2022-09-26T16:30:37.827Z
2022-09-26,12:30 PM,8,3,14,2,0,27,2022-09-26T17:32:38.896Z
2022-09-26,1:30 PM,8,2,14,2,0,26,2022-09-26T18:36:08.643Z
2022-09-26,2:30 PM,6,2,10,2,0,20,2022-09-26T19:32:30.978Z
2022-09-26,3:30 PM,10,6,11,1,3,31,2022-09-26T20:35:03.441Z
2022-09-26,4:30 PM,8,3,6,3,0,20,2022-09-26T21:32:37.454Z
2022-09-27,8:30 AM,3,0,1,0,0,4,2022-09-27T13:30:05.668Z
2022-09-27,9:30 AM,5,3,4,0,0,12,2022-09-27T14:31:20.435Z
2022-09-27,10:30 AM,4,2,6,0,0,12,2022-09-27T15:32:50.057Z
2022-09-27,11:30 AM,12,3,8,0,0,23,2022-09-27T16:49:45.786Z
2022-09-27,12:30 PM,20,6,20,2,4,52,2022-09-27T17:31:50.295Z
2022-09-27,2:30 PM,2,2,10,2,0,16,2022-09-27T19:32:15.867Z
2022-09-27,5:30 PM,2,6,6,0,2,16,2022-09-27T22:36:57.745Z
2022-09-27,6:30 PM,5,5,4,0,2,16,2022-09-27T23:33:55.361Z
2022-09-28,8:30 AM,3,1,3,2,0,9,2022-09-28T13:30:34.539Z
2022-09-28,9:30 AM,5,2,10,1,0,18,2022-09-28T14:29:25.858Z
2022-09-28,10:30 AM,10,3,11,1,0,25,2022-09-28T15:33:54.709Z
2022-09-28,11:30 AM,6,3,20,3,2,34,2022-09-28T16:39:27.117Z
2022-09-28,12:30 PM,22,3,15,4,2,46,2022-09-28T17:31:48.544Z
2022-09-28,1:30 PM,4,3,19,0,2,28,2022-09-28T18:31:37.427Z
2022-09-28,5:30 PM,4,3,7,2,5,21,2022-09-28T22:41:00.091Z
2022-09-28,6:30 PM,2,0,5,0,9,16,2022-09-28T23:38:12.763Z
2022-09-28,7:30 PM,2,1,4,0,4,11,2022-09-29T00:39:10.691Z
2022-09-29,8:30 AM,3,0,0,0,0,3,2022-09-29T13:30:52.576Z
2022-09-29,9:30 AM,5,1,4,0,0,10,2022-09-29T14:29:51.101Z
2022-09-29,10:30 AM,12,3,8,1,0,24,2022-09-29T15:33:15.076Z
2022-09-29,11:30 AM,8,0,13,2,2,25,2022-09-29T16:29:40.033Z
2022-09-29,12:30 PM,10,18,3,2,0,33,2022-09-29T17:29:04.595Z
2022-09-29,1:30 PM,5,2,10,2,0,19,2022-09-29T18:28:43.675Z
2022-09-29,2:30 PM,5,3,7,2,0,17,2022-09-29T19:30:04.717Z
2022-09-29,5:30 PM,3,1,4,0,6,14,2022-09-29T22:38:51.489Z
2022-09-29,6:30 PM,2,1,4,0,5,12,2022-09-29T23:29:43.677Z
2022-09-29,7:30 PM,4,0,2,0,6,12,2022-09-30T00:36:45.449Z
2022-09-30,8:30 AM,0,1,0,0,0,1,2022-09-30T13:32:10.059Z
2022-09-30,9:30 AM,2,2,0,1,0,5,2022-09-30T14:30:10.754Z
2022-09-30,10:30 AM,5,1,5,0,0,11,2022-09-30T15:31:00.284Z
2022-09-30,3:30 PM,9,0,2,0,1,12,2022-09-30T20:48:09.502Z
2022-09-30,4:30 PM,6,0,5,0,1,12,2022-09-30T21:46:07.671Z
2022-09-30,5:30 PM,3,1,3,0,2,9,2022-09-30T22:44:15.175Z
2022-10-01,10:30 AM,2,1,0,0,0,3,2022-10-01T15:30:11.086Z
2022-10-01,11:30 AM,2,1,1,0,0,4,2022-10-01T16:28:18.152Z
2022-10-01,12:30 PM,2,1,2,0,0,5,2022-10-01T17:29:54.451Z
2022-10-01,2:30 PM,2,2,5,1,0,10,2022-10-01T19:29:48.818Z
2022-10-01,3:30 PM,0,0,2,0,0,2,2022-10-01T20:30:36.458Z
2022-10-03,8:30 AM,0,3,1,0,0,4,2022-10-03T13:31:03.666Z
2022-10-03,9:30 AM,4,6,5,0,0,15,2022-10-03T14:31:23.811Z
2022-10-03,10:30 AM,5,3,8,0,0,16,2022-10-03T15:30:28.793Z
2022-10-03,11:30 AM,10,4,10,3,0,27,2022-10-03T16:30:13.131Z
2022-10-03,12:30 PM,9,2,15,4,5,35,2022-10-03T17:31:31.053Z
2022-10-03,1:30 PM,10,2,17,4,0,33,2022-10-03T18:30:01.346Z
2022-10-03,2:30 PM,8,2,10,2,2,24,2022-10-03T19:29:20.964Z
2022-10-03,3:30 PM,7,3,10,0,0,20,2022-10-03T20:35:27.321Z
2022-10-03,4:30 PM,6,2,11,2,3,24,2022-10-03T21:41:31.422Z
2022-10-03,5:30 PM,3,3,7,2,6,21,2022-10-03T22:38:24.128Z
2022-10-03,6:30 PM,8,3,4,5,7,27,2022-10-03T23:32:30.816Z
2022-10-03,7:30 PM,5,2,5,0,7,19,2022-10-04T00:35:56.794Z
2022-10-04,8:30 AM,2,2,3,0,0,7,2022-10-04T13:30:13.072Z
2022-10-04,9:30 AM,4,3,3,0,0,10,2022-10-04T14:30:18.183Z
2022-10-04,10:30 AM,8,5,6,2,0,21,2022-10-04T15:30:43.439Z
2022-10-04,11:30 AM,7,2,8,0,0,17,2022-10-04T16:34:11.155Z
2022-10-04,12:30 PM,10,3,8,3,0,24,2022-10-04T17:29:23.922Z
2022-10-04,1:30 PM,7,2,9,2,0,20,2022-10-04T18:29:53.507Z
2022-10-04,2:30 PM,8,2,7,2,0,19,2022-10-04T19:30:07.379Z
2022-10-04,5:30 PM,7,4,6,2,5,24,2022-10-04T22:41:22.264Z
2022-10-04,6:30 PM,0,3,4,2,2,11,2022-10-04T23:33:56.265Z
2022-10-04,7:30 PM,8,3,5,2,6,24,2022-10-05T00:35:25.268Z
2022-10-05,8:30 AM,6,1,3,0,0,10,2022-10-05T13:29:55.337Z
2022-10-05,9:30 AM,6,3,6,1,0,16,2022-10-05T14:33:05.642Z
2022-10-05,10:30 AM,4,4,13,3,0,24,2022-10-05T15:31:40.985Z
2022-10-05,11:30 AM,8,3,16,2,3,32,2022-10-05T16:32:43.688Z
2022-10-05,12:30 PM,13,3,21,4,0,41,2022-10-05T17:30:02.651Z
2022-10-05,2:30 PM,5,4,8,2,2,21,2022-10-05T19:29:24.466Z
2022-10-05,4:30 PM,8,3,1,3,6,21,2022-10-05T21:41:47.176Z
2022-10-05,5:30 PM,6,3,2,2,4,17,2022-10-05T22:31:45.904Z
2022-10-05,6:30 PM,3,3,3,3,3,15,2022-10-05T23:37:16.354Z
2022-10-05,7:30 PM,2,2,2,0,2,8,2022-10-06T00:30:29.137Z
2022-10-06,8:30 AM,4,2,1,0,0,7,2022-10-06T13:30:13.928Z
2022-10-06,9:30 AM,7,1,8,0,0,16,2022-10-06T14:36:04.715Z
2022-10-06,10:30 AM,8,4,8,2,0,22,2022-10-06T15:30:41.937Z
2022-10-06,11:30 AM,8,2,5,2,0,17,2022-10-06T16:31:50.493Z
2022-10-06,12:30 PM,7,2,10,2,0,21,2022-10-06T17:29:04.382Z
2022-10-06,1:30 PM,8,2,10,3,0,23,2022-10-06T18:28:12.165Z
2022-10-06,2:30 PM,6,2,5,2,0,15,2022-10-06T19:34:17.040Z
2022-10-06,3:30 PM,3,1,13,2,1,20,2022-10-06T20:54:33.798Z
2022-10-06,4:30 PM,2,4,9,4,5,24,2022-10-06T21:39:31.791Z
2022-10-06,5:30 PM,6,5,5,6,8,30,2022-10-06T22:36:09.245Z
2022-10-06,6:30 PM,1,1,3,6,5,16,2022-10-06T23:31:55.902Z
2022-10-07,8:30 AM,0,1,0,0,0,1,2022-10-07T13:31:00.148Z
2022-10-07,9:30 AM,3,2,0,0,0,5,2022-10-07T14:30:55.709Z
2022-10-07,10:30 AM,2,5,4,3,0,14,2022-10-07T15:30:22.139Z
2022-10-07,11:30 AM,8,2,5,3,3,21,2022-10-07T16:52:51.873Z
2022-10-07,12:30 PM,6,3,3,0,4,16,2022-10-07T17:38:08.114Z
2022-10-07,1:30 PM,3,2,3,1,2,11,2022-10-07T18:45:58.197Z
2022-10-07,2:30 PM,6,1,5,1,1,14,2022-10-07T19:28:13.940Z
2022-10-07,3:30 PM,6,0,4,1,2,13,2022-10-07T20:36:59.114Z
2022-10-07,4:30 PM,5,0,2,0,4,11,2022-10-07T22:36:19.938Z
2022-10-07,5:30 PM,4,0,1,0,2,7,2022-10-07T22:36:39.354Z
2022-10-08,11:30 AM,4,1,2,2,2,11,2022-10-08T16:29:20.993Z
2022-10-08,12:30 PM,3,0,1,2,0,6,2022-10-08T17:28:06.425Z
2022-10-08,2:30 PM,4,3,3,0,0,10,2022-10-08T19:29:58.935Z
2022-10-08,3:30 PM,5,3,2,0,0,10,2022-10-08T20:37:25.577Z
2022-10-08,4:30 PM,5,3,1,0,0,9,2022-10-08T21:23:33.996Z
2022-10-10,8:30 AM,1,3,3,1,0,8,2022-10-10T13:30:01.082Z
2022-10-10,9:30 AM,4,4,6,1,0,15,2022-10-10T14:30:54.580Z
2022-10-10,10:30 AM,2,2,10,1,0,15,2022-10-10T15:33:20.955Z
2022-10-10,11:30 AM,8,4,9,4,1,26,2022-10-10T16:31:11.008Z
2022-10-10,12:30 PM,12,5,16,5,3,41,2022-10-10T17:30:41.238Z
2022-10-10,1:30 PM,10,2,8,3,0,23,2022-10-10T18:31:05.797Z
2022-10-10,2:30 PM,9,3,8,3,5,28,2022-10-10T19:27:23.331Z
2022-10-10,4:30 PM,6,4,6,2,4,22,2022-10-10T21:42:45.106Z
2022-10-10,5:30 PM,4,3,7,2,5,21,2022-10-10T22:42:46.178Z
2022-10-10,6:30 PM,4,1,3,1,6,15,2022-10-10T23:34:03.948Z
2022-10-10,7:30 PM,3,1,2,0,5,11,2022-10-11T00:34:26.146Z
2022-10-10,7:30 PM,3,1,4,0,2,10,2022-10-11T00:39:07.126Z
2022-10-11,8:30 AM,2,1,0,1,0,4,2022-10-11T13:30:30.999Z
2022-10-11,9:30 AM,2,1,2,0,0,5,2022-10-11T14:29:55.884Z
2022-10-11,10:30 AM,3,4,7,1,0,15,2022-10-11T15:30:29.138Z
2022-10-11,11:30 AM,5,3,8,4,1,21,2022-10-11T16:29:38.321Z
2022-10-11,12:30 PM,11,4,15,3,0,33,2022-10-11T17:29:14.116Z
2022-10-11,1:30 PM,5,3,8,2,0,18,2022-10-11T18:32:41.768Z
2022-10-11,2:30 PM,7,3,8,3,0,21,2022-10-11T19:36:01.253Z
2022-10-11,3:30 PM,4,3,8,4,0,19,2022-10-11T20:40:37.134Z
2022-10-11,4:30 PM,5,2,6,1,7,21,2022-10-11T21:54:53.901Z
2022-10-11,5:30 PM,6,2,6,1,7,22,2022-10-11T22:42:45.163Z
2022-10-11,6:30 PM,2,0,2,1,5,10,2022-10-11T23:34:11.876Z
2022-10-11,7:30 PM,4,0,1,2,3,10,2022-10-12T00:53:49.630Z
2022-10-12,8:30 AM,3,3,5,0,0,11,2022-10-12T13:30:41.878Z
2022-10-12,9:30 AM,5,4,5,0,0,14,2022-10-12T14:31:14.814Z
2022-10-12,10:30 AM,3,8,6,1,0,18,2022-10-12T15:31:06.470Z
2022-10-12,11:30 AM,7,2,8,5,0,22,2022-10-12T16:31:17.545Z
2022-10-12,12:30 PM,9,2,10,6,0,27,2022-10-12T17:30:18.760Z
2022-10-12,1:30 PM,8,2,13,3,0,26,2022-10-12T18:29:52.624Z
2022-10-12,2:30 PM,10,2,5,4,0,21,2022-10-12T19:32:10.727Z
2022-10-12,4:30 PM,10,3,10,1,3,27,2022-10-12T21:33:55.791Z
2022-10-12,5:30 PM,10,4,6,2,5,27,2022-10-12T22:33:22.822Z
2022-10-12,6:30 PM,6,1,6,0,1,14,2022-10-12T23:32:24.707Z
2022-10-13,8:30 AM,1,0,2,1,0,4,2022-10-13T13:30:59.722Z
2022-10-13,9:30 AM,9,3,5,0,0,17,2022-10-13T14:33:15.708Z
2022-10-13,10:30 AM,9,4,4,0,0,17,2022-10-13T15:29:49.965Z
2022-10-13,11:30 AM,5,3,7,0,0,15,2022-10-13T16:30:14.253Z
2022-10-13,12:30 PM,11,3,10,0,0,24,2022-10-13T17:30:24.294Z
2022-10-13,1:30 PM,8,2,7,3,0,20,2022-10-13T18:42:21.914Z
2022-10-13,2:30 PM,9,2,11,2,0,24,2022-10-13T19:31:17.788Z
2022-10-13,4:30 PM,9,4,7,2,13,35,2022-10-13T21:13:11.437Z
2022-10-13,5:30 PM,9,1,5,0,10,25,2022-10-13T22:30:20.826Z
2022-10-13,6:30 PM,5,1,2,1,6,15,2022-10-13T23:37:19.281Z
2022-10-13,7:30 PM,2,1,1,0,4,8,2022-10-14T00:35:36.491Z
2022-10-14,8:30 AM,0,1,0,0,0,1,2022-10-14T13:33:51.455Z
2022-10-14,9:30 AM,2,3,2,0,0,7,2022-10-14T14:32:31.210Z
2022-10-14,10:30 AM,2,2,3,2,0,9,2022-10-14T15:30:00.244Z
2022-10-14,11:30 AM,11,3,5,0,2,21,2022-10-14T16:28:26.498Z
2022-10-14,12:30 PM,6,2,4,0,5,17,2022-10-14T17:49:21.050Z
2022-10-14,1:30 PM,3,1,4,0,5,13,2022-10-14T18:34:46.074Z
2022-10-14,2:30 PM,1,1,4,1,5,12,2022-10-14T19:31:08.699Z
2022-10-14,3:30 PM,4,1,3,1,1,10,2022-10-14T20:34:02.677Z
2022-10-14,4:30 PM,2,0,5,0,2,9,2022-10-14T21:33:17.743Z
2022-10-14,5:30 PM,1,0,2,0,2,5,2022-10-14T22:41:09.780Z
2022-10-17,8:30 AM,0,2,4,0,0,6,2022-10-17T13:27:46.121Z
2022-10-17,9:30 AM,4,3,5,0,0,12,2022-10-17T14:29:58.983Z
2022-10-17,10:30 AM,8,5,11,0,0,24,2022-10-17T15:36:06.055Z
2022-10-17,11:30 AM,7,4,13,1,1,26,2022-10-17T16:29:30.808Z
2022-10-17,12:30 PM,10,3,15,3,0,31,2022-10-17T17:29:06.164Z
2022-10-17,1:30 PM,6,4,9,1,0,20,2022-10-17T18:32:53.408Z
2022-10-17,2:30 PM,5,3,5,1,1,15,2022-10-17T19:29:17.041Z
2022-10-17,4:30 PM,4,4,4,8,5,25,2022-10-17T21:53:59.987Z
2022-10-17,5:30 PM,3,4,4,6,13,30,2022-10-17T22:37:17.860Z
2022-10-17,6:30 PM,5,2,6,1,7,21,2022-10-17T23:52:06.124Z
2022-10-17,7:30 PM,7,0,3,1,2,13,2022-10-18T00:42:44.737Z
2022-10-18,9:30 AM,8,4,2,1,0,15,2022-10-18T14:30:22.595Z
2022-10-18,10:30 AM,4,5,6,1,0,16,2022-10-18T15:29:47.106Z
2022-10-18,11:30 AM,17,3,8,2,0,30,2022-10-18T16:28:46.842Z
2022-10-18,12:30 PM,14,5,15,0,0,34,2022-10-18T17:30:50.439Z
2022-10-18,1:30 PM,8,3,10,2,0,23,2022-10-18T18:33:35.332Z
2022-10-18,2:30 PM,9,0,7,2,2,20,2022-10-18T19:30:43.298Z
2022-10-18,3:30 PM,6,0,8,2,3,19,2022-10-18T20:33:44.884Z
2022-10-18,4:30 PM,12,5,7,6,3,33,2022-10-18T21:32:12.354Z
2022-10-18,5:30 PM,7,5,7,5,0,24,2022-10-18T22:29:48.417Z
2022-10-18,6:30 PM,5,2,4,0,0,11,2022-10-18T23:30:01.908Z
2022-10-18,7:30 PM,6,1,4,0,0,11,2022-10-19T00:39:12.096Z
2022-10-19,7:30 AM,0,0,0,0,0,0,2022-10-19T12:29:51.585Z
2022-10-19,8:30 AM,1,2,3,0,0,6,2022-10-19T13:30:25.537Z
2022-10-19,9:30 AM,5,1,6,2,1,15,2022-10-19T14:30:01.596Z
2022-10-19,10:30 AM,4,4,4,2,0,14,2022-10-19T15:29:12.940Z
2022-10-19,11:30 AM,5,3,8,3,0,19,2022-10-19T16:39:31.884Z
2022-10-19,12:30 PM,7,3,11,2,0,23,2022-10-19T17:32:59.982Z
2022-10-19,1:30 PM,5,3,10,7,0,25,2022-10-19T18:29:43.213Z
2022-10-19,2:30 PM,8,3,11,2,1,25,2022-10-19T19:28:43.033Z
2022-10-19,4:30 PM,6,6,6,9,1,28,2022-10-19T21:36:39.036Z
2022-10-19,5:30 PM,7,3,3,0,1,14,2022-10-19T22:46:58.816Z
2022-10-19,6:30 PM,2,1,3,0,0,6,2022-10-19T23:43:39.014Z
2022-10-19,7:30 PM,1,2,3,0,0,6,2022-10-20T00:32:09.619Z
2022-10-20,8:30 AM,2,1,0,0,0,3,2022-10-20T13:30:54.645Z
2022-10-20,9:30 AM,7,3,5,4,0,19,2022-10-20T14:28:30.309Z
2022-10-20,10:30 AM,9,5,11,0,0,25,2022-10-20T15:29:24.918Z
2022-10-20,11:30 AM,6,3,7,2,0,18,2022-10-20T16:29:14.720Z
2022-10-20,12:30 PM,5,3,7,2,3,20,2022-10-20T17:30:08.326Z
2022-10-20,1:30 PM,5,3,9,14,0,31,2022-10-20T18:29:12.143Z
2022-10-20,2:30 PM,5,2,7,3,0,17,2022-10-20T19:28:27.602Z
2022-10-20,3:30 PM,9,1,8,3,4,25,2022-10-20T20:29:43.840Z
2022-10-20,4:30 PM,10,7,5,3,4,29,2022-10-20T21:28:59.887Z
2022-10-20,5:30 PM,9,4,7,2,4,26,2022-10-20T22:35:56.025Z
2022-10-20,6:30 PM,5,3,5,3,6,22,2022-10-20T23:33:57.186Z
2022-10-21,8:30 AM,0,1,0,1,0,2,2022-10-21T13:30:59.579Z
2022-10-21,9:30 AM,0,1,0,1,0,2,2022-10-21T14:30:06.703Z
2022-10-21,10:30 AM,1,2,1,3,0,7,2022-10-21T15:30:32.726Z
2022-10-21,11:30 AM,4,2,1,0,0,7,2022-10-21T16:28:24.376Z
2022-10-21,12:30 PM,4,2,2,0,0,8,2022-10-21T17:34:15.348Z
2022-10-21,1:30 PM,4,1,2,0,0,7,2022-10-21T18:45:33.885Z
2022-10-21,2:30 PM,6,1,2,1,1,11,2022-10-21T19:37:50.393Z
2022-10-21,3:30 PM,4,1,5,2,3,15,2022-10-21T20:32:55.461Z
2022-10-21,4:30 PM,5,1,5,2,3,16,2022-10-21T21:32:51.078Z
2022-10-22,10:30 AM,0,0,0,0,0,0,2022-10-22T15:27:50.572Z
2022-10-22,11:30 AM,1,1,0,0,0,2,2022-10-22T16:33:03.740Z
2022-10-22,12:30 PM,2,1,1,0,1,5,2022-10-22T17:28:20.095Z
2022-10-22,1:30 PM,4,1,4,0,0,9,2022-10-22T18:31:04.628Z
2022-10-22,2:30 PM,5,0,2,0,0,7,2022-10-22T19:51:51.194Z
2022-10-22,3:30 PM,3,0,2,0,0,5,2022-10-22T20:33:16.999Z
2022-10-22,4:30 PM,4,0,2,0,0,6,2022-10-22T21:28:34.828Z
2022-10-24,8:30 AM,1,2,3,2,0,8,2022-10-24T13:30:37.948Z
2022-10-24,9:30 AM,6,2,14,0,0,22,2022-10-24T14:30:31.641Z
2022-10-24,10:30 AM,4,2,11,1,0,18,2022-10-24T15:30:20.025Z
2022-10-24,11:30 AM,9,3,13,1,0,26,2022-10-24T16:30:31.252Z
2022-10-24,12:30 PM,10,3,17,1,0,31,2022-10-24T17:30:30.035Z
2022-10-24,1:30 PM,5,3,13,9,0,30,2022-10-24T18:30:10.686Z
2022-10-24,2:30 PM,5,3,10,3,2,23,2022-10-24T19:28:06.982Z
2022-10-24,4:30 PM,6,3,7,4,1,21,2022-10-24T21:38:42.390Z
2022-10-24,5:30 PM,7,2,5,0,1,15,2022-10-24T22:41:49.027Z
2022-10-24,6:30 PM,4,1,5,0,0,10,2022-10-24T23:28:25.993Z
2022-10-25,8:30 AM,5,1,1,0,0,7,2022-10-25T13:30:53.303Z
2022-10-25,9:30 AM,10,3,8,1,0,22,2022-10-25T14:32:55.500Z
2022-10-25,10:30 AM,10,3,7,1,0,21,2022-10-25T15:29:33.054Z
2022-10-25,11:30 AM,5,3,5,7,0,20,2022-10-25T16:33:01.040Z
2022-10-25,12:30 PM,10,2,10,2,5,29,2022-10-25T17:28:13.609Z
2022-10-25,1:30 PM,11,3,15,5,2,36,2022-10-25T18:29:53.987Z
2022-10-25,2:30 PM,7,3,10,3,2,25,2022-10-25T19:28:11.605Z
2022-10-25,3:30 PM,5,7,14,3,4,33,2022-10-25T20:40:59.415Z
2022-10-25,4:30 PM,5,6,8,4,4,27,2022-10-25T21:42:45.947Z
2022-10-25,5:30 PM,2,4,8,0,9,23,2022-10-25T22:40:30.943Z
2022-10-26,8:30 AM,1,1,2,0,0,4,2022-10-26T13:36:22.199Z
2022-10-26,9:30 AM,6,2,5,0,0,13,2022-10-26T14:29:48.877Z
2022-10-26,10:30 AM,5,2,9,2,0,18,2022-10-26T15:26:35.753Z
2022-10-26,11:30 AM,10,4,13,3,0,30,2022-10-26T16:27:55.167Z
2022-10-26,12:30 PM,7,5,10,11,0,33,2022-10-26T17:32:42.130Z
2022-10-26,1:30 PM,10,5,13,5,0,33,2022-10-26T18:29:22.345Z
2022-10-26,2:30 PM,11,3,10,5,0,29,2022-10-26T19:29:50.900Z
2022-10-26,4:30 PM,9,5,10,1,6,31,2022-10-26T21:59:49.888Z
2022-10-26,5:30 PM,9,4,9,1,3,26,2022-10-26T22:44:39.565Z
2022-10-26,6:30 PM,2,2,3,0,2,9,2022-10-26T23:32:42.879Z
2022-10-26,7:30 PM,2,0,3,0,0,5,2022-10-27T00:33:19.535Z
2022-10-27,8:30 AM,6,1,4,0,0,11,2022-10-27T13:55:08.206Z
2022-10-27,9:30 AM,6,4,4,0,0,14,2022-10-27T14:29:26.575Z
2022-10-27,10:30 AM,4,2,8,0,0,14,2022-10-27T15:32:36.411Z
2022-10-27,11:30 AM,5,2,7,5,0,19,2022-10-27T16:31:20.294Z
2022-10-27,12:30 PM,7,2,9,3,2,23,2022-10-27T17:30:40.862Z
2022-10-27,1:30 PM,6,3,7,2,0,18,2022-10-27T18:31:58.114Z
2022-10-27,3:30 PM,10,4,7,2,0,23,2022-10-27T20:53:42.201Z
2022-10-27,4:30 PM,5,2,12,2,6,27,2022-10-27T21:31:10.928Z
2022-10-27,5:30 PM,5,3,10,3,9,30,2022-10-27T22:38:59.636Z
2022-10-27,6:30 PM,5,2,7,0,2,16,2022-10-27T23:28:58.754Z
2022-10-28,8:30 AM,0,1,0,0,0,1,2022-10-28T13:33:13.821Z
2022-10-28,9:30 AM,1,1,1,0,0,3,2022-10-28T14:29:59.126Z
2022-10-28,10:30 AM,3,1,1,0,0,5,2022-10-28T15:30:06.962Z
2022-10-28,11:30 AM,5,2,3,0,2,12,2022-10-28T16:32:49.389Z
2022-10-28,12:30 PM,6,0,2,1,2,11,2022-10-28T17:34:15.441Z
2022-10-28,1:30 PM,7,0,2,0,0,9,2022-10-28T18:36:12.862Z
2022-10-28,2:30 PM,4,1,7,0,0,12,2022-10-28T19:28:59.322Z
2022-10-28,3:30 PM,3,1,4,2,1,11,2022-10-28T20:33:13.375Z
2022-10-28,4:30 PM,2,0,2,2,1,7,2022-10-28T21:39:28.191Z
2022-10-28,5:30 PM,2,0,1,0,1,4,2022-10-28T22:45:19.114Z
2022-10-29,10:30 AM,2,1,0,0,0,3,2022-10-29T15:29:24.859Z
2022-10-29,11:30 AM,2,0,0,0,0,2,2022-10-29T16:29:06.022Z
2022-10-29,12:30 PM,2,0,2,0,0,4,2022-10-29T17:29:18.750Z
2022-10-29,1:30 PM,3,3,5,0,0,11,2022-10-29T18:40:52.917Z
2022-10-29,2:30 PM,5,2,7,1,0,15,2022-10-29T19:30:43.000Z
2022-10-29,3:30 PM,5,3,4,1,0,13,2022-10-29T20:32:13.192Z
2022-10-29,4:30 PM,5,2,6,0,0,13,2022-10-29T21:29:47.202Z
2022-10-31,8:30 AM,0,2,5,1,0,8,2022-10-31T13:30:17.370Z
2022-10-31,11:30 AM,8,3,11,3,2,27,2022-10-31T16:31:10.660Z
2022-10-31,12:30 PM,5,2,12,3,0,22,2022-10-31T17:30:17.818Z
2022-10-31,1:30 PM,4,2,9,2,0,17,2022-10-31T18:30:11.004Z
2022-10-31,2:30 PM,10,5,3,5,2,25,2022-10-31T19:31:23.711Z
2022-10-31,4:30 PM,4,6,10,1,3,24,2022-10-31T21:34:56.207Z
2022-10-31,5:30 PM,4,5,5,0,3,17,2022-10-31T22:32:02.662Z
2022-11-01,8:30 AM,2,1,1,0,0,4,2022-11-01T13:30:04.837Z
2022-11-01,9:30 AM,8,5,5,0,0,18,2022-11-01T14:29:39.792Z
2022-11-01,10:30 AM,6,2,5,0,0,13,2022-11-01T15:30:01.506Z
2022-11-01,11:30 AM,5,3,7,3,0,18,2022-11-01T16:35:56.149Z
2022-11-01,12:30 PM,8,2,10,2,0,22,2022-11-01T17:30:12.173Z
2022-11-01,1:30 PM,9,3,10,2,0,24,2022-11-01T18:31:10.169Z
2022-11-01,2:30 PM,5,0,5,0,2,12,2022-11-01T19:31:42.934Z
2022-11-01,3:30 PM,15,2,6,2,8,33,2022-11-01T20:30:45.744Z
2022-11-01,4:30 PM,7,2,2,2,12,25,2022-11-01T21:32:15.270Z
2022-11-01,5:30 PM,7,3,4,0,4,18,2022-11-01T22:38:09.031Z
2022-11-01,6:30 PM,6,3,2,2,3,16,2022-11-01T23:32:33.874Z
2022-11-01,7:30 PM,4,2,3,2,1,12,2022-11-02T00:36:41.478Z
2022-11-02,7:30 AM,0,0,0,0,0,0,2022-11-02T12:30:04.375Z
2022-11-02,8:30 AM,4,2,3,0,0,9,2022-11-02T13:29:27.255Z
2022-11-02,9:30 AM,6,3,3,0,0,12,2022-11-02T14:29:28.112Z
2022-11-02,10:30 AM,6,5,10,0,0,21,2022-11-02T15:31:30.162Z
2022-11-02,11:30 AM,6,2,11,1,0,20,2022-11-02T16:33:33.340Z
2022-11-02,12:30 PM,10,3,13,2,2,30,2022-11-02T17:31:41.941Z
2022-11-02,1:30 PM,9,3,7,1,0,20,2022-11-02T18:29:31.965Z
2022-11-02,2:30 PM,9,4,8,3,2,26,2022-11-02T19:26:51.156Z
2022-11-02,4:30 PM,7,9,9,7,4,36,2022-11-02T21:31:36.442Z
2022-11-02,5:30 PM,7,4,10,2,2,25,2022-11-02T22:28:34.924Z
2022-11-02,6:30 PM,1,4,6,0,3,14,2022-11-02T23:32:28.869Z
2022-11-03,8:30 AM,4,1,1,0,0,6,2022-11-03T13:35:53.055Z
2022-11-03,9:30 AM,3,2,4,0,0,9,2022-11-03T14:29:00.444Z
2022-11-03,10:30 AM,1,5,9,0,0,15,2022-11-03T15:28:54.016Z
2022-11-03,11:30 AM,6,2,8,2,0,18,2022-11-03T16:33:35.435Z
2022-11-03,12:30 PM,10,4,7,0,0,21,2022-11-03T17:28:10.255Z
2022-11-03,1:30 PM,4,2,5,0,2,13,2022-11-03T18:29:26.431Z
2022-11-03,2:30 PM,5,2,10,0,0,17,2022-11-03T19:29:00.266Z
2022-11-03,3:30 PM,4,2,4,0,1,11,2022-11-03T20:33:50.778Z
2022-11-03,4:30 PM,5,3,5,0,5,18,2022-11-03T21:31:22.694Z
2022-11-03,5:30 PM,6,1,5,1,2,15,2022-11-03T22:47:19.726Z
2022-11-03,6:30 PM,4,0,5,0,0,9,2022-11-03T23:37:43.030Z
2022-11-03,7:30 PM,2,0,2,2,1,7,2022-11-04T00:44:00.747Z
2022-11-04,9:30 AM,0,1,0,2,0,3,2022-11-04T14:30:19.623Z
2022-11-04,10:30 AM,1,1,1,0,0,3,2022-11-04T15:28:53.924Z
2022-11-04,11:30 AM,1,0,2,0,1,4,2022-11-04T16:40:38.906Z
2022-11-04,12:30 PM,4,0,2,0,3,9,2022-11-04T17:31:40.098Z
2022-11-04,1:30 PM,5,0,1,1,2,9,2022-11-04T18:31:36.236Z
2022-11-04,2:30 PM,3,1,2,0,0,6,2022-11-04T19:30:31.211Z
2022-11-04,3:30 PM,3,3,3,0,0,9,2022-11-04T20:35:13.200Z
2022-11-04,4:30 PM,2,2,5,1,0,10,2022-11-04T21:53:41.403Z
2022-11-05,10:30 AM,4,1,2,0,0,7,2022-11-05T15:31:40.146Z
2022-11-05,11:30 AM,3,0,2,0,1,6,2022-11-05T16:28:08.988Z
2022-11-05,12:30 PM,4,0,0,0,1,5,2022-11-05T17:29:42.243Z
2022-11-05,1:30 PM,3,0,1,0,0,4,2022-11-05T18:35:35.295Z
2022-11-05,2:30 PM,2,1,2,0,0,5,2022-11-05T19:28:18.119Z
2022-11-05,3:30 PM,2,0,2,0,0,4,2022-11-05T20:31:41.234Z
2022-11-05,4:30 PM,3,1,1,0,0,5,2022-11-05T21:32:32.856Z
2022-11-07,7:30 AM,1,0,0,0,1,2,2022-11-07T13:36:33.117Z
2022-11-07,8:30 AM,1,0,2,0,1,4,2022-11-07T14:44:10.977Z
2022-11-07,9:30 AM,6,1,5,0,1,13,2022-11-07T15:43:07.213Z
2022-11-07,10:30 AM,9,0,10,3,2,24,2022-11-07T16:31:23.238Z
2022-11-07,11:30 AM,10,3,10,5,0,28,2022-11-07T17:29:34.569Z
2022-11-07,12:30 PM,15,2,11,3,3,34,2022-11-07T18:30:29.908Z
2022-11-07,1:30 PM,10,2,10,2,0,24,2022-11-07T19:27:40.912Z
2022-11-07,2:30 PM,9,2,7,0,0,18,2022-11-07T20:27:55.035Z
2022-11-07,4:30 PM,6,6,8,0,1,21,2022-11-07T22:38:02.080Z
2022-11-07,5:30 PM,1,4,4,0,1,10,2022-11-07T23:35:42.950Z
2022-11-08,8:30 AM,1,1,1,0,0,3,2022-11-08T14:31:04.104Z
2022-11-08,9:30 AM,6,4,2,0,0,12,2022-11-08T15:29:05.854Z
2022-11-08,10:30 AM,3,4,7,1,0,15,2022-11-08T16:29:15.651Z
2022-11-08,12:30 PM,10,3,13,1,2,29,2022-11-08T18:32:55.626Z
2022-11-08,1:30 PM,8,2,12,1,0,23,2022-11-08T19:28:49.999Z
2022-11-08,2:30 PM,9,3,9,2,0,23,2022-11-08T20:28:26.207Z
2022-11-08,3:30 PM,9,3,3,0,5,20,2022-11-08T21:35:57.980Z
2022-11-08,4:30 PM,2,0,4,0,8,14,2022-11-08T22:38:36.704Z
2022-11-08,5:30 PM,3,2,7,0,4,16,2022-11-08T23:34:00.509Z
2022-11-09,7:30 AM,1,0,0,0,0,1,2022-11-09T13:30:37.842Z
2022-11-09,8:30 AM,2,2,1,1,0,6,2022-11-09T14:30:05.430Z
2022-11-09,9:30 AM,4,1,7,2,0,14,2022-11-09T15:30:48.933Z
2022-11-09,11:30 AM,10,3,11,5,0,29,2022-11-09T17:37:57.087Z
2022-11-09,12:30 PM,11,3,10,2,0,26,2022-11-09T18:36:08.308Z
2022-11-09,1:30 PM,10,3,10,2,0,25,2022-11-09T19:28:55.099Z
2022-11-09,2:30 PM,10,3,7,2,1,23,2022-11-09T20:28:51.478Z
2022-11-09,4:30 PM,8,4,6,2,5,25,2022-11-09T22:38:11.761Z
2022-11-09,5:30 PM,6,2,5,0,5,18,2022-11-09T23:37:39.746Z
2022-11-09,6:30 PM,2,3,0,0,4,9,2022-11-10T00:46:06.391Z
2022-11-09,7:30 PM,2,3,0,0,4,9,2022-11-10T01:33:14.827Z
2022-11-10,8:30 AM,1,1,1,0,0,3,2022-11-10T14:30:04.069Z
2022-11-10,9:30 AM,7,2,8,2,0,19,2022-11-10T15:29:28.679Z
2022-11-10,10:30 AM,2,3,11,1,0,17,2022-11-10T16:29:14.447Z
2022-11-10,11:30 AM,5,2,5,0,0,12,2022-11-10T17:30:46.520Z
2022-11-10,12:30 PM,9,4,7,4,0,24,2022-11-10T18:34:00.979Z
2022-11-10,1:30 PM,5,2,10,3,0,20,2022-11-10T19:30:52.913Z
2022-11-10,2:30 PM,5,2,7,2,0,16,2022-11-10T20:28:13.480Z
2022-11-10,3:30 PM,4,7,8,2,3,24,2022-11-10T21:35:24.513Z
2022-11-10,4:30 PM,5,5,6,0,8,24,2022-11-10T22:37:30.856Z
2022-11-10,5:30 PM,2,2,3,0,8,15,2022-11-10T23:48:27.633Z
2022-11-10,7:30 PM,4,2,2,0,5,13,2022-11-11T01:32:00.772Z
2022-11-11,8:30 AM,3,1,0,0,0,4,2022-11-11T14:34:45.330Z
2022-11-11,9:30 AM,3,2,2,0,0,7,2022-11-11T15:29:43.844Z
2022-11-11,10:30 AM,5,3,3,0,0,11,2022-11-11T16:29:55.289Z
2022-11-11,11:30 AM,6,0,8,0,7,21,2022-11-11T17:39:45.354Z
2022-11-11,12:30 PM,3,1,6,1,5,16,2022-11-11T18:34:10.538Z
2022-11-11,1:30 PM,3,2,1,2,1,9,2022-11-11T19:43:06.752Z
2022-11-11,2:30 PM,4,3,4,2,0,13,2022-11-11T20:37:20.677Z
2022-11-11,3:30 PM,4,3,6,2,2,17,2022-11-11T21:32:53.819Z
2022-11-11,4:30 PM,7,2,2,1,4,16,2022-11-11T22:38:14.656Z
2022-11-12,9:30 AM,2,0,0,0,0,2,2022-11-12T15:50:48.900Z
2022-11-12,10:30 AM,0,0,0,2,0,2,2022-11-12T16:29:26.863Z
2022-11-12,11:30 AM,1,0,1,1,0,3,2022-11-12T17:28:25.583Z
2022-11-12,12:30 PM,3,1,0,1,0,5,2022-11-12T18:30:02.073Z
2022-11-12,1:30 PM,3,1,1,1,0,6,2022-11-12T19:30:27.987Z
2022-11-12,2:30 PM,8,1,2,1,0,12,2022-11-12T20:39:36.933Z
2022-11-12,3:30 PM,7,1,2,1,0,11,2022-11-12T21:48:36.126Z
2022-11-12,4:30 PM,5,1,0,1,0,7,2022-11-12T22:31:09.328Z
2022-11-14,8:30 AM,4,1,3,0,0,8,2022-11-14T14:38:11.072Z
2022-11-14,9:30 AM,5,1,3,1,0,10,2022-11-14T15:29:17.067Z
2022-11-14,10:30 AM,7,3,9,1,0,20,2022-11-14T16:30:01.542Z
2022-11-14,11:30 AM,8,2,12,2,0,24,2022-11-14T17:29:52.862Z
2022-11-14,12:30 PM,8,4,11,0,0,23,2022-11-14T18:30:21.422Z
2022-11-14,1:30 PM,7,2,8,4,0,21,2022-11-14T19:30:48.052Z
2022-11-14,4:30 PM,5,2,8,1,5,21,2022-11-14T22:32:13.348Z
2022-11-14,5:30 PM,2,2,2,1,6,13,2022-11-14T23:42:44.432Z
2022-11-14,6:30 PM,4,1,2,2,5,14,2022-11-15T00:34:51.354Z
2022-11-14,7:30 PM,6,2,2,1,2,13,2022-11-15T01:33:22.939Z
2022-11-15,8:30 AM,1,3,0,0,0,4,2022-11-15T14:31:07.317Z
2022-11-15,9:30 AM,5,5,4,2,0,16,2022-11-15T15:27:00.885Z
2022-11-15,10:30 AM,5,6,4,4,0,19,2022-11-15T16:34:56.391Z
2022-11-15,11:30 AM,8,3,10,3,0,24,2022-11-15T17:31:41.109Z
2022-11-15,12:30 PM,6,3,10,5,0,24,2022-11-15T18:30:47.212Z
2022-11-15,1:30 PM,7,3,11,2,0,23,2022-11-15T19:33:31.605Z
2022-11-15,2:30 PM,8,3,13,4,0,28,2022-11-15T20:30:28.485Z
2022-11-15,3:30 PM,10,6,10,4,0,30,2022-11-15T21:35:19.184Z
2022-11-15,4:30 PM,8,7,4,2,3,24,2022-11-15T22:35:14.287Z
2022-11-15,5:30 PM,8,4,5,3,4,24,2022-11-15T23:30:52.240Z
2022-11-15,6:30 PM,6,3,2,3,2,16,2022-11-16T00:36:32.770Z
2022-11-15,7:30 PM,5,3,2,1,0,11,2022-11-16T01:36:11.915Z
2022-11-16,7:30 AM,0,0,0,0,0,0,2022-11-16T13:30:59.047Z
2022-11-16,8:30 AM,1,1,5,0,0,7,2022-11-16T14:30:09.984Z
2022-11-16,9:30 AM,3,6,4,2,0,15,2022-11-16T15:28:59.020Z
2022-11-16,10:30 AM,7,6,9,0,0,22,2022-11-16T16:34:43.224Z
2022-11-16,11:30 AM,5,2,8,0,0,15,2022-11-16T17:31:59.707Z
2022-11-16,12:30 PM,11,3,8,4,0,26,2022-11-16T18:30:32.784Z
2022-11-16,1:30 PM,6,4,10,4,0,24,2022-11-16T19:28:17.918Z
2022-11-16,2:30 PM,8,3,8,4,0,23,2022-11-16T20:36:38.733Z
2022-11-16,3:30 PM,5,3,8,2,0,18,2022-11-16T21:41:21.977Z
2022-11-16,4:30 PM,8,3,6,0,7,24,2022-11-16T22:28:36.099Z
2022-11-16,5:30 PM,6,4,8,2,2,22,2022-11-16T23:29:13.240Z
2022-11-16,6:30 PM,5,1,2,1,3,12,2022-11-17T00:39:24.605Z
2022-11-17,8:30 AM,2,2,2,1,0,7,2022-11-17T14:30:17.343Z
2022-11-17,9:30 AM,6,4,3,1,0,14,2022-11-17T15:29:35.667Z
2022-11-17,10:30 AM,3,5,4,1,0,13,2022-11-17T16:32:54.669Z
2022-11-17,11:30 AM,7,3,10,4,0,24,2022-11-17T17:28:45.399Z
2022-11-17,12:30 PM,7,2,10,2,0,21,2022-11-17T18:29:42.515Z
2022-11-17,1:30 PM,7,3,8,4,4,26,2022-11-17T19:26:17.991Z
2022-11-17,2:30 PM,5,2,7,5,0,19,2022-11-17T20:29:46.396Z
2022-11-17,3:30 PM,4,2,8,2,5,21,2022-11-17T21:40:37.377Z
2022-11-17,4:30 PM,1,2,2,3,14,22,2022-11-17T22:39:11.112Z
2022-11-17,5:30 PM,2,2,1,1,10,16,2022-11-17T23:34:15.498Z
2022-11-17,7:30 PM,4,0,2,0,5,11,2022-11-18T01:37:12.711Z
2022-11-18,9:30 AM,1,2,1,2,0,6,2022-11-18T15:34:06.520Z
2022-11-18,10:30 AM,1,2,4,1,0,8,2022-11-18T16:29:07.136Z
2022-11-18,11:30 AM,5,1,4,1,5,16,2022-11-18T17:31:18.666Z
2022-11-18,12:30 PM,5,2,4,0,2,13,2022-11-18T18:38:37.493Z
2022-11-18,1:30 PM,3,2,4,2,7,18,2022-11-18T19:33:48.413Z
2022-11-18,2:30 PM,5,1,4,1,7,18,2022-11-18T20:38:32.094Z
2022-11-18,3:30 PM,5,1,3,1,1,11,2022-11-18T21:33:15.145Z
2022-11-18,4:30 PM,2,0,2,2,0,6,2022-11-18T22:32:35.453Z
2022-11-18,5:30 PM,2,0,0,0,0,2,2022-11-18T23:34:14.117Z
2022-11-19,10:30 AM,1,0,1,0,0,2,2022-11-19T16:29:32.696Z
2022-11-19,11:30 AM,2,0,2,0,1,5,2022-11-19T17:28:15.762Z
2022-11-19,12:30 PM,0,0,3,0,0,3,2022-11-19T18:31:28.983Z
2022-11-19,2:30 PM,5,0,0,2,0,7,2022-11-19T20:29:32.359Z
2022-11-19,3:30 PM,4,0,0,2,0,6,2022-11-19T21:30:53.455Z
2022-11-19,4:30 PM,4,0,0,2,3,9,2022-11-19T22:29:43.696Z
2022-11-21,8:30 AM,2,2,2,0,0,6,2022-11-21T14:30:01.664Z
2022-11-21,9:30 AM,6,3,4,1,0,14,2022-11-21T15:29:13.737Z
2022-11-21,10:30 AM,6,8,3,2,0,19,2022-11-21T16:32:15.307Z
2022-11-21,11:30 AM,10,2,8,3,0,23,2022-11-21T17:28:14.059Z
2022-11-21,12:30 PM,9,0,9,3,1,22,2022-11-21T18:29:37.558Z
2022-11-21,1:30 PM,7,0,8,3,0,18,2022-11-21T19:32:43.125Z
2022-11-21,2:30 PM,7,3,10,0,0,20,2022-11-21T20:30:10.871Z
2022-11-21,3:30 PM,12,1,12,1,4,30,2022-11-21T21:40:59.686Z
2022-11-21,4:30 PM,5,4,8,0,0,17,2022-11-21T22:35:05.356Z
2022-11-21,5:30 PM,6,4,3,0,0,13,2022-11-21T23:34:00.359Z
2022-11-22,8:30 AM,1,0,2,0,0,3,2022-11-22T14:29:25.612Z
2022-11-22,9:30 AM,2,1,5,0,0,8,2022-11-22T15:29:09.835Z
2022-11-22,10:30 AM,6,2,5,0,0,13,2022-11-22T16:29:07.313Z
2022-11-22,11:30 AM,7,1,6,1,0,15,2022-11-22T17:31:05.958Z
2022-11-22,12:30 PM,7,1,7,0,0,15,2022-11-22T18:29:42.061Z
2022-11-22,1:30 PM,7,0,5,1,2,15,2022-11-22T19:36:13.398Z
2022-11-22,2:30 PM,5,2,7,2,0,16,2022-11-22T20:31:39.838Z
2022-11-22,3:30 PM,5,3,2,2,3,15,2022-11-22T21:33:34.524Z
2022-11-22,4:30 PM,3,1,5,2,3,14,2022-11-22T22:49:02.326Z
2022-11-22,5:30 PM,2,1,1,0,7,11,2022-11-22T23:57:10.401Z
2022-11-22,7:30 PM,0,0,2,0,0,2,2022-11-23T01:36:15.677Z
2022-11-28,8:30 AM,0,2,2,1,0,5,2022-11-28T14:29:10.390Z
2022-11-28,9:30 AM,2,6,6,0,0,14,2022-11-28T15:29:47.142Z
2022-11-28,10:30 AM,7,7,6,4,0,24,2022-11-28T16:30:05.731Z
2022-11-28,11:30 AM,7,1,13,2,3,26,2022-11-28T17:29:54.087Z
2022-11-28,1:30 PM,11,2,12,2,4,31,2022-11-28T19:08:27.870Z
2022-11-28,1:30 PM,4,1,5,2,0,12,2022-11-28T19:44:38.560Z
2022-11-28,2:30 PM,9,1,10,5,1,26,2022-11-28T20:28:37.060Z
2022-11-28,3:30 PM,16,1,11,4,0,32,2022-11-28T21:31:10.203Z
2022-11-28,4:30 PM,12,4,7,6,2,31,2022-11-28T22:28:40.066Z
2022-11-28,5:30 PM,9,5,5,4,2,25,2022-11-28T23:27:40.468Z
2022-11-28,6:30 PM,4,3,5,0,0,12,2022-11-29T00:35:25.425Z
2022-11-28,7:30 PM,4,2,1,0,1,8,2022-11-29T01:34:07.666Z
2022-11-29,8:30 AM,1,1,1,0,0,3,2022-11-29T14:28:57.002Z
2022-11-29,9:30 AM,3,2,5,0,0,10,2022-11-29T15:29:10.447Z
2022-11-29,10:30 AM,7,4,6,2,0,19,2022-11-29T16:30:17.028Z
2022-11-29,11:30 AM,7,0,8,4,0,19,2022-11-29T17:29:06.191Z
2022-11-29,12:30 PM,10,2,10,3,2,27,2022-11-29T18:28:35.825Z
2022-11-29,1:30 PM,7,2,8,2,4,23,2022-11-29T19:43:19.261Z
2022-11-29,2:30 PM,8,4,6,3,3,24,2022-11-29T20:41:38.498Z
2022-11-29,3:30 PM,11,0,3,6,0,20,2022-11-29T21:40:32.497Z
2022-11-29,4:30 PM,5,5,5,7,7,29,2022-11-29T22:47:41.700Z
2022-11-29,5:30 PM,2,5,4,3,7,21,2022-11-29T23:36:55.624Z
2022-11-29,6:30 PM,0,2,3,2,0,7,2022-11-30T00:39:13.525Z
2022-11-30,8:30 AM,10,3,3,0,0,16,2022-11-30T14:31:20.665Z
2022-11-30,9:30 AM,4,2,5,0,2,13,2022-11-30T15:30:13.772Z
2022-11-30,10:30 AM,16,6,12,5,0,39,2022-11-30T16:28:17.503Z
2022-11-30,11:30 AM,20,3,27,6,5,61,2022-11-30T17:29:04.727Z
2022-11-30,12:30 PM,10,2,17,5,5,39,2022-11-30T18:30:16.919Z
2022-11-30,1:30 PM,7,0,7,0,0,14,2022-11-30T19:31:44.753Z
2022-11-30,2:30 PM,7,4,8,1,4,24,2022-11-30T20:35:12.765Z
2022-11-30,3:30 PM,10,6,7,2,1,26,2022-11-30T21:38:31.277Z
2022-11-30,4:30 PM,7,5,4,0,2,18,2022-11-30T22:34:08.923Z
2022-11-30,5:30 PM,2,2,3,2,0,9,2022-11-30T23:40:10.629Z
2022-11-30,6:30 PM,1,0,1,1,0,3,2022-12-01T00:43:52.598Z
2022-11-30,7:30 PM,1,0,1,1,0,3,2022-12-01T01:36:45.194Z
2022-12-01,8:30 AM,0,0,2,2,0,4,2022-12-01T14:31:36.593Z
2022-12-01,9:30 AM,4,4,5,0,0,13,2022-12-01T15:24:20.930Z
2022-12-01,10:30 AM,7,5,6,0,0,18,2022-12-01T16:31:48.584Z
2022-12-01,11:30 AM,3,0,7,0,0,10,2022-12-01T17:41:29.601Z
2022-12-01,12:30 PM,5,5,5,0,1,16,2022-12-01T18:31:49.669Z
2022-12-01,1:30 PM,6,6,7,1,0,20,2022-12-01T19:35:35.364Z
2022-12-01,2:30 PM,3,0,5,1,0,9,2022-12-01T20:31:48.527Z
2022-12-01,3:30 PM,5,2,5,3,0,15,2022-12-01T21:33:56.237Z
2022-12-01,4:30 PM,4,3,6,3,4,20,2022-12-01T22:42:23.182Z
2022-12-01,5:30 PM,2,3,6,0,10,21,2022-12-01T23:29:01.798Z
2022-12-01,6:30 PM,2,2,5,0,1,10,2022-12-02T00:33:08.451Z
2022-12-01,7:30 PM,1,2,1,0,4,8,2022-12-02T01:32:33.347Z
2022-12-02,8:30 AM,1,1,0,0,0,2,2022-12-02T14:34:39.734Z
2022-12-02,9:30 AM,2,1,1,0,0,4,2022-12-02T15:29:06.383Z
2022-12-02,10:30 AM,4,1,1,0,0,6,2022-12-02T16:29:29.615Z
2022-12-02,11:30 AM,2,2,4,0,4,12,2022-12-02T17:41:10.722Z
2022-12-02,12:30 PM,3,0,2,0,3,8,2022-12-02T18:36:13.286Z
2022-12-02,1:30 PM,3,0,2,2,1,8,2022-12-02T19:33:59.798Z
2022-12-02,2:30 PM,2,0,2,3,0,7,2022-12-02T20:38:13.671Z
2022-12-02,3:30 PM,4,2,5,3,0,14,2022-12-02T21:32:58.020Z
2022-12-02,4:30 PM,3,1,2,3,0,9,2022-12-02T22:39:20.096Z
2022-12-02,5:30 PM,1,1,2,3,0,7,2022-12-02T23:35:50.717Z
2022-12-03,10:30 AM,1,1,1,0,2,5,2022-12-03T16:31:42.750Z
2022-12-03,11:30 AM,2,1,2,0,1,6,2022-12-03T17:31:19.971Z
2022-12-03,12:30 PM,3,1,0,1,0,5,2022-12-03T18:27:31.467Z
2022-12-03,2:30 PM,6,0,4,0,0,10,2022-12-03T20:38:50.584Z
2022-12-03,3:30 PM,6,0,5,1,0,12,2022-12-03T21:28:19.883Z
2022-12-03,4:30 PM,5,1,7,1,0,14,2022-12-03T22:27:20.825Z
2022-12-04,12:30 PM,12,2,13,6,2,35,2022-04-04T17:30:40.115Z
2022-12-05,7:30 AM,2,0,2,0,0,4,2022-12-05T14:07:29.035Z
2022-12-05,8:30 AM,5,1,4,0,0,10,2022-12-05T14:41:00.857Z
2022-12-05,11:30 AM,6,3,7,4,0,20,2022-12-05T17:32:58.021Z
2022-12-05,12:30 PM,8,3,8,4,0,23,2022-12-05T18:28:26.099Z
2022-12-05,2:30 PM,5,2,8,3,2,20,2022-12-05T20:29:56.837Z
2022-12-05,2:30 PM,4,4,9,4,2,23,2022-12-05T20:46:36.013Z
2022-12-05,3:30 PM,6,3,6,4,2,21,2022-12-05T21:31:56.775Z
2022-12-05,4:30 PM,7,2,7,7,7,30,2022-12-05T22:43:12.000Z
2022-12-05,5:30 PM,7,1,7,5,5,25,2022-12-05T23:35:08.921Z
2022-12-05,6:30 PM,5,1,3,0,1,10,2022-12-06T00:40:31.989Z
2022-12-05,7:30 PM,2,2,3,0,1,8,2022-12-06T01:33:02.203Z
2022-12-06,8:30 AM,2,2,1,1,0,6,2022-12-06T14:28:57.736Z
2022-12-06,9:30 AM,4,5,5,1,0,15,2022-12-06T15:29:25.254Z
2022-12-06,10:30 AM,4,6,7,3,0,20,2022-12-06T16:28:52.084Z
2022-12-06,11:30 AM,8,7,10,4,0,29,2022-12-06T17:29:39.871Z
2022-12-06,12:30 PM,9,5,10,7,0,31,2022-12-06T18:31:23.728Z
2022-12-06,1:30 PM,5,2,14,3,5,29,2022-12-06T19:45:12.964Z
2022-12-06,2:30 PM,8,2,12,3,3,28,2022-12-06T20:37:24.393Z
2022-12-06,3:30 PM,7,3,9,4,2,25,2022-12-06T21:35:28.310Z
2022-12-06,4:30 PM,4,5,4,4,3,20,2022-12-06T22:37:31.515Z
2022-12-06,5:30 PM,3,2,1,0,0,6,2022-12-06T23:42:02.947Z
2022-12-06,6:30 PM,3,2,1,0,0,6,2022-12-07T00:39:57.477Z
2022-12-07,8:30 AM,4,0,2,2,0,8,2022-12-07T14:29:25.207Z
2022-12-07,9:30 AM,6,1,5,2,0,14,2022-12-07T15:30:05.336Z
2022-12-07,10:30 AM,10,1,8,3,0,22,2022-12-07T16:34:37.373Z
2022-12-07,11:30 AM,7,3,8,3,0,21,2022-12-07T17:31:25.623Z
2022-12-07,12:30 PM,6,3,7,3,2,21,2022-12-07T18:34:53.136Z
2022-12-07,1:30 PM,7,3,6,4,3,23,2022-12-07T19:49:06.920Z
2022-12-07,2:30 PM,5,2,8,2,0,17,2022-12-07T20:31:25.279Z
2022-12-07,3:30 PM,10,2,8,5,6,31,2022-12-07T21:43:21.936Z
2022-12-07,4:30 PM,5,3,7,5,4,24,2022-12-07T22:31:11.875Z
2022-12-07,5:30 PM,4,2,5,3,2,16,2022-12-07T23:33:45.123Z
2022-12-07,6:30 PM,2,2,1,2,2,9,2022-12-08T00:41:27.341Z
2022-12-07,7:30 PM,1,2,2,2,2,9,2022-12-08T01:34:48.873Z
2022-12-08,8:30 AM,3,0,2,0,0,5,2022-12-08T14:30:08.422Z
2022-12-08,9:30 AM,6,1,3,1,0,11,2022-12-08T15:29:11.497Z
2022-12-08,10:30 AM,3,5,5,3,0,16,2022-12-08T16:28:50.792Z
2022-12-08,11:30 AM,5,3,4,1,0,13,2022-12-08T17:30:56.855Z
2022-12-08,12:30 PM,5,3,5,2,0,15,2022-12-08T18:30:25.209Z
2022-12-08,1:30 PM,7,1,6,5,0,19,2022-12-08T19:48:17.962Z
2022-12-08,2:30 PM,8,2,6,0,0,16,2022-12-08T20:30:09.291Z
2022-12-08,3:30 PM,9,1,6,3,0,19,2022-12-08T21:38:30.682Z
2022-12-08,4:30 PM,8,2,7,1,2,20,2022-12-08T22:34:22.856Z
2022-12-08,5:30 PM,3,1,4,1,3,12,2022-12-08T23:29:32.063Z
2022-12-08,6:30 PM,1,1,3,0,2,7,2022-12-09T00:31:22.715Z
2022-12-09,8:30 AM,1,1,0,0,0,2,2022-12-09T14:30:18.799Z
2022-12-09,9:30 AM,4,1,0,0,0,5,2022-12-09T15:33:12.052Z
2022-12-09,10:30 AM,2,2,0,0,0,4,2022-12-09T16:36:31.714Z
2022-12-09,11:30 AM,3,1,2,0,4,10,2022-12-09T17:34:17.779Z
2022-12-09,12:30 PM,5,0,0,0,1,6,2022-12-09T18:28:27.406Z
2022-12-09,1:30 PM,4,0,0,0,1,5,2022-12-09T19:32:56.027Z
2022-12-09,2:30 PM,4,1,1,1,0,7,2022-12-09T20:33:17.871Z
2022-12-09,3:30 PM,3,2,0,0,0,5,2022-12-09T21:31:48.453Z
2022-12-09,4:30 PM,3,1,0,0,0,4,2022-12-09T22:43:18.705Z
2022-12-09,5:30 PM,2,0,0,0,0,2,2022-12-09T23:32:10.317Z
2022-12-10,10:30 AM,1,0,0,0,0,1,2022-12-10T16:27:30.522Z
2022-12-10,11:30 AM,0,0,1,0,1,2,2022-12-10T17:40:14.104Z
2022-12-10,12:30 PM,1,0,0,0,1,2,2022-12-10T18:27:39.318Z
2022-12-10,1:30 PM,4,0,2,0,0,6,2022-12-10T19:36:51.526Z
2022-12-10,2:30 PM,4,0,0,0,0,4,2022-12-10T20:57:17.106Z
2022-12-10,3:30 PM,3,0,1,0,0,4,2022-12-10T21:33:41.254Z
2022-12-10,4:30 PM,3,0,1,0,0,4,2022-12-10T22:42:30.498Z
2022-12-12,7:30 AM,2,0,0,0,0,2,2022-12-12T13:42:42.711Z
2022-12-12,8:30 AM,1,0,0,0,0,1,2022-12-12T14:39:02.065Z
2022-12-12,9:30 AM,2,1,0,0,0,3,2022-12-12T15:35:13.987Z
2022-12-12,10:30 AM,2,1,0,0,1,4,2022-12-12T16:49:54.279Z
2022-12-12,11:30 AM,2,1,0,0,1,4,2022-12-12T17:28:08.868Z
2022-12-12,12:30 PM,2,0,1,0,0,3,2022-12-12T18:58:10.097Z
2022-12-12,1:30 PM,2,0,2,0,0,4,2022-12-12T19:34:38.818Z
2022-12-12,3:30 PM,3,0,3,0,0,6,2022-12-12T21:36:55.868Z
2022-12-12,4:30 PM,4,0,2,0,0,6,2022-12-12T22:33:09.331Z
2022-12-13,7:30 AM,0,0,0,0,0,0,2022-12-13T13:31:50.775Z
2022-12-13,8:30 AM,0,0,0,0,0,0,2022-12-13T14:26:59.327Z
2022-12-13,9:30 AM,1,1,1,0,0,3,2022-12-13T15:36:11.358Z
2022-12-13,10:30 AM,1,0,2,0,0,3,2022-12-13T16:38:46.797Z
2022-12-13,12:30 PM,2,0,0,0,2,4,2022-12-13T18:28:54.162Z
2022-12-13,1:30 PM,2,0,3,0,0,5,2022-12-13T19:30:07.792Z
2022-12-13,4:30 PM,2,0,1,0,0,3,2022-12-13T22:34:29.069Z
2022-12-14,7:30 AM,0,0,0,0,1,1,2022-12-14T13:46:32.220Z
2022-12-14,8:30 AM,2,0,0,0,0,2,2022-12-14T14:42:15.854Z
2022-12-14,9:30 AM,3,0,1,0,0,4,2022-12-14T15:32:54.291Z
2022-12-14,11:30 AM,1,0,1,0,0,2,2022-12-14T17:41:02.044Z
2022-12-15,7:30 AM,0,0,0,0,0,0,2022-12-15T13:59:39.382Z
2022-12-15,8:30 AM,0,0,0,0,0,0,2022-12-15T14:40:34.314Z
2022-12-15,9:30 AM,1,1,0,0,1,3,2022-12-15T15:47:12.596Z
2022-12-15,10:30 AM,1,1,0,0,0,2,2022-12-15T16:53:31.084Z
2022-12-15,11:30 AM,1,0,0,0,0,1,2022-12-15T17:37:13.082Z
2022-12-15,12:30 PM,4,0,0,0,0,4,2022-12-15T18:34:30.015Z
2022-12-15,1:30 PM,4,0,0,0,0,4,2022-12-15T19:33:15.422Z
2022-12-15,2:30 PM,2,0,0,0,0,2,2022-12-15T20:37:06.881Z
2022-12-15,4:30 PM,0,0,0,0,0,0,2022-12-15T22:32:23.383Z
2022-12-16,7:30 AM,1,0,0,0,0,1,2022-12-16T13:37:16.800Z
2022-12-16,8:30 AM,1,0,0,0,0,1,2022-12-16T14:30:08.172Z
2022-12-16,9:30 AM,1,0,0,0,0,1,2022-12-16T15:28:13.692Z
2022-12-16,10:30 AM,1,0,0,0,0,1,2022-12-16T16:30:49.030Z
2022-12-16,11:30 AM,3,0,0,0,0,3,2022-12-16T17:35:05.178Z
2022-12-16,12:30 PM,2,0,0,0,0,2,2022-12-16T18:53:04.188Z
2022-12-16,1:30 PM,2,0,0,0,0,2,2022-12-16T19:27:11.765Z
2022-12-16,2:30 PM,0,0,0,0,0,0,2022-12-16T20:39:03.245Z
2022-12-16,4:30 PM,1,0,0,0,0,1,2022-12-16T22:29:23.539Z
2022-12-19,7:30 AM,0,0,0,0,0,0,2022-12-19T13:43:01.965Z
2022-12-19,8:30 AM,0,0,0,0,0,0,2022-12-19T14:46:03.624Z
2022-12-19,9:30 AM,0,0,0,0,0,0,2022-12-19T15:45:12.396Z
2022-12-19,10:30 AM,3,0,0,0,0,3,2022-12-19T16:31:08.242Z
2022-12-19,12:30 PM,0,0,0,0,0,0,2022-12-19T18:07:31.955Z
2022-12-19,3:30 PM,0,0,0,0,0,0,2022-12-19T21:30:53.121Z
2022-12-19,4:30 PM,1,1,0,0,0,2,2022-12-19T22:31:08.162Z
2022-12-19,5:30 PM,1,0,0,0,0,1,2022-12-19T23:28:59.224Z
2022-12-20,7:30 AM,0,0,0,0,0,0,2022-12-20T13:43:57.839Z
2022-12-20,8:30 AM,0,0,0,0,0,0,2022-12-20T14:35:13.999Z
2022-12-20,9:30 AM,0,0,0,0,0,0,2022-12-20T15:30:16.995Z
2022-12-20,10:30 AM,0,0,0,0,0,0,2022-12-20T16:29:34.883Z
2022-12-20,12:30 PM,2,0,0,2,0,4,2022-12-20T18:30:08.340Z
2022-12-20,3:30 PM,0,1,0,0,0,1,2022-12-20T22:00:21.085Z
2022-12-21,7:30 AM,0,0,0,0,0,0,2022-12-21T13:49:59.564Z
2022-12-21,8:30 AM,0,0,0,0,0,0,2022-12-21T14:34:50.969Z
2022-12-21,9:30 AM,0,0,0,0,0,0,2022-12-21T15:32:00.140Z
2022-12-21,10:30 AM,0,0,0,0,0,0,2022-12-21T16:26:04.651Z
2022-12-21,11:30 AM,0,0,0,0,1,1,2022-12-21T17:41:24.101Z
2022-12-21,12:30 PM,3,0,0,0,0,3,2022-12-21T18:48:03.001Z
2022-12-21,1:30 PM,0,0,0,0,0,0,2022-12-21T19:28:26.864Z
2022-12-21,2:30 PM,1,0,0,0,0,1,2022-12-21T20:24:43.265Z
2022-12-21,3:30 PM,2,0,0,0,0,2,2022-12-21T21:35:13.446Z
2023-01-03,7:30 AM,0,0,1,0,0,1,2023-01-03T13:35:24.112Z
2023-01-03,8:30 AM,0,0,2,2,3,7,2023-01-03T14:37:17.424Z
2023-01-03,9:30 AM,0,0,1,2,3,6,2023-01-03T15:31:53.680Z
2023-01-03,10:30 AM,1,1,0,2,0,4,2023-01-03T16:30:27.908Z
2023-01-03,11:30 AM,1,1,0,2,3,7,2023-01-03T17:34:47.055Z
2023-01-03,2:30 PM,0,1,0,0,1,2,2023-01-03T20:51:50.220Z
2023-01-03,3:30 PM,0,0,0,0,0,0,2023-01-03T21:35:31.871Z
2023-01-03,4:30 PM,0,0,0,1,0,1,2023-01-03T22:41:07.757Z
2023-01-04,7:30 AM,0,0,0,0,0,0,2023-01-04T13:38:39.583Z
2023-01-04,8:30 AM,0,0,0,0,0,0,2023-01-04T14:29:20.252Z
2023-01-04,10:30 AM,0,0,1,0,0,1,2023-01-04T16:04:31.756Z
2023-01-04,11:30 AM,1,0,0,0,0,1,2023-01-04T17:33:37.506Z
2023-01-04,12:30 PM,3,0,0,0,0,3,2023-01-04T18:34:14.609Z
2023-01-04,1:30 PM,0,0,0,0,0,0,2023-01-04T19:32:44.136Z
2023-01-04,2:30 PM,2,0,0,0,3,5,2023-01-04T20:33:35.728Z
2023-01-04,3:30 PM,4,0,0,0,3,7,2023-01-04T21:35:26.481Z
2023-01-04,4:30 PM,3,0,0,0,3,6,2023-01-04T22:30:40.760Z
2023-01-05,7:30 AM,0,0,0,0,0,0,2023-01-05T13:44:34.908Z
2023-01-05,8:30 AM,0,0,0,2,0,2,2023-01-05T14:34:27.982Z
2023-01-05,9:30 AM,1,0,3,2,0,6,2023-01-05T15:29:26.346Z
2023-01-05,10:30 AM,4,0,3,2,1,10,2023-01-05T16:32:06.949Z
2023-01-05,11:30 AM,3,0,0,2,1,6,2023-01-05T17:28:52.080Z
2023-01-05,12:30 PM,3,0,3,2,0,8,2023-01-05T18:30:36.098Z
2023-01-05,1:30 PM,2,0,0,1,0,3,2023-01-05T19:46:27.967Z
2023-01-05,2:30 PM,3,0,0,0,1,4,2023-01-05T20:40:54.232Z
2023-01-05,4:30 PM,0,0,0,0,0,0,2023-01-05T22:32:41.419Z
2023-01-06,8:30 AM,4,0,0,0,0,4,2023-01-06T14:33:53.364Z
2023-01-06,9:30 AM,3,0,0,0,0,3,2023-01-06T15:26:22.734Z
2023-01-06,10:30 AM,4,0,0,0,0,4,2023-01-06T16:38:41.023Z
2023-01-06,11:30 AM,4,0,0,0,0,4,2023-01-06T17:28:35.708Z
2023-01-06,2:30 PM,1,0,0,1,0,2,2023-01-06T20:31:22.013Z
2023-01-09,8:30 AM,2,0,0,1,0,3,2023-01-09T14:37:29.630Z
2023-01-09,9:30 AM,6,0,0,1,1,8,2023-01-09T15:44:20.625Z
2023-01-09,10:30 AM,5,0,0,1,2,8,2023-01-09T16:31:11.234Z
2023-01-09,11:30 AM,4,0,0,2,2,8,2023-01-09T17:27:53.176Z
2023-01-09,12:30 PM,4,1,2,0,0,7,2023-01-09T18:32:55.385Z
2023-01-09,2:30 PM,2,0,0,2,2,6,2023-01-09T20:48:03.872Z
2023-01-09,3:30 PM,1,0,0,1,0,2,2023-01-09T21:34:57.129Z
2023-01-09,4:30 PM,4,0,0,1,0,5,2023-01-09T22:32:10.229Z
2023-01-10,8:30 AM,2,0,0,0,0,2,2023-01-10T14:28:58.960Z
2023-01-10,9:30 AM,3,0,0,1,0,4,2023-01-10T15:35:36.338Z
2023-01-10,10:30 AM,2,0,1,3,2,8,2023-01-10T16:45:14.552Z
2023-01-10,12:30 PM,2,0,0,4,2,8,2023-01-10T18:35:49.883Z
2023-01-10,1:30 PM,3,0,2,1,2,8,2023-01-10T19:29:06.861Z
2023-01-10,2:30 PM,4,0,0,3,2,9,2023-01-10T20:31:53.096Z
2023-01-10,3:30 PM,1,0,2,2,1,6,2023-01-10T21:35:04.289Z
2023-01-11,9:30 AM,1,0,0,0,1,2,2023-01-11T15:10:20.609Z
2023-01-11,10:30 AM,4,0,0,0,3,7,2023-01-11T16:44:00.664Z
2023-01-11,11:30 AM,2,0,0,0,5,7,2023-01-11T17:27:45.648Z
2023-01-11,12:30 PM,4,0,0,0,2,6,2023-01-11T18:59:13.963Z
2023-01-11,1:30 PM,3,0,2,1,2,8,2023-01-11T19:55:47.937Z
2023-01-11,2:30 PM,5,1,0,0,2,8,2023-01-11T20:37:54.374Z
2023-01-11,3:30 PM,4,0,0,0,3,7,2023-01-11T21:37:35.159Z
2023-01-11,4:30 PM,2,0,1,0,1,4,2023-01-11T22:30:42.066Z
2023-01-12,8:30 AM,1,2,0,0,0,3,2023-01-12T14:34:52.322Z
2023-01-12,9:30 AM,0,0,0,1,1,2,2023-01-12T15:37:22.059Z
2023-01-12,10:30 AM,0,0,0,2,1,3,2023-01-12T16:35:39.767Z
2023-01-12,11:30 AM,4,0,0,2,0,6,2023-01-12T17:29:06.188Z
2023-01-12,12:30 PM,3,0,1,2,0,6,2023-01-12T18:44:16.782Z
2023-01-12,1:30 PM,1,0,1,2,0,4,2023-01-12T19:56:47.154Z
2023-01-12,2:30 PM,2,0,3,1,0,6,2023-01-12T20:34:25.288Z
2023-01-12,3:30 PM,2,0,4,0,0,6,2023-01-12T21:32:24.621Z
2023-01-12,4:30 PM,2,0,1,0,1,4,2023-01-12T22:50:22.000Z
2023-01-13,8:30 AM,3,0,0,1,1,5,2023-01-13T14:41:55.682Z
2023-01-13,9:30 AM,4,0,0,1,0,5,2023-01-13T15:52:50.619Z
2023-01-13,10:30 AM,5,0,0,1,0,6,2023-01-13T16:37:47.369Z
2023-01-13,11:30 AM,3,0,0,1,0,4,2023-01-13T17:32:21.534Z
2023-01-13,12:30 PM,4,0,2,0,0,6,2023-01-13T18:51:09.527Z
2023-01-13,2:30 PM,3,0,1,0,0,4,2023-01-13T20:25:08.251Z
2023-01-13,3:30 PM,1,0,0,0,1,2,2023-01-13T21:33:57.503Z
2023-01-13,4:30 PM,1,0,2,0,0,3,2023-01-13T22:36:20.220Z
2023-01-17,8:30 AM,7,1,1,0,0,9,2023-01-17T14:29:15.063Z
2023-01-17,9:30 AM,8,2,3,0,0,13,2023-01-17T15:32:23.215Z
2023-01-17,10:30 AM,8,6,9,1,0,24,2023-01-17T16:30:03.455Z
2023-01-17,11:30 AM,8,4,11,0,1,24,2023-01-17T17:43:15.784Z
2023-01-17,12:30 PM,13,2,12,0,8,35,2023-01-17T18:48:58.251Z
2023-01-17,1:30 PM,16,4,10,0,1,31,2023-01-17T19:50:39.571Z
2023-01-17,2:30 PM,14,2,9,1,0,26,2023-01-17T20:39:57.570Z
2023-01-17,3:30 PM,6,1,4,3,3,17,2023-01-17T21:34:18.389Z
2023-01-17,4:30 PM,14,0,4,0,1,19,2023-01-17T22:41:57.406Z
2023-01-17,5:30 PM,5,0,3,0,0,8,2023-01-17T23:41:32.607Z
2023-01-17,6:30 PM,3,0,0,0,0,3,2023-01-18T01:37:48.160Z
2023-01-17,7:30 PM,1,2,1,0,0,4,2023-01-18T01:38:02.224Z
2023-01-18,8:30 AM,3,2,0,0,0,5,2023-01-18T14:31:07.573Z
2023-01-18,9:30 AM,1,0,5,0,0,6,2023-01-18T15:29:23.271Z
2023-01-18,10:30 AM,4,1,4,0,0,9,2023-01-18T16:29:54.681Z
2023-01-18,11:30 AM,17,3,10,1,3,34,2023-01-18T17:43:20.443Z
2023-01-18,12:30 PM,17,4,22,1,0,44,2023-01-18T18:32:48.360Z
2023-01-18,1:30 PM,13,5,5,0,2,25,2023-01-18T19:35:58.181Z
2023-01-18,2:30 PM,10,2,7,1,2,22,2023-01-18T20:55:52.398Z
2023-01-18,3:30 PM,7,6,8,1,0,22,2023-01-18T21:35:17.570Z
2023-01-18,4:30 PM,6,3,6,0,0,15,2023-01-18T22:35:00.988Z
2023-01-18,5:30 PM,10,2,3,0,4,19,2023-01-18T23:29:21.932Z
2023-01-18,6:30 PM,0,0,2,0,0,2,2023-01-19T00:27:41.146Z
2023-01-19,8:30 AM,4,2,1,0,0,7,2023-01-19T14:33:28.324Z
2023-01-19,9:30 AM,4,2,3,0,0,9,2023-01-19T15:29:20.542Z
2023-01-19,10:30 AM,9,5,3,1,0,18,2023-01-19T16:32:48.086Z
2023-01-19,11:30 AM,5,6,10,0,0,21,2023-01-19T17:37:36.770Z
2023-01-19,12:30 PM,4,6,8,8,1,27,2023-01-19T18:41:10.456Z
2023-01-19,1:30 PM,15,6,11,1,0,33,2023-01-19T19:46:17.068Z
2023-01-19,3:30 PM,8,2,5,0,0,15,2023-01-19T21:38:58.293Z
2023-01-19,4:30 PM,5,0,8,3,3,19,2023-01-19T22:39:06.202Z
2023-01-19,5:30 PM,4,1,3,1,0,9,2023-01-19T23:35:56.357Z
2023-01-19,6:30 PM,1,2,1,0,15,19,2023-01-20T00:31:49.242Z
2023-01-20,8:30 AM,3,1,0,0,0,4,2023-01-20T14:29:33.360Z
2023-01-20,9:30 AM,3,1,8,0,0,12,2023-01-20T15:29:10.631Z
2023-01-20,10:30 AM,4,2,4,0,0,10,2023-01-20T16:30:44.146Z
2023-01-20,11:30 AM,5,2,8,0,3,18,2023-01-20T17:38:48.334Z
2023-01-20,12:30 PM,6,3,4,0,0,13,2023-01-20T18:46:45.868Z
2023-01-20,1:30 PM,5,2,2,0,3,12,2023-01-20T19:42:36.492Z
2023-01-20,2:30 PM,6,2,5,0,6,19,2023-01-20T20:33:59.190Z
2023-01-20,3:30 PM,9,0,3,0,4,16,2023-01-20T21:37:07.659Z
2023-01-20,4:30 PM,8,1,1,2,3,15,2023-01-20T22:40:29.641Z
2023-01-20,5:30 PM,4,0,1,2,0,7,2023-01-20T23:34:37.774Z
2023-01-21,10:30 AM,5,2,0,0,0,7,2023-01-21T16:31:44.680Z
2023-01-21,11:30 AM,2,0,1,0,0,3,2023-01-21T17:34:24.629Z
2023-01-21,1:30 PM,3,1,1,1,0,6,2023-01-21T19:48:50.365Z
2023-01-21,2:30 PM,2,1,1,2,0,6,2023-01-21T20:46:28.348Z
2023-01-21,3:30 PM,1,1,1,2,0,5,2023-01-21T21:44:08.774Z
2023-01-21,4:30 PM,1,1,1,0,0,3,2023-01-21T22:30:11.160Z
2023-01-23,8:30 AM,3,3,1,1,0,8,2023-01-23T14:29:12.503Z
2023-01-23,9:30 AM,4,2,1,1,1,9,2023-01-23T15:36:42.038Z
2023-01-23,10:30 AM,4,3,6,2,0,15,2023-01-23T16:33:12.227Z
2023-01-23,11:30 AM,9,4,14,1,0,28,2023-01-23T17:31:18.241Z
2023-01-23,12:30 PM,16,6,12,1,2,37,2023-01-23T18:35:49.208Z
2023-01-23,1:30 PM,7,5,11,3,3,29,2023-01-23T19:38:10.693Z
2023-01-23,2:30 PM,9,4,13,2,2,30,2023-01-23T20:54:38.272Z
2023-01-23,3:30 PM,9,3,5,1,3,21,2023-01-23T21:54:34.987Z
2023-01-23,4:30 PM,8,6,8,3,7,32,2023-01-23T22:31:39.663Z
2023-01-23,5:30 PM,4,2,4,3,6,19,2023-01-23T23:41:20.399Z
2023-01-24,8:30 AM,2,2,3,0,0,7,2023-01-24T14:30:10.439Z
2023-01-24,9:30 AM,3,2,5,0,0,10,2023-01-24T15:40:14.512Z
2023-01-24,10:30 AM,5,3,7,0,0,15,2023-01-24T16:30:44.592Z
2023-01-24,11:30 AM,9,2,10,0,6,27,2023-01-24T17:51:29.711Z
2023-01-24,12:30 PM,16,5,14,2,0,37,2023-01-24T18:39:30.795Z
2023-01-24,1:30 PM,11,3,8,2,0,24,2023-01-24T19:37:53.133Z
2023-01-24,2:30 PM,9,2,8,2,2,23,2023-01-24T20:38:39.279Z
2023-01-24,3:30 PM,5,1,4,0,0,10,2023-01-24T21:47:59.321Z
2023-01-25,8:30 AM,1,0,2,1,0,4,2023-01-25T14:39:04.381Z
2023-01-25,9:30 AM,3,1,2,1,0,7,2023-01-25T15:30:51.021Z
2023-01-25,10:30 AM,4,2,6,2,0,14,2023-01-25T16:29:20.819Z
2023-01-25,11:30 AM,10,7,13,4,2,36,2023-01-25T17:43:15.567Z
2023-01-25,12:30 PM,18,7,21,4,1,51,2023-01-25T18:33:18.672Z
2023-01-25,1:30 PM,9,4,5,2,1,21,2023-01-25T19:41:04.835Z
2023-01-25,2:30 PM,7,5,7,2,1,22,2023-01-25T20:35:35.451Z
2023-01-25,3:30 PM,9,4,8,0,1,22,2023-01-25T21:34:33.029Z
2023-01-25,4:30 PM,7,5,9,0,6,27,2023-01-25T22:34:36.149Z
2023-01-25,5:30 PM,5,2,4,1,6,18,2023-01-25T23:32:17.989Z
2023-01-26,8:30 AM,0,0,1,0,0,1,2023-01-26T14:29:48.447Z
2023-01-26,9:30 AM,1,2,5,1,0,9,2023-01-26T15:30:10.840Z
2023-01-26,10:30 AM,5,4,5,0,0,14,2023-01-26T16:30:00.398Z
2023-01-26,11:30 AM,9,5,14,1,2,31,2023-01-26T17:38:54.398Z
2023-01-26,12:30 PM,9,5,10,2,4,30,2023-01-26T18:42:04.295Z
2023-01-26,1:30 PM,7,2,11,2,1,23,2023-01-26T19:37:52.691Z
2023-01-26,2:30 PM,13,4,13,4,3,37,2023-01-26T20:33:59.736Z
2023-01-26,3:30 PM,7,2,11,2,6,28,2023-01-26T21:45:08.197Z
2023-01-26,4:30 PM,6,2,8,2,7,25,2023-01-26T22:22:46.318Z
2023-01-26,5:30 PM,4,0,4,2,2,12,2023-01-26T23:37:40.100Z
2023-01-26,6:30 PM,0,1,3,0,2,6,2023-01-27T00:37:34.334Z
2023-01-26,7:30 PM,1,1,2,1,0,5,2023-01-27T01:32:36.369Z
2023-01-27,8:30 AM,1,1,1,2,0,5,2023-01-27T14:36:36.924Z
2023-01-27,9:30 AM,1,1,2,0,0,4,2023-01-27T15:33:10.352Z
2023-01-27,10:30 AM,1,1,2,0,0,4,2023-01-27T16:29:46.678Z
2023-01-27,11:30 AM,2,0,3,0,4,9,2023-01-27T17:34:06.367Z
2023-01-27,12:30 PM,2,2,9,3,4,20,2023-01-27T18:50:18.076Z
2023-01-27,1:30 PM,4,2,4,1,4,15,2023-01-27T19:31:25.052Z
2023-01-27,2:30 PM,3,2,2,2,11,20,2023-01-27T20:33:56.547Z
2023-01-27,3:30 PM,3,1,3,2,2,11,2023-01-27T21:52:23.013Z
2023-01-27,4:30 PM,2,1,4,2,4,13,2023-01-27T22:30:07.179Z
2023-01-27,5:30 PM,1,1,4,0,4,10,2023-01-27T23:40:42.743Z
2023-01-28,9:30 AM,0,0,0,0,0,0,2023-01-28T15:54:35.518Z
2023-01-28,10:30 AM,1,0,0,0,0,1,2023-01-28T16:29:51.699Z
2023-01-28,11:30 AM,0,1,2,0,1,4,2023-01-28T17:26:41.582Z
2023-01-28,11:30 AM,2,1,2,0,3,8,2023-01-28T17:30:34.784Z
2023-01-28,12:30 PM,2,1,2,0,0,5,2023-01-28T18:28:15.711Z
2023-01-28,1:30 PM,3,1,1,0,7,12,2023-01-28T19:40:06.430Z
2023-01-28,2:30 PM,3,1,4,1,0,9,2023-01-28T20:35:58.198Z
2023-01-28,3:30 PM,2,2,4,0,1,9,2023-01-28T21:33:49.011Z
2023-01-28,4:30 PM,3,1,1,0,0,5,2023-01-28T22:37:19.384Z
2023-02-03,8:30 AM,1,2,0,0,0,3,2023-02-03T14:31:07.167Z
2023-02-03,9:30 AM,1,3,0,2,0,6,2023-02-03T15:30:01.626Z
2023-02-03,10:30 AM,3,2,0,3,0,8,2023-02-03T16:29:33.684Z
2023-02-03,11:30 AM,6,1,2,1,2,12,2023-02-03T17:29:52.135Z
2023-02-03,12:30 PM,12,2,4,6,3,27,2023-02-03T18:52:30.313Z
2023-02-03,1:30 PM,7,3,3,9,4,26,2023-02-03T19:36:21.929Z
2023-02-03,2:30 PM,4,2,1,4,0,11,2023-02-03T20:44:50.128Z
2023-02-03,3:30 PM,1,2,1,6,3,13,2023-02-03T21:50:57.987Z
2023-02-03,4:30 PM,2,1,1,3,2,9,2023-02-03T22:31:47.374Z
2023-02-03,5:30 PM,2,1,2,1,4,10,2023-02-03T23:32:02.031Z
2023-02-04,9:30 AM,0,0,0,0,0,0,2023-02-04T15:42:06.474Z
2023-02-04,10:30 AM,1,1,2,0,0,4,2023-02-04T16:29:16.806Z
2023-02-04,11:30 AM,2,1,1,0,0,4,2023-02-04T17:30:55.634Z
2023-02-04,12:30 PM,3,1,1,0,0,5,2023-02-04T18:30:50.754Z
2023-02-04,1:30 PM,2,1,5,0,0,8,2023-02-04T19:41:26.766Z
2023-02-04,2:30 PM,4,1,4,0,0,9,2023-02-04T20:32:21.706Z
2023-02-04,3:30 PM,3,0,3,0,1,7,2023-02-04T21:37:41.471Z
2023-02-04,4:30 PM,1,0,3,0,1,5,2023-02-04T22:38:54.656Z
2023-02-06,8:30 AM,1,3,1,0,0,5,2023-02-06T14:28:46.714Z
2023-02-06,9:30 AM,7,3,3,2,0,15,2023-02-06T15:30:47.761Z
2023-02-06,10:30 AM,10,4,6,1,0,21,2023-02-06T16:29:23.563Z
2023-02-06,11:30 AM,6,4,14,3,1,28,2023-02-06T17:28:32.384Z
2023-02-06,12:30 PM,15,4,12,2,0,33,2023-02-06T18:34:59.804Z
2023-02-06,1:30 PM,12,4,13,0,0,29,2023-02-06T19:42:24.301Z
2023-02-06,2:30 PM,11,7,13,2,4,37,2023-02-06T20:37:43.303Z
2023-02-06,3:30 PM,8,6,9,3,4,30,2023-02-06T21:33:44.647Z
2023-02-06,4:30 PM,8,4,9,5,6,32,2023-02-06T22:40:07.904Z
2023-02-06,5:30 PM,6,2,3,2,6,19,2023-02-07T00:09:58.764Z
2023-02-06,6:30 PM,4,1,3,2,4,14,2023-02-07T00:27:52.519Z
2023-02-06,6:30 PM,4,0,2,2,4,12,2023-02-07T00:34:56.588Z
2023-02-07,8:30 AM,0,1,0,0,0,1,2023-02-07T14:29:49.200Z
2023-02-07,9:30 AM,8,3,1,0,0,12,2023-02-07T15:35:28.770Z
2023-02-07,10:30 AM,7,3,7,1,0,18,2023-02-07T16:29:27.353Z
2023-02-07,11:30 AM,5,8,9,1,0,23,2023-02-07T17:35:13.185Z
2023-02-07,12:30 PM,10,7,12,3,1,33,2023-02-07T18:43:29.667Z
2023-02-07,1:30 PM,4,1,8,0,0,13,2023-02-07T19:52:36.702Z
2023-02-07,2:30 PM,8,3,5,2,2,20,2023-02-07T20:34:07.013Z
2023-02-07,3:30 PM,6,2,3,1,2,14,2023-02-07T21:41:41.822Z
2023-02-07,4:30 PM,4,2,4,6,5,21,2023-02-07T22:44:41.576Z
2023-02-07,5:30 PM,2,2,3,2,5,14,2023-02-07T23:34:01.723Z
2023-02-07,6:30 PM,0,1,1,0,3,5,2023-02-08T00:29:39.137Z
2023-02-07,7:30 PM,2,1,1,1,3,8,2023-02-08T01:34:37.971Z
2023-02-08,8:30 AM,2,1,1,0,0,4,2023-02-08T14:29:20.062Z
2023-02-08,9:30 AM,6,5,2,2,0,15,2023-02-08T15:32:46.715Z
2023-02-08,10:30 AM,8,6,6,1,0,21,2023-02-08T16:31:44.676Z
2023-02-08,11:30 AM,13,4,14,2,3,36,2023-02-08T17:33:20.424Z
2023-02-08,12:30 PM,13,8,22,2,2,47,2023-02-08T18:45:03.016Z
2023-02-08,1:30 PM,6,6,6,1,2,21,2023-02-08T19:32:19.237Z
2023-02-08,2:30 PM,9,2,7,2,1,21,2023-02-08T20:50:41.380Z
2023-02-08,3:30 PM,7,6,7,2,1,23,2023-02-08T21:47:47.517Z
2023-02-08,4:30 PM,10,3,6,1,5,25,2023-02-08T22:28:33.926Z
2023-02-08,5:30 PM,9,2,4,0,12,27,2023-02-08T23:39:30.400Z
2023-02-08,6:30 PM,2,1,1,0,7,11,2023-02-09T00:41:32.464Z
2023-02-08,7:30 PM,3,2,4,1,7,17,2023-02-09T01:31:00.914Z
2023-02-09,8:30 AM,2,0,1,1,0,4,2023-02-09T14:30:59.620Z
2023-02-09,9:30 AM,3,3,3,0,0,9,2023-02-09T15:29:14.510Z
2023-02-09,10:30 AM,3,4,4,0,0,11,2023-02-09T16:36:49.112Z
2023-02-09,11:30 AM,6,8,13,5,2,34,2023-02-09T17:36:45.569Z
2023-02-09,12:30 PM,9,5,23,3,5,45,2023-02-09T18:49:31.201Z
2023-02-09,1:30 PM,8,5,17,2,3,35,2023-02-09T19:37:02.259Z
2023-02-09,2:30 PM,11,3,10,0,3,27,2023-02-09T20:35:34.241Z
2023-02-09,3:30 PM,6,2,12,4,7,31,2023-02-09T21:35:31.634Z
2023-02-09,4:30 PM,3,2,10,5,5,25,2023-02-09T22:39:28.240Z
2023-02-09,5:30 PM,8,1,8,7,1,25,2023-02-09T23:37:26.333Z
2023-02-09,6:30 PM,4,1,5,4,5,19,2023-02-10T00:33:27.701Z
2023-02-09,7:30 PM,1,3,5,7,3,19,2023-02-10T01:32:09.572Z
2023-02-10,8:30 AM,1,1,0,0,0,2,2023-02-10T14:29:53.392Z
2023-02-10,9:30 AM,2,1,2,1,0,6,2023-02-10T15:29:20.679Z
2023-02-10,10:30 AM,2,1,1,1,0,5,2023-02-10T16:29:31.627Z
2023-02-10,11:30 AM,6,1,1,1,3,12,2023-02-10T17:38:18.485Z
2023-02-10,12:30 PM,4,1,2,1,5,13,2023-02-10T18:55:18.161Z
2023-02-10,1:30 PM,6,2,2,3,2,15,2023-02-10T19:32:45.833Z
2023-02-10,2:30 PM,4,2,2,4,0,12,2023-02-10T20:29:52.780Z
2023-02-10,3:30 PM,2,0,0,3,4,9,2023-02-10T21:43:01.273Z
2023-02-10,4:30 PM,1,0,1,1,4,7,2023-02-10T22:32:56.927Z
2023-02-10,5:30 PM,2,1,3,2,0,8,2023-02-10T23:36:27.798Z
2023-02-11,10:30 AM,0,1,3,1,0,5,2023-02-11T16:35:54.104Z
2023-02-11,11:30 AM,2,2,3,0,0,7,2023-02-11T17:32:46.344Z
2023-02-11,12:30 PM,1,1,7,0,1,10,2023-02-11T18:37:13.395Z
2023-02-11,1:30 PM,4,1,6,1,1,13,2023-02-11T19:38:18.999Z
2023-02-11,2:30 PM,5,4,8,1,5,23,2023-02-11T20:38:46.037Z
2023-02-11,3:30 PM,2,1,6,0,8,17,2023-02-11T21:40:32.734Z
2023-02-11,4:30 PM,4,1,0,0,10,15,2023-02-11T22:34:26.283Z
2023-02-13,8:30 AM,2,3,0,1,0,6,2023-02-13T14:29:05.004Z
2023-02-13,9:30 AM,8,4,3,0,0,15,2023-02-13T15:28:30.825Z
2023-02-13,10:30 AM,4,4,5,2,0,15,2023-02-13T16:28:56.135Z
2023-02-13,11:30 AM,10,5,14,3,7,39,2023-02-13T17:46:47.373Z
2023-02-13,1:30 PM,8,4,9,1,4,26,2023-02-13T19:42:50.633Z
2023-02-13,2:30 PM,6,3,9,0,1,19,2023-02-13T20:35:52.020Z
2023-02-13,3:30 PM,10,7,9,1,5,32,2023-02-13T21:30:55.900Z
2023-02-13,4:30 PM,7,1,7,11,7,33,2023-02-13T22:30:58.442Z
2023-02-13,5:30 PM,7,3,9,5,6,30,2023-02-13T23:39:19.403Z
2023-02-13,6:30 PM,5,0,6,4,0,15,2023-02-14T00:37:35.775Z
2023-02-13,7:30 PM,6,0,2,2,7,17,2023-02-14T01:36:12.878Z
2023-02-14,8:30 AM,1,1,0,1,0,3,2023-02-14T14:29:16.092Z
2023-02-14,9:30 AM,3,3,4,1,0,11,2023-02-14T15:29:32.154Z
2023-02-14,10:30 AM,5,1,6,2,0,14,2023-02-14T16:25:45.297Z
2023-02-14,11:30 AM,4,7,11,2,7,31,2023-02-14T17:43:36.611Z
2023-02-14,12:30 PM,9,8,22,4,2,45,2023-02-14T18:38:09.217Z
2023-02-14,1:30 PM,10,6,11,4,2,33,2023-02-14T19:37:47.528Z
2023-02-14,2:30 PM,2,4,7,4,0,17,2023-02-14T20:40:09.214Z
2023-02-14,3:30 PM,3,3,3,2,1,12,2023-02-14T21:46:09.929Z
2023-02-14,4:30 PM,5,4,2,1,1,13,2023-02-14T22:34:21.542Z
2023-02-14,5:30 PM,3,1,6,2,6,18,2023-02-14T23:44:27.542Z
2023-02-15,8:30 AM,3,3,0,0,0,6,2023-02-15T14:24:41.651Z
2023-02-15,9:30 AM,3,3,2,1,0,9,2023-02-15T15:32:11.715Z
2023-02-15,10:30 AM,4,5,9,0,0,18,2023-02-15T16:30:13.309Z
2023-02-15,11:30 AM,8,5,15,3,2,33,2023-02-15T17:35:40.645Z
2023-02-15,12:30 PM,14,6,22,3,1,46,2023-02-15T18:37:10.191Z
2023-02-15,1:30 PM,10,8,12,4,7,41,2023-02-15T19:36:39.355Z
2023-02-15,2:30 PM,12,1,15,3,5,36,2023-02-15T20:37:45.561Z
2023-02-15,3:30 PM,5,6,10,2,4,27,2023-02-15T21:36:24.677Z
2023-02-15,4:30 PM,11,3,5,5,10,34,2023-02-15T22:35:37.204Z
2023-02-15,5:30 PM,7,3,3,1,12,26,2023-02-15T23:37:37.627Z
2023-02-15,6:30 PM,7,0,2,1,5,15,2023-02-16T00:37:58.326Z
2023-02-16,8:30 AM,1,1,1,0,0,3,2023-02-16T14:28:50.044Z
2023-02-16,9:30 AM,5,2,3,1,0,11,2023-02-16T15:45:50.872Z
2023-02-16,10:30 AM,3,2,3,2,0,10,2023-02-16T16:29:02.978Z
2023-02-16,11:30 AM,8,3,12,2,11,36,2023-02-16T17:35:37.659Z
2023-02-16,12:30 PM,5,6,18,7,6,42,2023-02-16T18:37:23.618Z
2023-02-16,1:30 PM,4,4,11,3,2,24,2023-02-16T19:53:51.888Z
2023-02-16,2:30 PM,7,5,11,4,1,28,2023-02-16T20:35:37.354Z
2023-02-16,3:30 PM,6,2,5,4,8,25,2023-02-16T21:30:32.475Z
2023-02-16,4:30 PM,5,1,3,5,5,19,2023-02-16T22:38:40.079Z
2023-02-16,5:30 PM,4,1,5,7,9,26,2023-02-16T23:33:23.639Z
2023-02-16,6:30 PM,1,3,3,7,4,18,2023-02-17T00:40:09.714Z
2023-02-16,7:30 PM,1,3,3,3,3,13,2023-02-17T01:33:38.474Z
2023-02-17,8:30 AM,0,1,0,0,0,1,2023-02-17T14:30:26.465Z
2023-02-17,9:30 AM,0,2,0,0,0,2,2023-02-17T15:34:42.772Z
2023-02-17,10:30 AM,3,2,4,1,1,11,2023-02-17T16:34:46.674Z
2023-02-17,11:30 AM,4,1,4,1,4,14,2023-02-17T17:48:47.040Z
2023-02-17,12:30 PM,5,4,2,1,4,16,2023-02-17T18:34:32.855Z
2023-02-17,1:30 PM,6,2,4,1,1,14,2023-02-17T19:39:38.999Z
2023-02-17,2:30 PM,4,1,4,1,3,13,2023-02-17T20:41:30.060Z
2023-02-17,3:30 PM,5,2,5,1,3,16,2023-02-17T21:33:27.972Z
2023-02-17,4:30 PM,2,0,3,1,3,9,2023-02-18T00:05:50.866Z
2023-02-18,10:30 AM,0,1,3,0,0,4,2023-02-18T16:32:14.028Z
2023-02-18,11:30 AM,2,1,2,0,3,8,2023-02-18T17:33:08.275Z
2023-02-18,12:30 PM,5,1,2,0,3,11,2023-02-18T18:33:14.125Z
2023-02-18,2:30 PM,10,2,5,6,0,23,2023-02-18T20:38:09.155Z
2023-02-18,3:30 PM,7,0,3,2,0,12,2023-02-18T21:32:39.571Z
2023-02-20,8:30 AM,2,2,2,0,0,6,2023-02-20T14:29:46.622Z
2023-02-20,9:30 AM,5,6,5,2,0,18,2023-02-20T15:30:17.646Z
2023-02-20,10:30 AM,4,3,14,0,0,21,2023-02-20T16:31:31.626Z
2023-02-20,11:30 AM,4,4,10,1,4,23,2023-02-20T17:43:04.540Z
2023-02-20,12:30 PM,12,9,13,1,5,40,2023-02-20T19:35:54.513Z
2023-02-20,1:30 PM,7,3,9,1,3,23,2023-02-20T19:39:04.689Z
2023-02-20,2:30 PM,7,3,7,0,3,20,2023-02-20T20:49:17.135Z
2023-02-20,3:30 PM,6,6,12,0,3,27,2023-02-20T21:43:32.834Z
2023-02-20,4:30 PM,5,3,5,1,11,25,2023-02-20T22:31:50.003Z
2023-02-20,5:30 PM,2,3,6,3,10,24,2023-02-20T23:36:52.926Z
2023-02-20,6:30 PM,6,0,8,2,2,18,2023-02-21T00:32:56.660Z
2023-02-20,7:30 PM,4,2,12,3,3,24,2023-02-21T01:32:03.941Z
2023-02-21,8:30 AM,4,2,0,0,0,6,2023-02-21T14:28:52.072Z
2023-02-21,9:30 AM,5,4,3,1,0,13,2023-02-21T15:29:37.078Z
2023-02-21,10:30 AM,3,6,9,2,0,20,2023-02-21T16:39:34.848Z
2023-02-21,11:30 AM,6,6,12,4,0,28,2023-02-21T17:33:30.132Z
2023-02-21,12:30 PM,15,5,13,5,4,42,2023-02-21T18:38:22.399Z
2023-02-21,1:30 PM,9,2,5,4,4,24,2023-02-21T19:38:45.807Z
2023-02-21,2:30 PM,11,7,11,7,4,40,2023-02-21T20:42:22.916Z
2023-02-21,3:30 PM,3,7,6,5,1,22,2023-02-21T21:41:21.897Z
2023-02-21,4:30 PM,9,4,6,3,2,24,2023-02-21T22:55:18.009Z
2023-02-21,5:30 PM,3,0,9,1,4,17,2023-02-21T23:35:22.116Z
2023-02-22,8:30 AM,3,3,1,0,0,7,2023-02-22T14:31:17.099Z
2023-02-22,9:30 AM,8,4,2,2,0,16,2023-02-22T15:29:00.993Z
2023-02-22,10:30 AM,6,4,5,1,0,16,2023-02-22T16:24:51.234Z
2023-02-22,11:30 AM,8,3,10,1,1,23,2023-02-22T17:31:28.073Z
2023-02-22,12:30 PM,17,3,17,0,2,39,2023-02-22T18:37:06.942Z
2023-02-22,1:30 PM,8,11,7,0,2,28,2023-02-22T19:36:33.270Z
2023-02-22,2:30 PM,15,7,12,0,2,36,2023-02-22T20:36:04.414Z
2023-02-22,3:30 PM,9,7,13,3,1,33,2023-02-22T21:35:32.029Z
2023-02-22,4:30 PM,7,5,12,7,10,41,2023-02-22T22:47:09.767Z
2023-02-22,5:30 PM,9,2,3,3,7,24,2023-02-22T23:37:20.456Z
2023-02-22,6:30 PM,4,1,3,6,3,17,2023-02-23T00:40:05.755Z
2023-02-22,7:30 PM,3,1,7,3,3,17,2023-02-23T01:44:20.681Z
2023-02-22,8:30 PM,3,0,1,0,0,4,2023-02-23T02:37:03.657Z
2023-02-23,8:30 AM,1,0,1,0,0,2,2023-02-23T14:29:40.361Z
2023-02-23,9:30 AM,2,4,3,2,0,11,2023-02-23T15:31:18.586Z
2023-02-23,11:30 AM,10,3,9,1,4,27,2023-02-23T17:40:43.905Z
2023-02-23,12:30 PM,11,4,10,2,5,32,2023-02-23T18:32:18.483Z
2023-02-23,1:30 PM,8,3,8,2,6,27,2023-02-23T19:44:56.976Z
2023-02-23,2:30 PM,7,2,10,1,3,23,2023-02-23T20:58:37.608Z
2023-02-23,3:30 PM,8,1,9,3,1,22,2023-02-23T21:43:13.332Z
2023-02-23,4:30 PM,8,1,7,2,5,23,2023-02-23T22:45:03.053Z
2023-02-23,5:30 PM,6,3,7,2,7,25,2023-02-23T23:35:38.291Z
2023-02-23,6:30 PM,3,2,3,3,3,14,2023-02-24T00:40:26.402Z
2023-02-23,7:30 PM,2,0,1,1,1,5,2023-02-24T01:35:31.785Z
2023-02-24,8:30 AM,1,1,2,0,0,4,2023-02-24T14:28:22.058Z
2023-02-24,9:30 AM,3,2,2,1,0,8,2023-02-24T15:29:10.308Z
2023-02-24,10:30 AM,3,3,6,3,6,21,2023-02-24T16:31:46.128Z
2023-02-24,11:30 AM,6,4,8,2,5,25,2023-02-24T17:36:49.232Z
2023-02-24,12:30 PM,9,2,6,1,2,20,2023-02-24T18:39:17.444Z
2023-02-24,1:30 PM,7,3,8,1,2,21,2023-02-24T19:45:00.165Z
2023-02-24,2:30 PM,4,0,5,2,3,14,2023-02-24T20:50:53.009Z
2023-02-24,3:30 PM,4,2,6,1,6,19,2023-02-24T21:32:50.227Z
2023-02-25,2:30 PM,2,1,5,0,1,9,2023-02-25T20:18:43.179Z
2023-02-25,3:30 PM,2,0,5,1,0,8,2023-02-25T21:32:51.878Z
2023-02-25,4:30 PM,2,0,2,1,0,5,2023-02-25T22:44:02.612Z
2023-02-27,8:30 AM,2,6,0,1,0,9,2023-02-27T14:28:39.328Z
2023-02-27,9:30 AM,5,5,0,2,0,12,2023-02-27T15:28:08.848Z
2023-02-27,10:30 AM,2,5,9,2,0,18,2023-02-27T16:32:39.841Z
2023-02-27,11:30 AM,21,5,15,1,2,44,2023-02-27T17:53:02.604Z
2023-02-27,12:30 PM,22,7,20,3,2,54,2023-02-27T18:44:08.389Z
2023-02-27,1:30 PM,16,2,13,3,3,37,2023-02-27T19:38:16.500Z
2023-02-27,2:30 PM,7,5,9,3,5,29,2023-02-27T20:51:49.681Z
2023-02-27,3:30 PM,19,3,5,2,6,35,2023-02-27T21:38:54.576Z
2023-02-27,4:30 PM,7,3,11,3,4,28,2023-02-27T22:40:21.643Z
2023-02-27,5:30 PM,3,4,7,4,3,21,2023-02-27T23:35:35.935Z
2023-02-27,6:30 PM,3,1,5,3,4,16,2023-02-28T00:45:17.943Z
2023-02-27,7:30 PM,16,1,4,2,1,24,2023-02-28T01:34:36.768Z
2023-02-27,8:30 PM,3,0,1,2,0,6,2023-02-28T02:26:28.859Z
2023-02-28,8:30 AM,1,1,1,1,0,4,2023-02-28T14:29:08.036Z
2023-02-28,9:30 AM,4,2,8,1,0,15,2023-02-28T15:30:49.464Z
2023-02-28,10:30 AM,4,4,13,2,0,23,2023-02-28T16:33:34.916Z
2023-02-28,11:30 AM,10,6,10,2,4,32,2023-02-28T17:37:58.510Z
2023-02-28,12:30 PM,12,7,12,2,5,38,2023-02-28T18:31:26.988Z
2023-02-28,1:30 PM,7,5,6,1,9,28,2023-02-28T19:40:20.565Z
2023-02-28,2:30 PM,4,8,7,4,4,27,2023-02-28T20:33:57.763Z
2023-02-28,3:30 PM,5,3,6,3,3,20,2023-02-28T21:41:12.579Z
2023-02-28,4:30 PM,5,2,6,1,3,17,2023-02-28T22:31:05.651Z
2023-02-28,5:30 PM,3,4,5,3,3,18,2023-02-28T23:44:57.110Z
2023-02-28,7:30 PM,0,1,3,4,2,10,2023-03-01T01:40:44.947Z
2023-03-01,8:30 AM,1,2,1,0,0,4,2023-03-01T14:34:32.863Z
2023-03-01,9:30 AM,5,4,2,1,0,12,2023-03-01T15:28:30.900Z
2023-03-01,10:30 AM,10,3,8,0,0,21,2023-03-01T16:28:43.544Z
2023-03-01,11:30 AM,4,4,10,2,0,20,2023-03-01T17:34:50.386Z
2023-03-01,12:30 PM,11,8,18,2,0,39,2023-03-01T18:32:32.980Z
2023-03-01,1:30 PM,4,6,14,4,0,28,2023-03-01T19:31:59.538Z
2023-03-01,2:30 PM,6,4,11,1,0,22,2023-03-01T20:38:24.409Z
2023-03-01,3:30 PM,9,4,16,4,0,33,2023-03-01T21:33:35.363Z
2023-03-01,4:30 PM,3,3,9,1,4,20,2023-03-01T22:38:40.320Z
2023-03-01,5:30 PM,8,2,4,5,1,20,2023-03-01T23:41:48.760Z
2023-03-01,6:30 PM,5,3,5,2,3,18,2023-03-02T00:47:47.337Z
2023-03-01,7:30 PM,4,0,5,0,2,11,2023-03-02T01:32:34.960Z
2023-03-02,8:30 AM,0,0,1,0,0,1,2023-03-02T14:29:43.411Z
2023-03-02,9:30 AM,1,0,2,1,0,4,2023-03-02T15:29:25.122Z
2023-03-02,10:30 AM,5,2,4,2,0,13,2023-03-02T16:29:05.622Z
2023-03-02,11:30 AM,5,4,7,0,0,16,2023-03-02T17:33:12.274Z
2023-03-02,12:30 PM,6,4,10,3,0,23,2023-03-02T18:36:19.885Z
2023-03-02,1:30 PM,3,1,11,1,0,16,2023-03-02T19:30:49.954Z
2023-03-02,2:30 PM,7,3,3,4,0,17,2023-03-02T20:35:08.561Z
2023-03-02,3:30 PM,4,0,3,0,1,8,2023-03-02T21:31:24.775Z
2023-03-02,4:30 PM,2,3,1,1,5,12,2023-03-02T22:32:57.509Z
2023-03-02,5:30 PM,5,4,4,4,9,26,2023-03-02T23:41:15.118Z
2023-03-02,6:30 PM,3,3,3,5,7,21,2023-03-03T00:35:16.806Z
2023-03-03,8:30 AM,2,1,1,0,0,4,2023-03-03T14:28:38.940Z
2023-03-03,9:30 AM,4,4,1,1,0,10,2023-03-03T15:29:21.453Z
2023-03-03,10:30 AM,10,1,2,0,2,15,2023-03-03T16:32:11.142Z
2023-03-03,11:30 AM,7,1,4,2,2,16,2023-03-03T17:35:17.257Z
2023-03-03,12:30 PM,7,2,1,2,0,12,2023-03-03T18:37:43.636Z
2023-03-03,1:30 PM,6,2,2,2,3,15,2023-03-03T19:30:04.128Z
2023-03-03,2:30 PM,4,1,5,3,7,20,2023-03-03T20:31:11.133Z
2023-03-03,3:30 PM,4,0,7,3,0,14,2023-03-03T21:33:53.987Z
2023-03-03,4:30 PM,1,0,7,3,0,11,2023-03-03T22:33:33.923Z
2023-03-03,5:30 PM,1,1,2,2,0,6,2023-03-03T23:33:21.394Z
2023-03-04,10:30 AM,1,0,1,0,0,2,2023-03-04T16:33:10.002Z
2023-03-04,11:30 AM,1,0,2,1,0,4,2023-03-04T17:33:33.900Z
2023-03-04,12:30 PM,1,1,2,1,1,6,2023-03-04T18:34:20.052Z
2023-03-04,1:30 PM,2,2,2,0,0,6,2023-03-04T19:32:54.522Z
2023-03-04,3:30 PM,2,2,3,3,0,10,2023-03-04T21:34:14.249Z
2023-03-04,4:30 PM,0,1,0,2,0,3,2023-03-04T22:42:44.151Z
2023-03-06,9:30 AM,4,4,2,2,0,12,2023-03-06T15:32:02.822Z
2023-03-06,10:30 AM,8,4,7,2,0,21,2023-03-06T16:34:44.774Z
2023-03-06,11:30 AM,11,1,10,0,4,26,2023-03-06T17:35:51.003Z
2023-03-06,12:30 PM,10,4,11,0,4,29,2023-03-06T18:43:01.047Z
2023-03-06,1:30 PM,4,5,15,0,6,30,2023-03-06T19:43:43.682Z
2023-03-06,2:30 PM,4,3,11,2,5,25,2023-03-06T20:46:16.996Z
2023-03-06,3:30 PM,7,6,7,1,2,23,2023-03-06T21:32:51.628Z
2023-03-06,4:30 PM,3,2,5,2,1,13,2023-03-06T22:34:10.190Z
2023-03-06,5:30 PM,11,2,3,2,3,21,2023-03-06T23:38:19.436Z
2023-03-06,6:30 PM,8,1,2,3,6,20,2023-03-07T00:33:21.866Z
2023-03-06,7:30 PM,3,1,1,3,6,14,2023-03-07T01:35:47.889Z
2023-03-07,8:30 AM,0,2,1,1,0,4,2023-03-07T14:35:38.340Z
2023-03-07,9:30 AM,5,2,2,1,0,10,2023-03-07T15:29:03.863Z
2023-03-07,10:30 AM,3,2,6,2,0,13,2023-03-07T16:30:09.726Z
2023-03-07,11:30 AM,10,3,9,3,2,27,2023-03-07T17:49:26.749Z
2023-03-07,12:30 PM,19,4,10,3,11,47,2023-03-07T18:44:05.499Z
2023-03-07,1:30 PM,10,5,11,1,6,33,2023-03-07T19:41:18.090Z
2023-03-07,2:30 PM,14,5,5,0,6,30,2023-03-07T20:40:24.509Z
2023-03-07,3:30 PM,5,3,6,2,2,18,2023-03-07T21:41:31.943Z
2023-03-07,4:30 PM,6,2,3,1,6,18,2023-03-07T22:38:06.097Z
2023-03-07,5:30 PM,7,1,8,6,3,25,2023-03-07T23:33:20.872Z
2023-03-07,6:30 PM,3,1,4,4,1,13,2023-03-08T00:30:34.213Z
2023-03-07,7:30 PM,1,0,5,4,2,12,2023-03-08T01:34:57.981Z
2023-03-08,8:30 AM,4,5,5,1,0,15,2023-03-08T14:29:36.673Z
2023-03-08,9:30 AM,5,5,12,3,0,25,2023-03-08T15:29:40.833Z
2023-03-08,10:30 AM,4,3,13,3,0,23,2023-03-08T16:31:57.724Z
2023-03-08,11:30 AM,8,7,14,0,5,34,2023-03-08T17:45:53.432Z
2023-03-08,12:30 PM,13,9,17,1,0,40,2023-03-08T18:29:34.198Z
2023-03-08,1:30 PM,7,4,11,2,0,24,2023-03-08T19:31:47.517Z
2023-03-08,2:30 PM,3,4,15,2,0,24,2023-03-08T20:31:49.400Z
2023-03-08,3:30 PM,3,4,15,0,5,27,2023-03-08T21:37:32.663Z
2023-03-08,4:30 PM,7,3,6,1,2,19,2023-03-08T22:29:15.929Z
2023-03-08,5:30 PM,2,1,3,0,6,12,2023-03-08T23:44:42.373Z
2023-03-08,6:30 PM,1,1,2,4,3,11,2023-03-09T00:28:03.382Z
2023-03-08,7:30 PM,3,4,2,2,5,16,2023-03-09T01:32:22.177Z
2023-03-09,8:30 AM,1,0,2,0,0,3,2023-03-09T14:29:15.658Z
2023-03-09,10:30 AM,2,5,10,2,0,19,2023-03-09T16:29:46.519Z
2023-03-09,11:30 AM,6,6,11,3,0,26,2023-03-09T17:31:04.204Z
2023-03-09,12:30 PM,4,4,11,4,0,23,2023-03-09T18:32:49.791Z
2023-03-09,1:30 PM,7,5,5,3,0,20,2023-03-09T19:31:32.154Z
2023-03-09,2:30 PM,1,6,7,2,0,16,2023-03-09T20:30:09.541Z
2023-03-09,3:30 PM,1,1,6,2,2,12,2023-03-09T21:35:17.855Z
2023-03-09,4:30 PM,2,0,5,4,7,18,2023-03-09T22:48:31.067Z
2023-03-09,5:30 PM,3,4,7,7,7,28,2023-03-09T23:34:03.468Z
2023-03-09,6:30 PM,4,0,2,4,5,15,2023-03-10T00:32:03.108Z
2023-03-09,7:30 PM,2,0,4,5,2,13,2023-03-10T01:40:43.122Z
2023-03-10,8:30 AM,1,2,2,0,0,5,2023-03-10T14:29:28.997Z
2023-03-10,9:30 AM,1,1,3,0,0,5,2023-03-10T15:27:29.409Z
2023-03-10,10:30 AM,1,2,5,0,3,11,2023-03-10T16:45:52.271Z
2023-03-10,11:30 AM,3,2,3,1,4,13,2023-03-10T17:41:40.057Z
2023-03-10,12:30 PM,5,3,3,1,2,14,2023-03-10T18:48:18.674Z
2023-03-10,1:30 PM,7,1,5,1,1,15,2023-03-10T19:47:29.576Z
2023-03-10,2:30 PM,2,0,3,2,0,7,2023-03-10T20:31:47.217Z
2023-03-10,3:30 PM,2,0,3,5,0,10,2023-03-10T21:32:17.916Z
2023-03-10,4:30 PM,2,1,1,4,0,8,2023-03-10T22:31:46.857Z
2023-03-10,5:30 PM,0,1,1,2,0,4,2023-03-10T23:31:41.096Z
2023-03-11,10:30 AM,3,0,0,0,0,3,2023-03-11T16:31:49.868Z
2023-03-11,11:30 AM,3,0,0,0,0,3,2023-03-11T17:33:00.872Z
2023-03-11,12:30 PM,3,2,0,0,0,5,2023-03-11T18:31:23.829Z
2023-03-11,2:30 PM,1,2,3,3,0,9,2023-03-11T20:42:55.795Z
2023-03-11,3:30 PM,2,2,0,1,0,5,2023-03-11T21:40:45.756Z
2023-03-11,4:30 PM,2,1,2,0,0,5,2023-03-11T22:35:06.982Z
2023-03-13,8:30 AM,3,1,1,0,0,5,2023-03-15T20:33:52.194Z
2023-03-13,12:30 PM,3,2,1,0,2,8,2023-03-15T20:34:56.677Z
2023-03-13,4:30 PM,4,1,3,1,1,10,2023-03-15T20:35:30.212Z
2023-03-14,8:30 AM,3,2,1,0,1,7,2023-03-15T20:36:02.430Z
2023-03-14,12:30 PM,3,1,6,1,0,11,2023-03-15T20:37:50.114Z
2023-03-14,4:30 PM,2,5,1,0,0,8,2023-03-15T20:38:12.001Z
2023-03-15,2:30 PM,2,1,4,0,0,7,2023-03-15T19:30:39.919Z
2023-03-15,3:30 PM,2,0,0,0,1,3,2023-03-15T20:31:41.256Z
2023-03-15,12:30 PM,5,2,6,1,0,14,2023-03-15T20:36:42.758Z
2023-03-15,8:30 AM,3,1,5,0,0,9,2023-03-15T20:38:57.905Z
2023-03-15,4:30 PM,0,1,1,0,0,2,2023-03-15T21:33:53.124Z
2023-03-15,5:30 PM,0,1,1,0,1,3,2023-03-15T22:30:52.437Z
2023-03-16,9:30 AM,3,0,3,0,0,6,2023-03-16T14:30:33.637Z
2023-03-16,11:30 AM,1,0,2,0,0,3,2023-03-16T16:36:35.614Z
2023-03-16,2:30 PM,2,1,1,2,0,6,2023-03-16T19:32:11.052Z
2023-03-16,3:30 PM,5,1,1,0,0,7,2023-03-16T20:30:04.872Z
2023-03-16,4:30 PM,2,1,1,0,0,4,2023-03-16T21:32:32.305Z
2023-03-17,8:30 AM,2,0,0,0,2,4,2023-03-17T13:40:19.841Z
2023-03-17,9:30 AM,2,0,0,0,2,4,2023-03-17T14:33:57.615Z
2023-03-17,2:30 PM,1,0,0,0,0,1,2023-03-17T19:27:51.691Z
2023-03-17,3:30 PM,0,0,1,0,0,1,2023-03-17T20:36:16.897Z
2023-03-20,8:30 AM,3,3,2,1,0,9,2023-03-20T13:31:24.487Z
2023-03-20,9:30 AM,4,5,5,0,0,14,2023-03-20T14:30:36.201Z
2023-03-20,10:30 AM,6,3,8,2,0,19,2023-03-20T15:34:08.384Z
2023-03-20,11:30 AM,23,3,11,6,2,45,2023-03-20T16:36:47.518Z
2023-03-20,12:30 PM,11,5,7,2,3,28,2023-03-20T17:24:18.721Z
2023-03-20,1:30 PM,4,2,6,1,2,15,2023-03-20T18:37:05.611Z
2023-03-20,2:30 PM,6,1,7,0,0,14,2023-03-20T19:43:30.167Z
2023-03-20,3:30 PM,4,4,8,0,2,18,2023-03-20T20:34:00.459Z
2023-03-20,4:30 PM,4,0,5,3,2,14,2023-03-20T21:30:49.240Z
2023-03-20,5:30 PM,7,1,1,4,2,15,2023-03-20T22:48:54.038Z
2023-03-20,6:30 PM,3,1,8,3,6,21,2023-03-20T23:42:21.982Z
2023-03-20,7:30 PM,4,0,5,3,6,18,2023-03-21T00:30:50.114Z
2023-03-21,8:30 AM,1,0,1,0,0,2,2023-03-21T13:30:09.311Z
2023-03-21,9:30 AM,3,2,5,3,0,13,2023-03-21T14:32:44.664Z
2023-03-21,10:30 AM,5,3,7,3,0,18,2023-03-21T15:29:14.109Z
2023-03-21,11:30 AM,7,4,8,1,3,23,2023-03-21T16:35:40.651Z
2023-03-21,12:30 PM,9,6,18,1,3,37,2023-03-21T17:30:06.848Z
2023-03-21,1:30 PM,3,8,9,2,2,24,2023-03-21T18:40:25.353Z
2023-03-21,2:30 PM,7,6,12,4,2,31,2023-03-21T19:44:46.140Z
2023-03-21,3:30 PM,8,7,10,5,3,33,2023-03-21T20:46:27.173Z
2023-03-21,4:30 PM,5,3,3,2,7,20,2023-03-21T21:34:34.783Z
2023-03-21,5:30 PM,2,3,7,6,3,21,2023-03-21T22:40:40.007Z
2023-03-22,8:30 AM,1,1,2,1,0,5,2023-03-22T13:29:22.500Z
2023-03-22,9:30 AM,5,4,5,1,0,15,2023-03-22T14:29:29.715Z
2023-03-22,10:30 AM,8,6,7,7,0,28,2023-03-22T15:29:16.074Z
2023-03-22,11:30 AM,3,4,6,1,0,14,2023-03-22T16:34:51.413Z
2023-03-22,12:30 PM,8,6,13,0,0,27,2023-03-22T17:38:11.345Z
2023-03-22,1:30 PM,8,4,13,0,0,25,2023-03-22T18:32:58.040Z
2023-03-22,2:30 PM,5,5,7,1,0,18,2023-03-22T19:33:05.051Z
2023-03-22,3:30 PM,11,6,8,2,5,32,2023-03-22T20:40:54.888Z
2023-03-22,4:30 PM,10,4,5,3,4,26,2023-03-22T21:45:17.798Z
2023-03-22,5:30 PM,8,1,5,3,3,20,2023-03-22T22:34:14.575Z
2023-03-22,6:30 PM,6,1,2,0,3,12,2023-03-22T23:34:05.690Z
2023-03-22,7:30 PM,4,1,5,1,0,11,2023-03-23T00:28:49.297Z
2023-03-23,8:30 AM,1,0,1,0,0,2,2023-03-23T13:29:38.987Z
2023-03-23,9:30 AM,0,2,2,1,0,5,2023-03-23T14:29:33.552Z
2023-03-23,10:30 AM,3,4,3,1,0,11,2023-03-23T15:47:50.287Z
2023-03-23,11:30 AM,10,4,9,0,4,27,2023-03-23T16:39:13.621Z
2023-03-23,12:30 PM,15,4,8,3,0,30,2023-03-23T17:29:42.568Z
2023-03-23,1:30 PM,7,5,9,2,0,23,2023-03-23T18:30:47.904Z
2023-03-23,2:30 PM,7,4,8,1,0,20,2023-03-23T19:31:48.160Z
2023-03-23,3:30 PM,3,4,4,0,7,18,2023-03-23T20:53:46.388Z
2023-03-23,4:30 PM,5,3,3,3,6,20,2023-03-23T21:27:44.317Z
2023-03-23,5:30 PM,5,1,3,3,2,14,2023-03-23T22:49:30.076Z
2023-03-23,6:30 PM,5,0,0,2,3,10,2023-03-23T23:37:20.676Z
2023-03-24,8:30 AM,0,1,1,1,0,3,2023-03-24T13:29:07.427Z
2023-03-24,9:30 AM,0,1,2,1,0,4,2023-03-24T14:28:52.126Z
2023-03-24,10:30 AM,5,0,5,1,4,15,2023-03-24T15:40:38.801Z
2023-03-24,11:30 AM,8,3,8,2,4,25,2023-03-24T16:42:31.531Z
2023-03-24,12:30 PM,5,1,11,2,10,29,2023-03-24T17:45:59.104Z
2023-03-24,1:30 PM,1,1,8,4,5,19,2023-03-24T18:40:03.851Z
2023-03-24,2:30 PM,4,2,3,3,0,12,2023-03-24T19:31:41.404Z
2023-03-24,3:30 PM,2,1,5,3,0,11,2023-03-24T20:30:57.158Z
2023-03-24,4:30 PM,2,2,2,3,0,9,2023-03-24T21:32:03.205Z
2023-03-24,5:30 PM,3,2,2,0,0,7,2023-03-24T22:31:11.468Z
2023-03-24,6:30 PM,0,1,0,1,0,2,2023-03-24T23:33:34.775Z
2023-03-25,10:30 AM,2,0,1,0,0,3,2023-03-25T15:30:58.060Z
2023-03-25,11:30 AM,1,0,2,0,0,3,2023-03-25T16:34:21.370Z
2023-03-25,12:30 PM,2,0,1,1,0,4,2023-03-25T17:37:14.835Z
2023-03-25,1:30 PM,1,1,1,1,1,5,2023-03-25T18:31:39.628Z
2023-03-25,2:30 PM,3,2,3,1,0,9,2023-03-25T19:35:30.222Z
2023-03-25,3:30 PM,6,1,2,1,0,10,2023-03-25T20:34:59.566Z
2023-03-25,4:30 PM,4,1,1,1,0,7,2023-03-25T21:31:13.124Z
2023-03-27,8:30 AM,3,1,1,2,0,7,2023-03-27T13:34:49.577Z
2023-03-27,9:30 AM,4,4,2,1,0,11,2023-03-27T14:42:23.904Z
2023-03-27,10:30 AM,4,1,5,1,0,11,2023-03-27T15:41:33.966Z
2023-03-27,11:30 AM,8,4,11,4,2,29,2023-03-27T16:37:38.594Z
2023-03-27,12:30 PM,15,1,13,4,1,34,2023-03-27T17:33:32.389Z
2023-03-27,1:30 PM,6,2,9,1,1,19,2023-03-27T18:35:47.213Z
2023-03-27,2:30 PM,6,3,9,1,6,25,2023-03-27T19:41:57.716Z
2023-03-27,3:30 PM,9,5,13,1,5,33,2023-03-27T20:28:50.281Z
2023-03-27,4:30 PM,3,4,8,0,5,20,2023-03-27T21:40:02.096Z
2023-03-27,5:30 PM,5,4,6,6,3,24,2023-03-27T22:43:36.411Z
2023-03-27,6:30 PM,2,3,4,5,1,15,2023-03-27T23:41:48.690Z
2023-03-27,7:30 PM,2,2,2,5,1,12,2023-03-28T00:43:54.649Z
2023-03-28,8:30 AM,2,2,3,1,0,8,2023-03-28T13:29:28.558Z
2023-03-28,9:30 AM,3,1,3,0,0,7,2023-03-28T14:30:12.504Z
2023-03-28,10:30 AM,3,2,8,0,0,13,2023-03-28T15:33:22.118Z
2023-03-28,11:30 AM,1,4,7,1,4,17,2023-03-28T16:33:01.283Z
2023-03-28,12:30 PM,8,6,16,3,4,37,2023-03-28T17:37:50.449Z
2023-03-28,1:30 PM,8,4,8,2,9,31,2023-03-28T19:01:57.365Z
2023-03-28,2:30 PM,12,7,8,4,4,35,2023-03-28T19:35:35.805Z
2023-03-28,6:30 PM,3,2,2,3,0,10,2023-03-28T23:36:35.689Z
2023-03-28,7:30 PM,5,3,2,2,0,12,2023-03-29T00:36:56.666Z
2023-03-29,8:30 AM,3,2,2,1,0,8,2023-03-29T13:27:58.710Z
2023-03-29,9:30 AM,3,3,4,0,0,10,2023-03-29T14:36:16.521Z
2023-03-29,10:30 AM,6,6,8,1,0,21,2023-03-29T15:31:03.544Z
2023-03-29,11:30 AM,7,6,15,5,0,33,2023-03-29T16:33:39.571Z
2023-03-29,12:30 PM,6,7,12,2,0,27,2023-03-29T17:33:31.618Z
2023-03-29,1:30 PM,22,5,4,3,1,35,2023-03-29T18:36:05.408Z
2023-03-29,2:30 PM,8,3,6,3,0,20,2023-03-29T19:30:20.612Z
2023-03-29,3:30 PM,16,6,10,0,3,35,2023-03-29T20:39:24.283Z
2023-03-29,4:30 PM,8,4,10,0,2,24,2023-03-29T21:34:47.741Z
2023-03-29,5:30 PM,8,3,6,5,3,25,2023-03-29T22:37:08.157Z
2023-03-29,6:30 PM,4,3,5,4,2,18,2023-03-29T23:43:07.469Z
2023-03-29,7:30 PM,6,0,1,0,0,7,2023-03-30T00:38:58.397Z
2023-03-30,8:30 AM,2,2,1,1,0,6,2023-03-30T13:32:45.479Z
2023-03-30,9:30 AM,6,2,0,0,0,8,2023-03-30T14:30:16.211Z
2023-03-30,10:30 AM,7,2,6,1,0,16,2023-03-30T15:29:52.532Z
2023-03-30,11:30 AM,6,4,8,2,0,20,2023-03-30T16:29:12.546Z
2023-03-30,12:30 PM,5,4,13,2,0,24,2023-03-30T17:32:58.188Z
2023-03-30,1:30 PM,4,3,5,1,0,13,2023-03-30T18:30:15.903Z
2023-03-30,2:30 PM,6,4,9,1,0,20,2023-03-30T19:31:30.069Z
2023-03-30,3:30 PM,4,3,8,1,5,21,2023-03-30T20:35:56.901Z
2023-03-30,4:30 PM,8,3,6,1,6,24,2023-03-30T21:42:00.768Z
2023-03-30,5:30 PM,2,2,4,3,3,14,2023-03-30T22:39:02.726Z
2023-03-30,6:30 PM,4,1,1,2,2,10,2023-03-30T23:46:03.954Z
2023-03-31,8:30 AM,1,1,0,0,0,2,2023-03-31T13:31:07.503Z
2023-03-31,9:30 AM,3,2,3,0,0,8,2023-03-31T14:30:02.489Z
2023-03-31,10:30 AM,2,2,4,0,4,12,2023-03-31T15:36:00.195Z
2023-03-31,11:30 AM,4,2,7,0,1,14,2023-03-31T16:58:30.222Z
2023-03-31,12:30 PM,7,3,5,0,0,15,2023-03-31T17:42:42.878Z
2023-03-31,1:30 PM,3,4,4,0,5,16,2023-03-31T18:41:54.205Z
2023-03-31,2:30 PM,3,3,3,2,0,11,2023-03-31T19:29:21.857Z
2023-03-31,3:30 PM,6,3,4,2,0,15,2023-03-31T20:32:40.426Z
2023-03-31,4:30 PM,5,2,3,1,0,11,2023-03-31T21:34:14.544Z
2023-03-31,5:30 PM,3,1,2,0,0,6,2023-03-31T22:31:38.682Z
2023-03-31,6:30 PM,3,1,2,0,0,6,2023-03-31T23:31:56.419Z
2023-04-01,10:30 AM,0,0,3,2,0,5,2023-04-01T15:29:56.591Z
2023-04-01,11:30 AM,1,1,4,1,0,7,2023-04-01T16:31:19.683Z
2023-04-01,12:30 PM,4,2,5,1,0,12,2023-04-01T17:31:40.804Z
2023-04-01,1:30 PM,2,2,4,2,0,10,2023-04-01T18:31:04.456Z
2023-04-01,2:30 PM,3,3,9,1,0,16,2023-04-01T19:54:22.617Z
2023-04-01,3:30 PM,4,2,6,3,0,15,2023-04-01T20:29:48.957Z
2023-04-01,4:30 PM,3,2,1,0,0,6,2023-04-01T21:29:46.235Z
2023-04-03,8:30 AM,4,4,4,1,0,13,2023-04-03T13:31:14.380Z
2023-04-03,10:30 AM,5,4,6,3,0,18,2023-04-03T15:28:12.649Z
2023-04-03,11:30 AM,21,2,12,7,3,45,2023-04-03T16:42:23.587Z
2023-04-03,12:30 PM,15,4,16,2,3,40,2023-04-03T17:32:04.655Z
2023-04-03,1:30 PM,11,4,8,3,4,30,2023-04-03T18:38:47.668Z
2023-04-03,2:30 PM,10,3,10,1,2,26,2023-04-03T19:43:26.908Z
2023-04-03,3:30 PM,13,4,5,6,4,32,2023-04-03T20:31:00.976Z
2023-04-03,4:30 PM,5,5,9,1,2,22,2023-04-03T21:35:03.555Z
2023-04-03,5:30 PM,8,0,7,6,4,25,2023-04-03T22:42:32.007Z
2023-04-03,6:30 PM,4,2,6,6,3,21,2023-04-03T23:34:14.440Z
2023-04-03,7:30 PM,13,2,3,4,2,24,2023-04-04T00:29:32.801Z
2023-04-04,8:30 AM,2,0,1,0,0,3,2023-04-04T13:30:24.082Z
2023-04-04,9:30 AM,5,0,3,2,0,10,2023-04-04T14:31:31.359Z
2023-04-04,10:30 AM,4,2,6,3,0,15,2023-04-04T15:24:31.122Z
2023-04-04,11:30 AM,20,4,6,3,13,46,2023-04-04T16:36:19.386Z
2023-04-04,12:30 PM,13,5,16,3,9,46,2023-04-04T17:32:13.370Z
2023-04-04,1:30 PM,12,7,11,8,10,48,2023-04-04T18:30:44.548Z
2023-04-04,2:30 PM,4,7,13,2,9,35,2023-04-04T19:45:27.886Z
2023-04-04,3:30 PM,8,3,5,6,4,26,2023-04-04T20:33:10.528Z
2023-04-04,5:30 PM,7,2,5,5,1,20,2023-04-04T22:41:38.864Z
2023-04-04,6:30 PM,3,2,3,2,0,10,2023-04-04T23:41:09.315Z
2023-04-05,8:30 AM,2,3,0,1,0,6,2023-04-05T13:29:51.125Z
2023-04-05,9:30 AM,3,2,5,0,0,10,2023-04-05T14:31:26.246Z
2023-04-05,11:30 AM,6,8,12,1,0,27,2023-04-05T16:30:59.168Z
2023-04-05,12:30 PM,12,6,12,13,0,43,2023-04-05T17:31:01.099Z
2023-04-05,1:30 PM,8,10,7,16,1,42,2023-04-05T18:31:18.662Z
2023-04-05,2:30 PM,8,4,8,0,1,21,2023-04-05T19:32:36.935Z
2023-04-05,3:30 PM,11,3,6,11,0,31,2023-04-05T20:37:37.084Z
2023-04-05,4:30 PM,8,4,6,0,4,22,2023-04-05T21:35:24.352Z
2023-04-05,5:30 PM,8,3,5,5,7,28,2023-04-05T22:43:13.945Z
2023-04-05,6:30 PM,5,4,2,3,1,15,2023-04-05T23:49:01.417Z
2023-04-05,7:30 PM,8,1,3,0,0,12,2023-04-06T00:48:17.029Z
2023-04-06,8:30 AM,0,3,1,0,0,4,2023-04-06T13:29:10.483Z
2023-04-06,9:30 AM,3,2,2,1,0,8,2023-04-06T14:29:37.968Z
2023-04-06,10:30 AM,7,6,8,1,0,22,2023-04-06T15:30:50.585Z
2023-04-06,11:30 AM,10,4,8,5,0,27,2023-04-06T16:34:59.330Z
2023-04-06,12:30 PM,7,7,9,4,0,27,2023-04-06T17:30:35.617Z
2023-04-06,1:30 PM,6,3,5,2,0,16,2023-04-06T18:34:16.733Z
2023-04-06,2:30 PM,11,6,4,3,0,24,2023-04-06T19:30:29.490Z
2023-04-06,3:30 PM,4,1,7,1,11,24,2023-04-06T20:53:30.900Z
2023-04-06,4:30 PM,3,0,2,4,10,19,2023-04-06T21:30:21.570Z
2023-04-06,5:30 PM,2,1,1,4,4,12,2023-04-06T22:36:01.185Z
2023-04-06,6:30 PM,3,0,0,7,5,15,2023-04-06T23:36:19.858Z
2023-04-07,8:30 AM,0,1,1,1,0,3,2023-04-07T13:29:00.888Z
2023-04-07,9:30 AM,1,1,2,1,0,5,2023-04-07T14:31:39.291Z
2023-04-07,10:30 AM,5,0,2,6,6,19,2023-04-07T15:54:26.059Z
2023-04-07,11:30 AM,3,1,4,4,5,17,2023-04-07T16:43:57.815Z
2023-04-07,12:30 PM,3,1,2,0,6,12,2023-04-07T17:40:57.501Z
2023-04-07,1:30 PM,4,1,2,3,3,13,2023-04-07T18:41:02.303Z
2023-04-07,2:30 PM,5,2,4,1,0,12,2023-04-07T19:30:47.264Z
2023-04-07,3:30 PM,3,2,3,0,0,8,2023-04-07T20:31:26.177Z
2023-04-07,4:30 PM,8,0,4,0,0,12,2023-04-07T21:31:57.684Z
2023-04-07,5:30 PM,5,0,2,0,0,7,2023-04-07T22:31:30.971Z
2023-04-07,6:30 PM,2,0,1,0,0,3,2023-04-07T23:31:28.134Z
2023-04-08,10:30 AM,3,1,2,0,0,6,2023-04-08T15:33:06.440Z
2023-04-08,11:30 AM,3,1,4,0,0,8,2023-04-08T16:31:36.441Z
2023-04-08,12:30 PM,4,1,2,0,0,7,2023-04-08T17:30:54.526Z
2023-04-08,1:30 PM,3,0,5,0,0,8,2023-04-08T18:31:50.871Z
2023-04-08,2:30 PM,2,1,3,0,0,6,2023-04-08T19:40:38.993Z
2023-04-08,3:30 PM,1,0,3,1,0,5,2023-04-08T20:35:29.500Z
2023-04-08,4:30 PM,4,1,0,0,0,5,2023-04-08T21:40:09.036Z
2023-04-10,8:30 AM,2,2,2,1,0,7,2023-04-10T13:29:22.587Z
2023-04-10,9:30 AM,4,8,5,0,0,17,2023-04-10T14:30:24.060Z
2023-04-10,10:30 AM,4,4,8,2,0,18,2023-04-10T15:29:06.448Z
2023-04-10,11:30 AM,21,3,10,16,3,53,2023-04-10T16:38:47.072Z
2023-04-10,12:30 PM,14,5,16,2,2,39,2023-04-10T17:38:48.792Z
2023-04-10,1:30 PM,15,3,9,11,1,39,2023-04-10T18:41:29.874Z
2023-04-10,2:30 PM,11,4,10,2,5,32,2023-04-10T19:26:07.026Z
2023-04-10,3:30 PM,16,6,11,13,6,52,2023-04-10T20:38:41.392Z
2023-04-10,4:30 PM,3,3,20,5,5,36,2023-04-10T21:31:13.859Z
2023-04-10,5:30 PM,8,2,7,5,6,28,2023-04-10T22:33:01.811Z
2023-04-10,6:30 PM,3,1,4,6,4,18,2023-04-10T23:51:12.557Z
2023-04-10,7:30 PM,4,0,2,6,2,14,2023-04-11T00:31:41.174Z
2023-04-11,8:30 AM,1,1,0,0,0,2,2023-04-11T13:29:53.796Z
2023-04-11,9:30 AM,5,6,3,3,0,17,2023-04-11T14:28:33.738Z
2023-04-11,10:30 AM,4,3,10,3,0,20,2023-04-11T15:30:33.284Z
2023-04-11,11:30 AM,5,3,8,4,8,28,2023-04-11T16:35:36.822Z
2023-04-11,12:30 PM,8,7,14,10,11,50,2023-04-11T17:31:28.141Z
2023-04-11,1:30 PM,11,4,13,3,14,45,2023-04-11T18:40:21.579Z
2023-04-11,2:30 PM,7,4,10,11,7,39,2023-04-11T19:42:56.429Z
2023-04-11,3:30 PM,4,3,7,4,7,25,2023-04-11T20:31:57.876Z
2023-04-11,4:30 PM,1,4,4,5,3,17,2023-04-11T21:52:19.585Z
2023-04-11,5:30 PM,3,3,6,8,3,23,2023-04-11T22:36:36.420Z
2023-04-11,6:30 PM,1,2,5,6,1,15,2023-04-11T23:31:13.775Z
2023-04-12,8:30 AM,1,4,0,1,0,6,2023-04-12T13:29:16.564Z
2023-04-12,9:30 AM,9,7,4,0,0,20,2023-04-12T14:29:00.597Z
2023-04-12,10:30 AM,9,8,9,4,0,30,2023-04-12T15:31:15.267Z
2023-04-12,11:30 AM,6,7,11,2,4,30,2023-04-12T16:43:11.167Z
2023-04-12,12:30 PM,8,10,10,2,0,30,2023-04-12T17:35:41.019Z
2023-04-12,1:30 PM,8,6,11,1,0,26,2023-04-12T18:30:55.884Z
2023-04-12,2:30 PM,7,4,11,2,0,24,2023-04-12T19:30:39.378Z
2023-04-12,3:30 PM,5,5,6,1,5,22,2023-04-12T20:42:28.418Z
2023-04-12,4:30 PM,3,1,4,7,4,19,2023-04-12T21:44:00.203Z
2023-04-12,5:30 PM,2,0,7,5,3,17,2023-04-12T22:47:37.701Z
2023-04-12,6:30 PM,1,1,5,6,2,15,2023-04-12T23:27:12.529Z
2023-04-12,7:30 PM,3,1,5,2,2,13,2023-04-13T00:42:22.210Z
2023-04-13,9:30 AM,6,2,4,1,1,14,2023-04-13T14:37:07.617Z
2023-04-13,10:30 AM,4,3,5,1,4,17,2023-04-13T15:33:39.370Z
2023-04-13,11:30 AM,6,2,6,5,0,19,2023-04-13T16:32:29.181Z
2023-04-13,12:30 PM,6,3,13,7,0,29,2023-04-13T17:36:07.899Z
2023-04-13,1:30 PM,5,2,8,4,6,25,2023-04-13T18:37:04.655Z
2023-04-13,2:30 PM,6,1,14,3,0,24,2023-04-13T19:33:22.472Z
2023-04-13,3:30 PM,10,1,4,13,14,42,2023-04-13T20:43:25.666Z
2023-04-13,4:30 PM,8,2,4,2,5,21,2023-04-13T21:34:55.626Z
2023-04-13,5:30 PM,4,3,6,3,8,24,2023-04-13T22:36:32.821Z
2023-04-13,6:30 PM,3,2,3,3,8,19,2023-04-13T23:31:50.494Z
2023-04-14,8:30 AM,0,1,0,0,0,1,2023-04-14T13:29:33.555Z
2023-04-14,9:30 AM,1,1,2,1,0,5,2023-04-14T14:33:42.101Z
2023-04-14,10:30 AM,2,0,4,1,3,10,2023-04-14T15:39:00.619Z
2023-04-14,11:30 AM,3,1,2,0,3,9,2023-04-14T16:46:59.050Z
2023-04-14,12:30 PM,6,2,5,0,2,15,2023-04-14T17:36:36.719Z
2023-04-14,1:30 PM,3,2,5,1,2,13,2023-04-14T18:43:41.790Z
2023-04-14,2:30 PM,3,1,6,1,0,11,2023-04-14T19:30:46.793Z
2023-04-14,3:30 PM,1,1,4,1,0,7,2023-04-14T20:32:23.898Z
2023-04-14,4:30 PM,6,0,6,0,0,12,2023-04-14T21:33:12.899Z
2023-04-14,5:30 PM,5,0,5,2,0,12,2023-04-14T22:32:13.169Z
2023-04-15,10:30 AM,1,0,3,1,0,5,2023-04-15T15:32:09.819Z
2023-04-15,11:30 AM,1,0,4,2,0,7,2023-04-15T16:34:13.350Z
2023-04-15,12:30 PM,1,0,6,3,0,10,2023-04-15T17:35:50.434Z
2023-04-15,1:30 PM,1,1,6,3,0,11,2023-04-15T18:32:07.827Z
2023-04-15,2:30 PM,5,0,4,2,0,11,2023-04-15T19:33:28.011Z
2023-04-15,3:30 PM,4,0,2,0,0,6,2023-04-15T20:53:35.994Z
2023-04-15,4:30 PM,4,0,1,1,0,6,2023-04-15T21:41:57.360Z
2023-04-17,8:30 AM,4,2,3,0,0,9,2023-04-17T13:27:28.434Z
2023-04-17,9:30 AM,7,4,1,0,0,12,2023-04-17T14:36:36.544Z
2023-04-17,10:30 AM,9,2,3,0,0,14,2023-04-17T15:49:53.888Z
2023-04-17,11:30 AM,19,4,6,1,3,33,2023-04-17T16:32:27.340Z
2023-04-17,12:30 PM,12,2,12,4,4,34,2023-04-17T17:33:55.095Z
2023-04-17,1:30 PM,21,4,8,3,2,38,2023-04-17T18:32:07.390Z
2023-04-17,2:30 PM,9,3,8,0,4,24,2023-04-17T19:39:56.989Z
2023-04-17,3:30 PM,13,2,6,0,3,24,2023-04-17T20:41:20.723Z
2023-04-17,4:30 PM,3,5,2,1,2,13,2023-04-17T21:33:10.106Z
2023-04-17,5:30 PM,3,3,6,1,1,14,2023-04-17T22:39:42.655Z
2023-04-17,6:30 PM,1,1,2,0,4,8,2023-04-17T23:39:51.388Z
2023-04-17,7:30 PM,1,0,2,1,4,8,2023-04-18T00:38:04.677Z
2023-04-18,8:30 AM,0,1,1,1,0,3,2023-04-18T13:29:10.785Z
2023-04-18,9:30 AM,4,2,0,1,0,7,2023-04-18T14:29:23.126Z
2023-04-18,10:30 AM,3,3,6,1,0,13,2023-04-18T15:31:07.402Z
2023-04-18,11:30 AM,10,4,6,1,3,24,2023-04-18T16:40:21.894Z
2023-04-18,12:30 PM,10,4,12,5,2,33,2023-04-18T17:41:33.569Z
2023-04-18,1:30 PM,7,2,9,5,2,25,2023-04-18T18:38:03.948Z
2023-04-18,2:30 PM,6,2,9,0,1,18,2023-04-18T19:42:49.663Z
2023-04-18,3:30 PM,9,2,5,5,9,30,2023-04-18T20:36:03.762Z
2023-04-18,4:30 PM,3,7,2,7,7,26,2023-04-18T21:40:43.592Z
2023-04-18,5:30 PM,3,2,8,0,1,14,2023-04-18T22:37:27.477Z
2023-04-18,6:30 PM,5,1,3,0,2,11,2023-04-18T23:37:00.176Z
2023-04-19,8:30 AM,0,2,0,1,0,3,2023-04-19T13:30:31.363Z
2023-04-19,9:30 AM,3,2,3,1,0,9,2023-04-19T14:31:20.260Z
2023-04-19,10:30 AM,5,6,8,0,0,19,2023-04-19T15:36:29.272Z
2023-04-19,11:30 AM,12,5,8,1,0,26,2023-04-19T16:32:14.059Z
2023-04-19,12:30 PM,15,8,11,3,0,37,2023-04-19T17:33:01.650Z
2023-04-19,1:30 PM,7,6,11,1,0,25,2023-04-19T18:32:20.338Z
2023-04-19,2:30 PM,7,5,7,1,0,20,2023-04-19T19:30:47.680Z
2023-04-19,3:30 PM,4,4,9,2,4,23,2023-04-19T20:34:56.042Z
2023-04-19,4:30 PM,5,1,5,4,8,23,2023-04-19T21:35:05.720Z
2023-04-19,5:30 PM,6,0,4,4,6,20,2023-04-19T22:35:29.032Z
2023-04-19,6:30 PM,3,1,1,3,1,9,2023-04-19T23:54:15.257Z
2023-04-19,7:30 PM,3,2,3,5,2,15,2023-04-20T00:37:34.215Z
2023-04-20,8:30 AM,0,2,2,1,0,5,2023-04-20T13:32:39.474Z
2023-04-20,9:30 AM,2,1,0,1,0,4,2023-04-20T14:29:09.931Z
2023-04-20,10:30 AM,4,4,1,2,0,11,2023-04-20T15:29:20.730Z
2023-04-20,11:30 AM,8,5,12,4,0,29,2023-04-20T16:32:50.144Z
2023-04-20,12:30 PM,10,3,13,7,0,33,2023-04-20T17:29:58.615Z
2023-04-20,1:30 PM,3,5,12,8,0,28,2023-04-20T18:33:01.812Z
2023-04-20,2:30 PM,3,4,4,5,0,16,2023-04-20T19:28:56.907Z
2023-04-20,3:30 PM,3,3,6,5,11,28,2023-04-20T20:48:10.960Z
2023-04-20,4:30 PM,4,2,7,4,8,25,2023-04-20T21:40:05.084Z
2023-04-20,5:30 PM,4,1,1,2,2,10,2023-04-20T22:54:59.179Z
2023-04-20,6:30 PM,3,2,4,3,0,12,2023-04-20T23:52:27.894Z
2023-04-21,8:30 AM,2,2,0,1,0,5,2023-04-21T13:28:56.204Z
2023-04-21,9:30 AM,3,1,3,1,0,8,2023-04-21T14:31:06.730Z
2023-04-21,10:30 AM,5,2,3,0,0,10,2023-04-21T15:48:22.098Z
2023-04-21,12:30 PM,5,0,5,2,0,12,2023-04-21T17:55:41.390Z
2023-04-21,1:30 PM,2,2,5,4,0,13,2023-04-21T18:42:04.467Z
2023-04-21,2:30 PM,0,2,6,3,0,11,2023-04-21T19:34:10.083Z
2023-04-21,3:30 PM,2,1,4,1,0,8,2023-04-21T20:30:03.248Z
2023-04-21,4:30 PM,3,1,5,2,0,11,2023-04-21T21:34:29.290Z
2023-04-21,5:30 PM,4,0,3,2,0,9,2023-04-21T22:32:25.600Z
2023-04-21,6:30 PM,2,0,3,2,0,7,2023-04-21T23:30:52.873Z
2023-04-22,10:30 AM,0,0,0,1,0,1,2023-04-22T15:30:50.640Z
2023-04-22,11:30 AM,2,0,0,0,0,2,2023-04-22T16:32:40.736Z
2023-04-22,12:30 PM,2,0,4,3,0,9,2023-04-22T17:34:06.785Z
2023-04-22,1:30 PM,3,0,3,3,0,9,2023-04-22T18:51:00.321Z
2023-04-22,2:30 PM,2,0,3,0,0,5,2023-04-22T19:48:50.045Z
2023-04-22,3:30 PM,0,0,3,1,0,4,2023-04-22T20:48:56.387Z
2023-04-22,4:30 PM,2,1,1,0,0,4,2023-04-22T21:49:39.393Z
2023-04-24,8:30 AM,4,3,1,0,0,8,2023-04-24T13:33:53.379Z
2023-04-24,9:30 AM,7,3,7,0,0,17,2023-04-24T14:34:34.158Z
2023-04-24,11:30 AM,7,3,5,2,2,19,2023-04-24T16:49:52.524Z
2023-04-24,12:30 PM,10,3,9,1,3,26,2023-04-24T17:32:51.486Z
2023-04-24,1:30 PM,12,6,8,8,13,47,2023-04-24T18:37:58.910Z
2023-04-24,2:30 PM,16,7,8,3,9,43,2023-04-24T19:37:50.203Z
2023-04-24,3:30 PM,8,6,13,3,4,34,2023-04-24T20:50:47.535Z
2023-04-24,4:30 PM,9,6,10,6,4,35,2023-04-24T21:40:29.047Z
2023-04-24,5:30 PM,5,3,5,1,4,18,2023-04-24T22:49:04.929Z
2023-04-24,6:30 PM,14,3,6,2,10,35,2023-04-24T23:43:29.481Z
2023-04-25,8:30 AM,1,0,3,0,0,4,2023-04-25T13:30:07.582Z
2023-04-25,9:30 AM,3,4,4,1,1,13,2023-04-25T14:31:29.561Z
2023-04-25,10:30 AM,1,3,8,0,0,12,2023-04-25T15:30:05.871Z
2023-04-25,11:30 AM,4,5,11,2,4,26,2023-04-25T16:37:04.758Z
2023-04-25,12:30 PM,6,5,14,6,5,36,2023-04-25T17:54:30.214Z
2023-04-25,1:30 PM,6,5,5,3,4,23,2023-04-25T18:37:55.753Z
2023-04-25,2:30 PM,9,4,10,3,6,32,2023-04-25T19:44:53.510Z
2023-04-25,3:30 PM,2,3,10,3,2,20,2023-04-25T20:43:48.428Z
2023-04-25,4:30 PM,3,0,6,4,3,16,2023-04-25T21:35:02.744Z
2023-04-25,5:30 PM,3,2,6,1,5,17,2023-04-25T22:45:47.754Z
2023-04-25,6:30 PM,2,3,5,0,2,12,2023-04-25T23:43:15.239Z
2023-04-26,8:30 AM,0,1,2,2,0,5,2023-04-26T13:30:21.058Z
2023-04-26,9:30 AM,5,4,3,2,0,14,2023-04-26T14:29:21.179Z
2023-04-26,11:30 AM,9,6,5,3,5,28,2023-04-26T16:41:15.330Z
2023-04-26,12:30 PM,16,7,8,1,6,38,2023-04-26T17:43:17.182Z
2023-04-26,1:30 PM,7,5,10,2,7,31,2023-04-26T18:33:05.429Z
2023-04-26,2:30 PM,7,4,6,5,5,27,2023-04-26T19:29:40.247Z
2023-04-26,3:30 PM,6,5,9,5,1,26,2023-04-26T20:32:54.476Z
2023-04-26,4:30 PM,7,0,12,5,6,30,2023-04-26T21:44:20.306Z
2023-04-26,5:30 PM,8,3,4,3,5,23,2023-04-26T22:37:53.294Z
2023-04-26,6:30 PM,3,3,3,8,1,18,2023-04-26T23:33:43.318Z
2023-04-26,7:30 PM,3,2,3,5,0,13,2023-04-27T00:41:09.208Z
2023-04-27,8:30 AM,1,1,1,0,0,3,2023-04-27T13:29:32.342Z
2023-04-27,9:30 AM,2,2,4,0,0,8,2023-04-27T14:30:08.491Z
2023-04-27,10:30 AM,5,2,5,0,0,12,2023-04-27T15:29:51.473Z
2023-04-27,11:30 AM,5,3,5,3,0,16,2023-04-27T16:30:39.880Z
2023-04-27,12:30 PM,5,3,5,5,0,18,2023-04-27T17:35:29.088Z
2023-04-27,1:30 PM,10,4,3,2,0,19,2023-04-27T18:38:57.582Z
2023-04-27,2:30 PM,6,2,6,1,0,15,2023-04-27T19:37:29.760Z
2023-04-27,3:30 PM,5,0,4,4,2,15,2023-04-27T20:43:25.624Z
2023-04-27,4:30 PM,6,0,0,6,5,17,2023-04-27T21:40:14.552Z
2023-04-27,5:30 PM,5,1,3,7,7,23,2023-04-27T22:41:28.718Z
2023-04-27,6:30 PM,1,1,2,3,5,12,2023-04-27T23:36:18.703Z
2023-04-28,8:30 AM,2,1,0,0,0,3,2023-04-28T13:29:43.957Z
2023-04-28,9:30 AM,4,3,1,1,0,9,2023-04-28T14:30:56.692Z
2023-04-28,10:30 AM,4,1,1,0,8,14,2023-04-28T15:38:32.025Z
2023-04-28,11:30 AM,3,1,5,0,7,16,2023-04-28T16:36:13.153Z
2023-04-28,12:30 PM,4,2,4,0,7,17,2023-04-28T17:48:04.594Z
2023-04-28,1:30 PM,4,2,3,0,2,11,2023-04-28T18:34:09.790Z
2023-04-28,2:30 PM,1,3,5,0,1,10,2023-04-28T19:44:29.144Z
2023-04-28,4:30 PM,3,1,1,0,4,9,2023-04-28T21:37:44.159Z
2023-04-28,5:30 PM,1,1,2,0,4,8,2023-04-28T22:31:43.244Z
2023-04-29,10:30 AM,2,0,2,2,0,6,2023-04-29T15:41:36.757Z
2023-04-29,11:30 AM,2,0,4,2,0,8,2023-04-29T16:40:28.967Z
2023-04-29,12:30 PM,4,1,6,2,0,13,2023-04-29T17:35:26.676Z
2023-04-29,1:30 PM,3,1,4,1,0,9,2023-04-29T18:39:35.334Z
2023-04-29,2:30 PM,2,1,6,1,0,10,2023-04-29T19:31:08.615Z
2023-04-29,3:30 PM,3,0,4,2,0,9,2023-04-29T20:30:47.657Z
2023-04-29,4:30 PM,4,2,1,2,0,9,2023-04-29T21:47:04.934Z
2023-05-01,8:30 AM,4,1,0,3,0,8,2023-05-01T13:33:22.906Z
2023-05-01,9:30 AM,4,8,5,1,0,18,2023-05-01T14:28:26.611Z
2023-05-01,10:30 AM,6,6,5,4,0,21,2023-05-01T15:31:20.720Z
2023-05-01,11:30 AM,13,3,13,6,1,36,2023-05-01T16:25:03.724Z
2023-05-01,12:30 PM,19,4,11,1,6,41,2023-05-01T17:43:08.503Z
2023-05-01,1:30 PM,8,2,7,7,13,37,2023-05-01T18:38:43.994Z
2023-05-01,2:30 PM,7,3,9,3,12,34,2023-05-01T19:35:42.287Z
2023-05-01,3:30 PM,9,2,10,2,6,29,2023-05-01T20:32:47.896Z
2023-05-01,4:30 PM,10,3,5,0,1,19,2023-05-01T21:42:13.455Z
2023-05-01,5:30 PM,8,4,4,8,1,25,2023-05-01T22:43:25.209Z
2023-05-01,6:30 PM,5,3,2,7,0,17,2023-05-01T23:45:10.117Z
2023-05-01,7:30 PM,5,1,2,3,0,11,2023-05-02T00:36:34.601Z
2023-05-02,8:30 AM,2,0,0,0,0,2,2023-05-02T13:28:27.094Z
2023-05-02,9:30 AM,1,4,2,0,0,7,2023-05-02T14:34:38.016Z
2023-05-02,10:30 AM,1,6,9,0,0,16,2023-05-02T15:30:04.646Z
2023-05-02,11:30 AM,12,4,11,3,1,31,2023-05-02T16:35:07.630Z
2023-05-02,12:30 PM,8,5,19,5,8,45,2023-05-02T17:39:14.006Z
2023-05-02,1:30 PM,5,4,12,4,4,29,2023-05-02T18:33:08.729Z
2023-05-02,2:30 PM,4,5,10,5,7,31,2023-05-02T19:39:53.472Z
2023-05-02,3:30 PM,5,2,7,6,9,29,2023-05-02T20:46:08.068Z
2023-05-02,4:30 PM,6,2,9,6,1,24,2023-05-02T21:46:48.542Z
2023-05-02,5:30 PM,7,1,5,5,2,20,2023-05-02T22:41:34.162Z
2023-05-02,6:30 PM,4,1,3,4,2,14,2023-05-02T23:43:19.502Z
2023-05-03,8:30 AM,3,2,1,0,0,6,2023-05-03T13:29:58.687Z
2023-05-03,9:30 AM,3,3,6,2,0,14,2023-05-03T14:29:41.446Z
2023-05-03,11:30 AM,9,5,7,5,0,26,2023-05-03T16:31:07.318Z
2023-05-03,12:30 PM,6,8,17,2,0,33,2023-05-03T17:30:42.768Z
2023-05-03,1:30 PM,4,5,14,6,0,29,2023-05-03T18:32:08.052Z
2023-05-03,2:30 PM,5,4,7,8,0,24,2023-05-03T19:32:21.426Z
2023-05-03,3:30 PM,7,4,5,4,6,26,2023-05-03T20:41:33.357Z
2023-05-03,4:30 PM,9,2,4,2,6,23,2023-05-03T21:45:37.456Z
2023-05-03,5:30 PM,7,5,5,3,4,24,2023-05-03T22:33:08.715Z
2023-05-03,6:30 PM,1,1,6,6,0,14,2023-05-03T23:50:19.197Z
2023-05-03,7:30 PM,2,0,1,3,0,6,2023-05-04T00:59:11.683Z
2023-05-04,8:30 AM,2,2,1,0,0,5,2023-05-04T13:31:44.053Z
2023-05-04,9:30 AM,2,1,3,0,0,6,2023-05-04T14:29:12.611Z
2023-05-04,11:30 AM,5,6,6,0,8,25,2023-05-04T16:45:18.408Z
2023-05-04,12:30 PM,9,7,8,1,0,25,2023-05-04T17:29:58.108Z
2023-05-04,1:30 PM,11,2,3,2,0,18,2023-05-04T18:36:28.530Z
2023-05-04,2:30 PM,7,4,3,0,0,14,2023-05-04T19:31:48.507Z
2023-05-04,3:30 PM,7,3,2,9,7,28,2023-05-04T20:45:28.808Z
2023-05-04,4:30 PM,3,2,5,7,6,23,2023-05-04T21:53:04.418Z
2023-05-04,5:30 PM,5,3,4,7,3,22,2023-05-04T22:36:00.631Z
2023-05-04,6:30 PM,3,1,5,2,0,11,2023-05-04T23:36:43.384Z
2023-05-05,7:30 AM,0,0,0,0,0,0,2023-05-05T13:00:15.386Z
2023-05-05,8:30 AM,2,0,0,0,1,3,2023-05-05T13:38:37.042Z
2023-05-05,9:30 AM,3,1,0,0,1,5,2023-05-05T14:33:15.717Z
2023-05-05,10:30 AM,6,1,1,0,0,8,2023-05-05T15:36:14.444Z
2023-05-05,11:30 AM,4,1,2,0,3,10,2023-05-05T16:38:39.693Z
2023-05-05,12:30 PM,3,2,0,0,3,8,2023-05-05T17:37:01.271Z
2023-05-05,1:30 PM,0,1,2,1,0,4,2023-05-05T18:43:20.137Z
2023-05-05,2:30 PM,1,2,2,1,0,6,2023-05-05T19:31:02.920Z
2023-05-05,3:30 PM,3,0,2,1,0,6,2023-05-05T20:32:44.883Z
2023-05-05,4:30 PM,4,2,0,2,0,8,2023-05-05T21:32:25.649Z
2023-05-05,5:30 PM,2,2,2,2,0,8,2023-05-05T22:31:54.059Z
2023-05-05,6:30 PM,2,2,2,0,0,6,2023-05-05T23:32:03.198Z
2023-05-06,10:30 AM,0,0,1,0,0,1,2023-05-06T15:30:22.019Z
2023-05-06,11:30 AM,2,0,3,1,0,6,2023-05-06T16:30:37.736Z
2023-05-06,12:30 PM,4,1,3,1,0,9,2023-05-06T17:33:12.152Z
2023-05-06,1:30 PM,3,1,5,1,0,10,2023-05-06T18:30:47.615Z
2023-05-06,2:30 PM,1,1,2,1,0,5,2023-05-06T19:44:46.435Z
2023-05-06,3:30 PM,2,1,2,1,0,6,2023-05-06T20:53:22.592Z
2023-05-06,4:30 PM,1,0,1,0,0,2,2023-05-06T21:54:24.290Z
2023-05-08,9:30 AM,11,2,4,1,6,24,2023-05-08T14:44:29.182Z
2023-05-08,10:30 AM,11,5,6,2,7,31,2023-05-08T15:42:58.874Z
2023-05-08,11:30 AM,6,6,8,2,5,27,2023-05-08T16:33:02.800Z
2023-05-08,12:30 PM,8,6,5,9,3,31,2023-05-08T17:42:21.604Z
2023-05-08,1:30 PM,8,5,10,3,4,30,2023-05-08T18:41:23.771Z
2023-05-08,2:30 PM,9,6,4,2,9,30,2023-05-08T19:37:05.830Z
2023-05-08,3:30 PM,10,5,9,3,6,33,2023-05-08T20:37:20.104Z
2023-05-08,4:30 PM,5,4,4,2,5,20,2023-05-08T21:40:06.630Z
2023-05-08,5:30 PM,9,6,5,6,3,29,2023-05-08T22:46:54.043Z
2023-05-08,6:30 PM,16,3,6,5,0,30,2023-05-08T23:43:29.471Z
2023-05-09,8:30 AM,3,0,1,0,1,5,2023-05-09T13:36:32.236Z
2023-05-09,9:30 AM,6,2,2,0,3,13,2023-05-09T14:48:58.867Z
2023-05-09,10:30 AM,6,3,3,1,6,19,2023-05-09T15:45:52.381Z
2023-05-09,11:30 AM,4,5,8,12,5,34,2023-05-09T16:46:26.901Z
2023-05-09,12:30 PM,3,6,10,8,6,33,2023-05-09T17:34:48.764Z
2023-05-09,1:30 PM,8,5,12,4,5,34,2023-05-09T19:20:42.629Z
2023-05-09,2:30 PM,8,2,5,5,8,28,2023-05-09T19:35:37.344Z
2023-05-09,3:30 PM,6,3,9,10,5,33,2023-05-09T20:34:40.596Z
2023-05-09,4:30 PM,6,1,5,5,3,20,2023-05-09T21:39:19.525Z
2023-05-09,5:30 PM,8,3,3,0,6,20,2023-05-09T22:36:27.251Z
2023-05-09,6:30 PM,6,3,4,3,3,19,2023-05-09T23:50:32.435Z
2023-05-10,7:30 AM,0,0,0,0,0,0,2023-05-10T13:46:52.652Z
2023-05-10,8:30 AM,6,1,2,0,1,10,2023-05-10T13:50:49.389Z
2023-05-10,9:30 AM,6,3,5,3,6,23,2023-05-10T14:32:48.139Z
2023-05-10,10:30 AM,12,4,4,5,6,31,2023-05-10T15:49:09.319Z
2023-05-10,11:30 AM,4,5,5,3,0,17,2023-05-10T17:34:42.242Z
2023-05-10,12:30 PM,8,5,7,5,0,25,2023-05-10T17:35:11.554Z
2023-05-10,1:30 PM,9,7,6,1,0,23,2023-05-10T18:33:27.449Z
2023-05-10,2:30 PM,7,5,7,1,0,20,2023-05-10T19:37:10.625Z
2023-05-10,3:30 PM,7,2,7,2,6,24,2023-05-10T20:39:35.783Z
2023-05-10,4:30 PM,5,1,6,3,3,18,2023-05-10T21:42:02.125Z
2023-05-10,5:30 PM,3,1,3,3,8,18,2023-05-10T22:37:26.761Z
2023-05-10,6:30 PM,5,2,3,4,4,18,2023-05-10T23:37:46.915Z
2023-05-10,7:30 PM,3,2,4,4,2,15,2023-05-11T00:40:23.866Z
2023-05-11,8:30 AM,0,2,2,0,0,4,2023-05-11T13:30:13.894Z
2023-05-11,10:30 AM,4,6,6,1,0,17,2023-05-11T15:28:50.849Z
2023-05-11,11:30 AM,3,3,10,1,0,17,2023-05-11T16:42:26.084Z
2023-05-11,12:30 PM,3,3,4,2,0,12,2023-05-11T17:31:46.919Z
2023-05-11,1:30 PM,8,4,1,0,0,13,2023-05-11T18:32:16.645Z
2023-05-11,2:30 PM,7,4,2,3,0,16,2023-05-11T19:38:40.123Z
2023-05-11,3:30 PM,3,2,4,2,1,12,2023-05-11T20:57:42.059Z
2023-05-11,4:30 PM,5,3,4,3,0,15,2023-05-11T21:50:34.956Z
2023-05-11,5:30 PM,4,3,4,2,0,13,2023-05-11T22:44:53.321Z
2023-05-11,6:30 PM,2,2,3,6,0,13,2023-05-11T23:27:55.268Z
2023-05-12,8:30 AM,0,2,0,0,0,2,2023-05-12T13:34:29.333Z
2023-05-12,9:30 AM,3,2,2,0,0,7,2023-05-12T14:28:30.006Z
2023-05-12,10:30 AM,5,0,3,2,0,10,2023-05-12T15:39:09.745Z
2023-05-12,11:30 AM,3,1,3,0,0,7,2023-05-12T16:45:44.203Z
2023-05-12,12:30 PM,5,1,2,0,0,8,2023-05-12T17:41:29.020Z
2023-05-12,1:30 PM,4,2,3,0,0,9,2023-05-12T18:40:35.641Z
2023-05-12,2:30 PM,4,2,3,0,0,9,2023-05-12T19:31:10.344Z
2023-05-12,3:30 PM,3,1,1,1,0,6,2023-05-12T20:31:37.478Z
2023-05-12,4:30 PM,3,0,2,0,0,5,2023-05-12T21:34:29.009Z
2023-05-12,5:30 PM,3,0,1,0,0,4,2023-05-12T22:52:12.039Z
2023-05-13,10:30 AM,1,0,1,1,0,3,2023-05-13T15:31:58.287Z
2023-05-13,11:30 AM,2,0,1,0,0,3,2023-05-13T16:33:10.276Z
2023-05-13,12:30 PM,1,0,2,0,0,3,2023-05-13T17:33:48.171Z
2023-05-13,1:30 PM,2,1,0,0,0,3,2023-05-13T18:41:23.894Z
2023-05-13,2:30 PM,2,0,1,0,0,3,2023-05-13T19:49:50.805Z
2023-05-13,3:30 PM,3,0,2,0,0,5,2023-05-13T20:42:56.127Z
2023-05-13,4:30 PM,2,0,1,0,0,3,2023-05-13T21:38:00.801Z
2023-05-15,8:30 AM,0,1,0,0,0,1,2023-05-15T13:34:11.111Z
2023-05-15,9:30 AM,1,1,1,0,0,3,2023-05-15T14:31:02.992Z
2023-05-15,10:30 AM,1,0,3,0,0,4,2023-05-15T15:40:22.565Z
2023-05-15,11:30 AM,1,0,2,0,0,3,2023-05-15T16:41:34.142Z
2023-05-15,12:30 PM,2,0,3,0,0,5,2023-05-15T17:37:27.072Z
2023-05-15,1:30 PM,2,1,2,0,0,5,2023-05-15T18:44:00.414Z
2023-05-15,2:30 PM,0,3,1,0,0,4,2023-05-15T19:46:49.486Z
2023-05-15,3:30 PM,0,1,0,0,1,2,2023-05-15T21:11:12.071Z
2023-05-15,4:30 PM,2,1,1,0,1,5,2023-05-15T21:59:43.669Z
2023-05-16,8:30 AM,0,0,0,0,0,0,2023-05-16T13:28:57.418Z
2023-05-16,9:30 AM,2,0,2,0,0,4,2023-05-16T14:32:39.374Z
2023-05-16,10:30 AM,2,0,2,0,2,6,2023-05-16T15:37:28.754Z
2023-05-16,11:30 AM,1,0,1,0,2,4,2023-05-16T16:37:32.060Z
2023-05-16,12:30 PM,0,0,0,0,0,0,2023-05-16T17:46:05.033Z
2023-05-16,1:30 PM,0,0,0,0,2,2,2023-05-16T18:38:41.366Z
2023-05-16,2:30 PM,0,1,0,0,2,3,2023-05-16T19:36:34.032Z
2023-05-16,3:30 PM,2,1,0,0,3,6,2023-05-16T20:44:55.858Z
2023-05-16,4:30 PM,2,1,1,0,1,5,2023-05-16T22:04:45.400Z
2023-05-17,8:30 AM,0,0,2,0,0,2,2023-05-17T13:34:09.791Z
2023-05-17,9:30 AM,1,0,2,0,0,3,2023-05-17T14:31:11.428Z
2023-05-17,10:30 AM,0,0,4,0,3,7,2023-05-17T15:43:27.980Z
2023-05-17,11:30 AM,0,3,3,0,3,9,2023-05-17T16:34:40.841Z
2023-05-17,12:30 PM,1,1,1,0,0,3,2023-05-17T17:39:17.698Z
2023-05-17,1:30 PM,4,1,1,0,3,9,2023-05-17T18:31:28.886Z
2023-05-17,2:30 PM,1,1,1,1,3,7,2023-05-17T19:36:55.548Z
2023-05-17,3:30 PM,2,1,1,1,1,6,2023-05-17T21:02:15.844Z
2023-05-17,4:30 PM,4,1,1,1,1,8,2023-05-17T21:56:48.004Z
2023-05-18,7:30 AM,0,0,0,0,0,0,2023-05-18T12:31:53.159Z
2023-05-18,8:30 AM,0,0,0,0,0,0,2023-05-18T13:39:54.542Z
2023-05-18,2:30 PM,1,1,0,0,0,2,2023-05-18T19:38:00.459Z
2023-05-18,3:30 PM,4,1,0,0,2,7,2023-05-18T20:37:12.112Z
2023-05-18,4:30 PM,6,1,1,0,2,10,2023-05-18T21:36:12.627Z
2023-05-19,8:30 AM,0,1,0,0,0,1,2023-05-19T13:33:27.722Z
2023-05-19,9:30 AM,0,1,0,0,0,1,2023-05-19T14:30:28.742Z
2023-05-19,10:30 AM,3,1,0,0,0,4,2023-05-19T15:29:58.818Z
2023-05-19,2:30 PM,2,0,0,0,0,2,2023-05-19T19:39:07.326Z
2023-05-19,3:30 PM,1,0,0,0,0,1,2023-05-19T20:39:16.828Z
2023-05-19,4:30 PM,2,0,0,1,0,3,2023-05-19T21:33:10.144Z
2023-05-22,8:30 AM,1,0,0,0,0,1,2023-05-22T13:35:25.024Z
2023-05-22,9:30 AM,1,0,1,0,0,2,2023-05-22T14:38:57.240Z
2023-05-22,10:30 AM,2,0,1,0,0,3,2023-05-22T15:44:03.714Z
2023-05-22,11:30 AM,4,0,2,0,0,6,2023-05-22T16:34:15.243Z
2023-05-22,12:30 PM,3,0,2,0,0,5,2023-05-22T17:43:16.435Z
2023-05-22,1:30 PM,3,0,2,0,0,5,2023-05-22T18:32:16.607Z
2023-05-22,4:30 PM,3,1,1,1,0,6,2023-05-22T21:33:53.063Z
2023-05-23,7:30 AM,0,0,0,0,0,0,2023-05-23T13:41:36.064Z
2023-05-23,8:30 AM,0,0,1,0,0,1,2023-05-23T13:41:50.447Z
2023-05-23,9:30 AM,1,2,2,0,1,6,2023-05-23T14:43:31.806Z
2023-05-23,10:30 AM,0,1,0,0,1,2,2023-05-23T15:34:53.447Z
2023-05-23,11:30 AM,0,0,1,0,0,1,2023-05-23T16:32:17.046Z
2023-05-23,12:30 PM,0,0,1,0,2,3,2023-05-23T17:34:29.345Z
2023-05-23,1:30 PM,1,0,2,0,4,7,2023-05-23T18:34:33.414Z
2023-05-24,8:30 AM,0,1,0,0,0,1,2023-05-24T13:28:01.885Z
2023-05-24,9:30 AM,0,1,0,0,0,1,2023-05-24T14:35:55.835Z
2023-05-24,10:30 AM,0,1,0,0,0,1,2023-05-24T15:29:00.804Z
2023-05-24,10:30 AM,1,0,0,0,0,1,2023-05-24T15:37:52.726Z
2023-05-24,11:30 AM,1,0,2,0,0,3,2023-05-24T16:31:54.745Z
2023-05-24,12:30 PM,3,0,1,0,0,4,2023-05-24T17:31:23.034Z
2023-05-24,1:30 PM,4,0,0,2,0,6,2023-05-24T18:37:43.474Z
2023-05-25,8:30 AM,0,0,0,0,0,0,2023-05-25T13:29:52.658Z
2023-05-25,9:30 AM,1,0,0,0,0,1,2023-05-25T14:44:50.155Z
2023-05-25,10:30 AM,2,0,1,0,0,3,2023-05-25T15:34:16.564Z
2023-05-25,11:30 AM,2,0,2,0,0,4,2023-05-25T16:38:46.791Z
2023-05-25,12:30 PM,1,1,1,0,0,3,2023-05-25T17:34:25.107Z
2023-05-25,1:30 PM,2,1,0,0,0,3,2023-05-25T18:33:06.984Z
2023-05-26,7:30 AM,1,0,0,0,0,1,2023-05-26T12:33:41.656Z
2023-05-26,8:30 AM,0,1,0,0,0,1,2023-05-26T13:29:43.116Z
2023-05-26,9:30 AM,0,1,0,0,0,1,2023-05-26T14:28:53.466Z
2023-05-26,10:30 AM,0,1,1,0,0,2,2023-05-26T15:34:34.513Z
2023-05-26,11:30 AM,2,0,1,0,0,3,2023-05-26T16:38:52.147Z
2023-05-26,12:30 PM,2,0,1,0,0,3,2023-05-26T17:32:36.953Z
2023-05-26,1:30 PM,1,1,0,0,0,2,2023-05-26T18:41:00.969Z
2023-05-26,2:30 PM,0,0,0,0,0,0,2023-05-26T19:30:26.539Z
2023-05-26,3:30 PM,0,1,0,0,0,1,2023-05-26T20:34:22.366Z
2023-05-26,4:30 PM,0,3,0,0,0,3,2023-05-26T21:33:09.148Z
2023-05-30,8:30 AM,0,0,1,0,0,1,2023-05-30T13:43:12.727Z
2023-05-30,10:30 AM,0,0,0,0,1,1,2023-05-30T15:42:25.179Z
2023-05-30,11:30 AM,2,0,0,0,0,2,2023-05-30T16:34:55.967Z
2023-05-30,12:30 PM,0,0,3,0,1,4,2023-05-30T17:36:54.441Z
2023-05-30,1:30 PM,1,0,1,0,1,3,2023-05-30T18:33:20.866Z
2023-05-30,2:30 PM,2,0,0,0,0,2,2023-05-30T19:33:18.553Z
2023-05-30,3:30 PM,3,0,1,0,0,4,2023-05-30T20:33:37.486Z
2023-05-30,4:30 PM,2,0,1,0,0,3,2023-05-30T21:32:51.203Z
2023-05-31,7:30 AM,0,0,0,0,0,0,2023-05-31T12:47:39.343Z
2023-05-31,8:30 AM,1,0,0,0,0,1,2023-05-31T13:30:19.054Z
2023-05-31,8:30 AM,1,0,0,0,0,1,2023-05-31T13:51:38.166Z
2023-05-31,9:30 AM,1,1,0,0,0,2,2023-05-31T14:50:55.631Z
2023-05-31,10:30 AM,0,0,0,0,1,1,2023-05-31T15:28:25.676Z
2023-05-31,11:30 AM,0,0,1,0,1,2,2023-05-31T16:38:47.490Z
2023-06-01,7:30 AM,0,0,0,0,0,0,2023-06-01T13:14:20.370Z
2023-06-01,8:30 AM,1,0,0,0,0,1,2023-06-01T14:36:17.139Z
2023-06-01,9:30 AM,0,0,0,0,0,0,2023-06-01T14:36:29.659Z
2023-06-01,10:30 AM,1,0,0,0,0,1,2023-06-01T15:33:45.826Z
2023-06-01,11:30 AM,1,1,2,0,2,6,2023-06-01T16:34:12.126Z
2023-06-01,12:30 PM,1,1,1,0,3,6,2023-06-01T17:34:58.660Z
2023-06-01,1:30 PM,0,0,3,1,1,5,2023-06-01T18:36:06.015Z
2023-06-01,4:30 PM,0,0,3,0,0,3,2023-06-01T21:34:50.630Z
2023-06-02,7:30 AM,0,0,0,0,0,0,2023-06-02T12:30:07.647Z
2023-06-02,8:30 AM,3,0,0,0,0,3,2023-06-02T13:46:24.895Z
2023-06-02,10:30 AM,2,0,0,0,2,4,2023-06-02T15:33:31.686Z
2023-06-02,11:30 AM,2,0,0,0,0,2,2023-06-02T16:47:02.684Z
2023-06-02,12:30 PM,3,0,0,1,0,4,2023-06-02T17:38:24.911Z
2023-06-02,1:30 PM,2,0,2,1,0,5,2023-06-02T18:34:08.874Z
2023-06-02,3:30 PM,0,0,4,1,0,5,2023-06-02T20:37:23.917Z
2023-06-02,4:30 PM,2,0,4,1,0,7,2023-06-02T21:33:53.345Z
2023-06-05,8:30 AM,6,0,1,0,0,7,2023-06-05T13:49:43.973Z
2023-06-05,9:30 AM,3,0,0,0,2,5,2023-06-05T14:28:43.630Z
2023-06-05,10:30 AM,4,1,2,0,1,8,2023-06-05T15:32:43.673Z
2023-06-05,11:30 AM,4,0,3,0,1,8,2023-06-05T16:38:50.241Z
2023-06-05,12:30 PM,4,1,5,0,1,11,2023-06-05T17:54:24.960Z
2023-06-05,1:30 PM,7,1,4,0,2,14,2023-06-05T18:39:32.798Z
2023-06-05,2:30 PM,5,1,1,1,0,8,2023-06-05T19:36:02.809Z
2023-06-05,3:30 PM,3,2,5,5,1,16,2023-06-05T20:36:44.433Z
2023-06-05,4:30 PM,1,3,2,0,1,7,2023-06-05T21:36:18.831Z
2023-06-05,5:30 PM,1,1,2,0,1,5,2023-06-05T22:33:22.115Z
2023-06-05,6:30 PM,1,1,1,0,0,3,2023-06-05T23:33:53.083Z
2023-06-05,7:30 PM,1,0,0,0,0,1,2023-06-06T00:35:19.181Z
2023-06-06,8:30 AM,1,0,0,0,0,1,2023-06-06T13:33:33.229Z
2023-06-06,8:30 AM,1,0,0,0,2,3,2023-06-06T13:41:20.283Z
2023-06-06,9:30 AM,2,0,2,0,0,4,2023-06-06T14:29:36.801Z
2023-06-06,10:30 AM,1,0,2,0,0,3,2023-06-06T15:34:10.416Z
2023-06-06,11:30 AM,5,2,1,0,0,8,2023-06-06T16:38:51.443Z
2023-06-06,12:30 PM,4,2,4,0,0,10,2023-06-06T17:39:00.415Z
2023-06-06,1:30 PM,7,1,5,0,1,14,2023-06-06T18:40:54.442Z
2023-06-06,2:30 PM,3,1,2,1,1,8,2023-06-06T19:35:44.558Z
2023-06-06,3:30 PM,2,2,3,2,1,10,2023-06-06T20:33:03.065Z
2023-06-06,6:30 PM,1,1,2,1,0,5,2023-06-06T23:00:57.569Z
2023-06-06,5:30 PM,1,1,2,1,0,5,2023-06-06T23:01:39.361Z
2023-06-07,8:30 AM,0,0,0,0,0,0,2023-06-07T13:35:58.171Z
2023-06-07,9:30 AM,1,1,0,2,0,4,2023-06-07T14:29:46.025Z
2023-06-07,10:30 AM,2,0,0,0,2,4,2023-06-07T15:54:34.407Z
2023-06-07,11:30 AM,4,1,2,1,0,8,2023-06-07T16:54:43.014Z
2023-06-07,12:30 PM,6,3,6,0,1,16,2023-06-07T17:34:17.654Z
2023-06-07,1:30 PM,3,2,1,0,0,6,2023-06-07T18:35:08.034Z
2023-06-07,2:30 PM,2,3,2,0,0,7,2023-06-07T19:38:38.595Z
2023-06-07,3:30 PM,1,2,3,0,0,6,2023-06-07T20:25:23.233Z
2023-06-07,4:30 PM,0,0,3,2,0,5,2023-06-07T21:35:59.278Z
2023-06-07,5:30 PM,0,0,1,2,0,3,2023-06-07T22:32:55.648Z
2023-06-07,6:30 PM,2,2,0,0,0,4,2023-06-07T23:34:55.082Z
2023-06-07,7:30 PM,0,0,0,0,0,0,2023-06-08T00:33:21.229Z
2023-06-08,7:30 AM,0,0,0,0,1,1,2023-06-08T12:31:54.482Z
2023-06-08,8:30 AM,0,1,0,0,0,1,2023-06-08T13:31:53.445Z
2023-06-08,9:30 AM,1,1,0,1,0,3,2023-06-08T14:31:50.376Z
2023-06-08,10:30 AM,0,1,1,0,0,2,2023-06-08T15:39:06.553Z
2023-06-08,11:30 AM,2,1,1,0,5,9,2023-06-08T16:40:16.426Z
2023-06-08,12:30 PM,3,3,7,0,3,16,2023-06-08T18:05:58.671Z
2023-06-08,1:30 PM,1,3,2,2,0,8,2023-06-08T18:36:31.101Z
2023-06-08,2:30 PM,1,3,2,0,0,6,2023-06-08T19:36:31.059Z
2023-06-08,3:30 PM,3,3,4,0,0,10,2023-06-08T20:29:11.906Z
2023-06-08,5:30 PM,3,2,3,0,2,10,2023-06-08T22:32:58.149Z
2023-06-08,6:30 PM,0,1,2,1,0,4,2023-06-08T23:40:06.057Z
2023-06-09,8:30 AM,0,1,0,1,0,2,2023-06-09T13:34:44.998Z
2023-06-09,9:30 AM,0,2,0,1,0,3,2023-06-09T14:38:59.437Z
2023-06-09,11:30 AM,1,1,1,0,1,4,2023-06-09T16:40:15.101Z
2023-06-09,12:30 PM,2,2,1,0,2,7,2023-06-09T17:37:03.436Z
2023-06-09,1:30 PM,3,2,1,0,3,9,2023-06-09T18:30:11.990Z
2023-06-09,2:30 PM,4,3,0,0,3,10,2023-06-09T19:20:03.327Z
2023-06-09,3:30 PM,4,0,2,1,0,7,2023-06-09T20:36:45.791Z
2023-06-12,8:30 AM,0,1,0,0,0,1,2023-06-12T13:30:19.074Z
2023-06-12,9:30 AM,4,1,1,0,0,6,2023-06-12T14:30:20.090Z
2023-06-12,10:30 AM,4,2,2,0,0,8,2023-06-12T15:31:26.145Z
2023-06-12,11:30 AM,3,1,4,0,4,12,2023-06-12T16:48:19.274Z
2023-06-12,12:30 PM,4,3,9,1,1,18,2023-06-12T17:37:18.976Z
2023-06-12,1:30 PM,3,1,5,1,0,10,2023-06-12T18:35:22.635Z
2023-06-12,2:30 PM,2,2,2,5,0,11,2023-06-12T19:36:38.310Z
2023-06-12,5:30 PM,2,1,2,0,0,5,2023-06-12T22:41:06.695Z
2023-06-12,7:30 PM,2,0,0,0,0,2,2023-06-13T00:32:47.440Z
2023-06-13,8:30 AM,0,0,0,0,0,0,2023-06-13T13:29:57.820Z
2023-06-13,9:30 AM,2,0,1,3,0,6,2023-06-13T14:29:58.117Z
2023-06-13,10:30 AM,1,0,2,0,1,4,2023-06-13T16:34:34.079Z
2023-06-13,11:30 AM,0,0,1,0,1,2,2023-06-13T16:37:19.791Z
2023-06-13,12:30 PM,2,2,5,1,0,10,2023-06-13T17:34:04.714Z
2023-06-13,1:30 PM,1,0,2,0,1,4,2023-06-13T18:30:50.589Z
2023-06-13,3:30 PM,3,0,1,2,3,9,2023-06-13T20:39:58.347Z
2023-06-13,5:30 PM,1,1,1,0,0,3,2023-06-13T22:32:05.688Z
2023-06-13,6:30 PM,0,1,0,0,0,1,2023-06-13T23:32:32.998Z
2023-06-13,7:30 PM,0,1,0,0,0,1,2023-06-14T00:33:48.794Z
2023-06-14,8:30 AM,0,0,0,0,0,0,2023-06-14T13:26:10.357Z
2023-06-14,9:30 AM,1,0,0,0,0,1,2023-06-14T14:31:58.775Z
2023-06-14,10:30 AM,0,1,1,1,0,3,2023-06-14T15:32:50.286Z
2023-06-14,11:30 AM,4,2,1,2,2,11,2023-06-14T16:36:11.564Z
2023-06-14,12:30 PM,9,3,5,0,1,18,2023-06-14T17:34:51.780Z
2023-06-14,1:30 PM,4,2,3,1,2,12,2023-06-14T18:38:33.100Z
2023-06-14,2:30 PM,2,5,5,1,1,14,2023-06-14T19:34:19.213Z
2023-06-14,5:30 PM,3,0,5,0,0,8,2023-06-14T22:33:00.536Z
2023-06-14,6:30 PM,0,4,0,0,4,8,2023-06-14T23:32:56.103Z
2023-06-14,7:30 PM,0,2,0,0,0,2,2023-06-15T00:32:55.575Z
2023-06-15,8:30 AM,0,0,1,1,0,2,2023-06-15T13:30:38.663Z
2023-06-15,9:30 AM,3,0,3,2,0,8,2023-06-15T14:43:27.980Z
2023-06-15,10:30 AM,2,0,1,1,0,4,2023-06-15T15:31:13.451Z
2023-06-15,11:30 AM,3,2,3,1,3,12,2023-06-15T16:38:44.039Z
2023-06-15,12:30 PM,4,2,7,1,2,16,2023-06-15T17:57:21.361Z
2023-06-15,1:30 PM,5,3,6,1,3,18,2023-06-15T18:34:14.746Z
2023-06-15,2:30 PM,2,2,2,0,1,7,2023-06-15T19:50:01.390Z
2023-06-15,3:30 PM,4,3,4,0,0,11,2023-06-15T20:40:19.660Z
2023-06-15,7:30 PM,0,2,5,0,0,7,2023-06-16T00:33:02.389Z
2023-06-16,8:30 AM,1,1,0,0,0,2,2023-06-16T13:32:04.892Z
2023-06-16,9:30 AM,0,2,0,0,0,2,2023-06-16T14:29:23.337Z
2023-06-16,10:30 AM,0,2,0,0,0,2,2023-06-16T15:28:40.334Z
2023-06-16,11:30 AM,4,1,2,0,0,7,2023-06-16T16:39:06.603Z
2023-06-16,12:30 PM,4,0,1,0,0,5,2023-06-16T17:44:53.299Z
2023-06-16,1:30 PM,5,0,1,0,1,7,2023-06-16T18:40:43.526Z
2023-06-21,8:30 AM,1,1,2,0,0,4,2023-06-21T13:31:52.193Z
2023-06-21,9:30 AM,0,3,3,0,0,6,2023-06-21T14:32:26.827Z
2023-06-21,10:30 AM,1,2,3,2,0,8,2023-06-21T15:30:22.775Z
2023-06-21,11:30 AM,9,1,7,3,1,21,2023-06-21T16:43:02.486Z
2023-06-21,12:30 PM,2,3,5,0,1,11,2023-06-21T17:37:59.707Z
2023-06-21,1:30 PM,1,3,3,1,1,9,2023-06-21T18:32:58.144Z
2023-06-21,2:30 PM,2,3,3,1,3,12,2023-06-21T19:37:31.784Z
2023-06-21,5:30 PM,3,1,3,1,7,15,2023-06-21T22:46:04.475Z
2023-06-21,6:30 PM,2,2,1,0,6,11,2023-06-21T23:34:27.755Z
2023-06-21,7:30 PM,4,1,0,0,2,7,2023-06-22T00:35:49.025Z
2023-06-22,8:30 AM,0,1,3,0,0,4,2023-06-22T13:32:35.343Z
2023-06-22,9:30 AM,0,2,2,0,0,4,2023-06-22T14:29:47.545Z
2023-06-22,10:30 AM,0,2,5,1,0,8,2023-06-22T15:43:14.998Z
2023-06-22,11:30 AM,1,3,3,0,1,8,2023-06-22T16:33:43.130Z
2023-06-22,12:30 PM,5,2,4,3,3,17,2023-06-22T17:36:31.748Z
2023-06-22,1:30 PM,1,3,5,3,3,15,2023-06-22T18:36:28.172Z
2023-06-22,2:30 PM,2,1,5,3,3,14,2023-06-22T19:39:39.530Z
2023-06-22,3:30 PM,2,1,6,3,4,16,2023-06-22T20:34:19.517Z
2023-06-22,5:30 PM,0,1,5,2,0,8,2023-06-22T22:44:08.213Z
2023-06-22,6:30 PM,4,3,6,0,0,13,2023-06-22T23:36:34.996Z
2023-06-22,7:30 PM,0,3,2,4,0,9,2023-06-23T00:33:57.132Z
2023-06-23,8:30 AM,1,1,0,0,0,2,2023-06-23T13:41:10.897Z
2023-06-23,9:30 AM,2,1,0,0,0,3,2023-06-23T14:29:13.387Z
2023-06-23,10:30 AM,2,1,1,0,0,4,2023-06-23T15:30:40.262Z
2023-06-23,11:30 AM,1,1,3,1,0,6,2023-06-23T16:39:10.223Z
2023-06-23,12:30 PM,1,1,2,1,1,6,2023-06-23T17:34:38.961Z
2023-06-23,1:30 PM,1,1,0,1,1,4,2023-06-23T18:30:39.112Z
2023-06-23,2:30 PM,0,1,1,1,2,5,2023-06-23T19:33:42.448Z
2023-06-23,3:30 PM,2,1,1,0,3,7,2023-06-23T20:33:46.558Z
2023-06-26,8:30 AM,0,2,2,0,0,4,2023-06-26T13:30:07.864Z
2023-06-26,9:30 AM,5,2,2,0,0,9,2023-06-26T14:29:16.039Z
2023-06-26,10:30 AM,0,3,1,2,0,6,2023-06-26T15:31:48.775Z
2023-06-26,11:30 AM,0,1,2,1,8,12,2023-06-26T16:55:20.745Z
2023-06-26,12:30 PM,4,3,5,1,5,18,2023-06-26T17:49:24.722Z
2023-06-26,1:30 PM,3,2,2,1,3,11,2023-06-26T18:42:27.620Z
2023-06-26,2:30 PM,2,3,2,2,0,9,2023-06-26T19:34:18.817Z
2023-06-26,5:30 PM,2,0,2,2,3,9,2023-06-26T22:34:15.622Z
2023-06-26,6:30 PM,1,1,3,3,5,13,2023-06-26T23:36:54.928Z
2023-06-26,7:30 PM,2,1,2,2,0,7,2023-06-27T00:34:53.764Z
2023-06-27,8:30 AM,0,1,0,0,0,1,2023-06-27T13:29:57.077Z
2023-06-27,9:30 AM,0,3,0,0,0,3,2023-06-27T14:32:31.249Z
2023-06-27,10:30 AM,0,4,1,0,0,5,2023-06-27T15:29:15.832Z
2023-06-27,11:30 AM,3,1,5,0,4,13,2023-06-27T16:40:22.842Z
2023-06-27,12:30 PM,0,3,4,1,2,10,2023-06-27T17:41:25.377Z
2023-06-27,1:30 PM,2,2,2,2,3,11,2023-06-27T18:37:01.115Z
2023-06-27,2:30 PM,2,2,1,2,3,10,2023-06-27T19:46:41.125Z
2023-06-27,3:30 PM,3,2,1,3,0,9,2023-06-27T20:34:11.775Z
2023-06-27,6:30 PM,0,1,2,1,0,4,2023-06-27T23:33:56.007Z
2023-06-27,7:30 PM,0,1,1,0,0,2,2023-06-28T00:34:14.003Z
2023-06-28,8:30 AM,0,0,0,0,0,0,2023-06-28T13:30:07.015Z
2023-06-28,9:30 AM,0,1,0,1,0,2,2023-06-28T14:31:06.133Z
2023-06-28,10:30 AM,0,1,1,1,0,3,2023-06-28T15:27:18.001Z
2023-06-28,11:30 AM,0,3,1,0,1,5,2023-06-28T16:40:34.096Z
2023-06-28,12:30 PM,0,3,2,1,2,8,2023-06-28T17:42:22.456Z
2023-06-28,1:30 PM,1,3,1,3,0,8,2023-06-28T18:35:31.497Z
2023-06-28,2:30 PM,5,1,1,2,2,11,2023-06-28T19:31:24.115Z
2023-06-28,5:30 PM,10,0,1,0,5,16,2023-06-28T22:41:54.879Z
2023-06-28,6:30 PM,0,1,2,0,0,3,2023-06-28T23:33:29.647Z
2023-06-28,7:30 PM,3,0,4,0,0,7,2023-06-29T00:32:52.263Z
2023-06-29,8:30 AM,0,1,1,0,0,2,2023-06-29T13:29:45.056Z
2023-06-29,9:30 AM,0,0,2,0,0,2,2023-06-29T14:30:11.492Z
2023-06-29,10:30 AM,2,0,1,0,0,3,2023-06-29T15:35:52.335Z
2023-06-29,11:30 AM,4,0,3,0,2,9,2023-06-29T16:43:02.924Z
2023-06-29,12:30 PM,5,0,3,1,2,11,2023-06-29T17:45:08.147Z
2023-06-29,1:30 PM,0,1,1,1,1,4,2023-06-29T18:36:07.081Z
2023-06-29,2:30 PM,2,4,3,5,0,14,2023-06-29T19:45:23.391Z
2023-06-29,3:30 PM,3,2,3,5,0,13,2023-06-29T20:55:20.849Z
2023-06-29,5:30 PM,0,3,2,5,1,11,2023-06-29T22:33:28.943Z
2023-06-29,6:30 PM,1,1,1,2,5,10,2023-06-29T23:34:59.958Z
2023-06-29,7:30 PM,1,1,1,2,0,5,2023-06-30T00:33:02.833Z
2023-06-30,8:30 AM,0,1,0,0,0,1,2023-06-30T13:29:52.346Z
2023-06-30,9:30 AM,0,0,0,0,0,0,2023-06-30T14:34:53.859Z
2023-06-30,10:30 AM,2,2,1,1,0,6,2023-06-30T15:30:39.032Z
2023-06-30,11:30 AM,8,2,2,1,1,14,2023-06-30T17:09:47.259Z
2023-06-30,12:30 PM,5,2,2,1,2,12,2023-06-30T18:01:30.116Z
2023-06-30,1:30 PM,2,0,2,1,1,6,2023-06-30T18:33:50.513Z
2023-06-30,2:30 PM,0,0,0,1,1,2,2023-06-30T19:35:40.029Z
2023-06-30,3:30 PM,0,0,1,1,0,2,2023-06-30T20:33:49.009Z
2023-07-03,8:30 AM,0,1,0,0,0,1,2023-07-03T13:30:07.730Z
2023-07-03,9:30 AM,0,1,1,0,0,2,2023-07-03T14:28:15.569Z
2023-07-03,10:30 AM,0,2,0,0,0,2,2023-07-03T15:29:46.541Z
2023-07-03,11:30 AM,0,1,4,0,0,5,2023-07-03T16:41:35.927Z
2023-07-03,12:30 PM,2,3,5,0,0,10,2023-07-03T17:21:18.725Z
2023-07-03,1:30 PM,1,0,4,0,0,5,2023-07-03T18:35:53.504Z
2023-07-03,2:30 PM,0,0,3,0,0,3,2023-07-03T19:29:58.909Z
2023-07-03,5:30 PM,0,0,2,1,0,3,2023-07-03T22:33:48.159Z
2023-07-03,6:30 PM,4,0,2,1,3,10,2023-07-03T23:33:48.356Z
2023-07-03,7:30 PM,0,0,0,0,0,0,2023-07-04T00:36:18.616Z
2023-07-05,8:30 AM,0,0,0,0,0,0,2023-07-05T13:30:17.519Z
2023-07-05,9:30 AM,2,1,0,0,0,3,2023-07-05T14:29:31.915Z
2023-07-05,10:30 AM,0,0,0,0,0,0,2023-07-05T15:30:07.359Z
2023-07-05,11:30 AM,1,0,3,0,0,4,2023-07-05T16:42:35.996Z
2023-07-05,12:30 PM,3,1,4,0,2,10,2023-07-05T17:38:32.125Z
2023-07-05,1:30 PM,2,1,3,0,4,10,2023-07-05T18:35:33.672Z
2023-07-05,2:30 PM,2,2,3,1,2,10,2023-07-05T19:38:35.679Z
2023-07-05,5:30 PM,4,2,0,0,3,9,2023-07-05T22:35:41.866Z
2023-07-05,6:30 PM,0,2,0,1,2,5,2023-07-05T23:41:02.221Z
2023-07-05,7:30 PM,1,1,1,0,0,3,2023-07-06T00:31:37.579Z
2023-07-06,9:30 AM,1,0,0,0,0,1,2023-07-06T14:43:02.775Z
2023-07-06,10:30 AM,2,0,2,0,0,4,2023-07-06T15:39:25.893Z
2023-07-06,11:30 AM,0,0,3,0,2,5,2023-07-06T16:44:35.104Z
2023-07-06,12:30 PM,2,0,4,0,2,8,2023-07-06T17:40:39.078Z
2023-07-06,1:30 PM,3,0,5,2,0,10,2023-07-06T18:35:27.888Z
2023-07-06,2:30 PM,1,0,5,3,0,9,2023-07-06T19:45:36.229Z
2023-07-06,3:30 PM,2,1,2,3,0,8,2023-07-06T20:49:26.011Z
2023-07-06,5:30 PM,2,0,2,3,0,7,2023-07-06T22:33:01.312Z
2023-07-06,6:30 PM,1,0,1,2,3,7,2023-07-06T23:34:02.275Z
2023-07-06,7:30 PM,1,0,0,1,1,3,2023-07-07T00:32:13.880Z
2023-07-07,8:30 AM,0,2,0,0,0,2,2023-07-07T13:30:35.348Z
2023-07-07,9:30 AM,0,3,0,0,0,3,2023-07-07T14:28:51.885Z
2023-07-07,10:30 AM,0,3,0,0,0,3,2023-07-07T15:31:08.272Z
2023-07-07,11:30 AM,0,2,2,1,0,5,2023-07-07T16:34:22.705Z
2023-07-07,12:30 PM,4,2,3,1,0,10,2023-07-07T17:38:21.765Z
2023-07-07,1:30 PM,4,2,4,3,0,13,2023-07-07T18:31:42.381Z
2023-07-07,2:30 PM,2,2,2,1,3,10,2023-07-07T19:34:56.220Z
2023-07-07,3:30 PM,1,3,3,1,4,12,2023-07-07T20:33:55.366Z
2023-07-10,8:30 AM,0,1,0,0,0,1,2023-07-10T13:29:30.324Z
2023-07-10,9:30 AM,4,3,0,0,0,7,2023-07-10T14:30:05.758Z
2023-07-10,10:30 AM,0,2,2,0,0,4,2023-07-10T15:36:48.303Z
2023-07-10,11:30 AM,2,2,2,0,3,9,2023-07-10T16:49:27.687Z
2023-07-10,12:30 PM,3,3,3,2,1,12,2023-07-10T17:54:17.524Z
2023-07-10,1:30 PM,3,3,2,3,5,16,2023-07-10T18:45:53.956Z
2023-07-10,2:30 PM,4,2,2,4,7,19,2023-07-10T19:37:14.468Z
2023-07-10,5:30 PM,4,3,6,0,3,16,2023-07-10T22:33:40.087Z
2023-07-10,6:30 PM,0,2,3,0,5,10,2023-07-10T23:33:35.406Z
2023-07-10,7:30 PM,3,0,3,0,5,11,2023-07-11T00:33:20.560Z
2023-07-11,8:30 AM,1,0,0,0,0,1,2023-07-11T13:27:30.756Z
2023-07-11,9:30 AM,0,0,1,1,0,2,2023-07-11T14:27:16.065Z
2023-07-11,10:30 AM,1,1,2,0,0,4,2023-07-11T15:31:47.941Z
2023-07-11,11:30 AM,4,2,4,1,3,14,2023-07-11T16:43:40.167Z
2023-07-11,12:30 PM,4,3,2,3,2,14,2023-07-11T17:48:49.291Z
2023-07-11,1:30 PM,0,2,1,1,0,4,2023-07-11T18:36:38.522Z
2023-07-11,2:30 PM,1,0,2,3,3,9,2023-07-11T19:41:25.417Z
2023-07-11,3:30 PM,2,1,4,4,2,13,2023-07-11T20:36:02.696Z
2023-07-11,5:30 PM,3,0,3,0,2,8,2023-07-11T22:35:21.372Z
2023-07-11,6:30 PM,3,0,1,0,0,4,2023-07-11T23:33:07.519Z
2023-07-11,7:30 PM,1,0,0,0,0,1,2023-07-12T00:36:28.486Z
2023-07-12,8:30 AM,1,1,0,0,0,2,2023-07-12T13:31:19.851Z
2023-07-12,9:30 AM,0,2,2,0,0,4,2023-07-12T14:30:10.432Z
2023-07-12,10:30 AM,0,1,2,0,0,3,2023-07-12T15:28:40.598Z
2023-07-12,11:30 AM,3,1,2,3,0,9,2023-07-12T16:36:41.512Z
2023-07-12,12:30 PM,1,3,2,0,0,6,2023-07-12T17:45:04.319Z
2023-07-12,1:30 PM,2,1,2,0,1,6,2023-07-12T18:36:57.252Z
2023-07-12,2:30 PM,2,2,3,1,1,9,2023-07-12T19:47:48.343Z
2023-07-12,5:30 PM,2,1,2,2,5,12,2023-07-12T22:32:46.872Z
2023-07-12,6:30 PM,2,0,4,0,6,12,2023-07-12T23:33:46.437Z
2023-07-12,7:30 PM,2,0,1,2,1,6,2023-07-13T00:32:53.657Z
2023-07-13,8:30 AM,2,1,0,0,0,3,2023-07-13T13:47:36.306Z
2023-07-13,9:30 AM,0,0,0,0,0,0,2023-07-13T14:31:21.501Z
2023-07-13,11:30 AM,3,0,5,0,3,11,2023-07-13T16:48:06.418Z
2023-07-13,12:30 PM,2,1,3,1,2,9,2023-07-13T17:50:46.393Z
2023-07-13,1:30 PM,0,0,1,3,2,6,2023-07-13T18:28:52.706Z
2023-07-13,2:30 PM,3,0,4,3,4,14,2023-07-13T19:35:22.344Z
2023-07-13,3:30 PM,2,4,4,2,2,14,2023-07-13T20:37:46.620Z
2023-07-13,5:30 PM,1,1,1,6,0,9,2023-07-13T22:33:09.087Z
2023-07-13,6:30 PM,1,0,0,4,4,9,2023-07-13T23:33:08.982Z
2023-07-13,7:30 PM,0,0,0,2,4,6,2023-07-14T00:33:36.166Z
2023-07-14,8:30 AM,0,2,0,0,0,2,2023-07-14T13:31:01.702Z
2023-07-14,9:30 AM,0,2,0,0,0,2,2023-07-14T14:29:42.812Z
2023-07-14,10:30 AM,0,1,0,0,0,1,2023-07-14T15:29:41.925Z
2023-07-14,11:30 AM,3,0,1,0,1,5,2023-07-14T16:43:22.910Z
2023-07-14,12:30 PM,3,0,4,0,3,10,2023-07-14T17:36:17.165Z
2023-07-14,1:30 PM,3,1,5,0,3,12,2023-07-14T18:34:41.721Z
2023-07-14,2:30 PM,1,0,2,2,2,7,2023-07-14T19:37:38.802Z
2023-07-14,3:30 PM,3,1,3,2,1,10,2023-07-14T20:32:52.671Z
2023-07-17,8:30 AM,0,1,0,0,0,1,2023-07-17T13:29:08.590Z
2023-07-17,9:30 AM,3,6,2,0,0,11,2023-07-17T14:29:18.958Z
2023-07-17,10:30 AM,2,4,1,0,0,7,2023-07-17T15:30:04.690Z
2023-07-17,11:30 AM,2,0,5,0,0,7,2023-07-17T16:39:55.084Z
2023-07-17,12:30 PM,1,2,5,2,0,10,2023-07-17T17:44:15.708Z
2023-07-17,1:30 PM,3,0,3,3,2,11,2023-07-17T18:37:25.350Z
2023-07-17,2:30 PM,1,2,3,1,2,9,2023-07-17T19:44:25.573Z
2023-07-17,5:30 PM,1,1,2,1,2,7,2023-07-17T22:32:47.835Z
2023-07-17,6:30 PM,2,1,2,1,2,8,2023-07-17T23:34:39.756Z
2023-07-17,7:30 PM,4,2,0,0,0,6,2023-07-18T00:36:30.640Z
2023-07-18,8:30 AM,0,0,1,0,0,1,2023-07-18T13:29:10.443Z
2023-07-18,9:30 AM,1,1,1,0,0,3,2023-07-18T14:30:13.314Z
2023-07-18,10:30 AM,0,2,2,1,0,5,2023-07-18T15:30:15.482Z
2023-07-18,11:30 AM,2,1,2,1,0,6,2023-07-18T16:36:39.373Z
2023-07-18,12:30 PM,1,2,3,2,0,8,2023-07-18T17:34:41.756Z
2023-07-18,1:30 PM,1,2,9,3,1,16,2023-07-18T18:40:54.419Z
2023-07-18,2:30 PM,2,2,7,2,4,17,2023-07-18T19:44:59.404Z
2023-07-18,3:30 PM,2,4,4,4,2,16,2023-07-18T20:36:11.010Z
2023-07-18,5:30 PM,0,0,2,0,2,4,2023-07-18T22:32:00.334Z
2023-07-18,6:30 PM,0,1,2,0,1,4,2023-07-18T23:35:36.663Z
2023-07-18,7:30 PM,0,1,0,0,0,1,2023-07-19T00:34:49.240Z
2023-07-19,7:30 AM,0,0,0,0,0,0,2023-07-19T13:30:24.473Z
2023-07-19,8:30 AM,1,0,0,0,0,1,2023-07-19T13:30:37.249Z
2023-07-19,9:30 AM,6,1,2,0,0,9,2023-07-19T14:45:59.548Z
2023-07-19,11:30 AM,1,2,4,1,0,8,2023-07-19T16:30:57.825Z
2023-07-19,12:30 PM,5,2,6,0,5,18,2023-07-19T17:35:24.649Z
2023-07-19,1:30 PM,3,3,6,0,4,16,2023-07-19T18:31:56.206Z
2023-07-19,2:30 PM,8,3,5,0,5,21,2023-07-19T19:35:56.335Z
2023-07-19,5:30 PM,2,1,3,1,4,11,2023-07-19T22:37:07.061Z
2023-07-19,6:30 PM,2,1,4,1,5,13,2023-07-19T23:32:56.326Z
2023-07-19,7:30 PM,2,1,1,1,0,5,2023-07-20T00:32:49.814Z
2023-07-20,8:30 AM,1,2,0,0,0,3,2023-07-20T13:26:42.319Z
2023-07-20,10:30 AM,1,1,1,0,0,3,2023-07-20T15:27:43.219Z
2023-07-20,11:30 AM,2,1,2,0,0,5,2023-07-20T16:39:04.924Z
2023-07-20,12:30 PM,2,2,5,2,0,11,2023-07-20T17:54:39.535Z
2023-07-20,1:30 PM,3,3,4,3,2,15,2023-07-20T18:42:43.130Z
2023-07-20,2:30 PM,6,2,5,3,1,17,2023-07-20T19:50:00.823Z
2023-07-20,3:30 PM,5,2,5,3,3,18,2023-07-20T20:50:31.533Z
2023-07-20,4:30 PM,5,2,8,1,0,16,2023-07-20T21:27:31.216Z
2023-07-20,5:30 PM,1,0,6,0,1,8,2023-07-20T22:34:04.375Z
2023-07-20,6:30 PM,0,0,5,1,2,8,2023-07-20T23:29:59.716Z
2023-07-20,7:30 PM,0,0,3,0,0,3,2023-07-21T00:31:51.099Z
2023-07-21,11:30 AM,3,1,2,0,0,6,2023-07-21T16:40:46.144Z
2023-07-21,12:30 PM,2,0,3,0,0,5,2023-07-21T17:38:28.701Z
2023-07-21,1:30 PM,5,0,3,0,0,8,2023-07-21T18:44:18.758Z
2023-07-21,3:30 PM,1,0,3,1,2,7,2023-07-21T20:35:38.707Z
2023-07-24,7:30 AM,1,0,0,0,0,1,2023-07-24T15:56:25.568Z
2023-07-24,11:30 AM,1,4,6,1,0,12,2023-07-24T16:35:59.390Z
2023-07-24,12:30 PM,5,11,4,0,0,20,2023-07-24T17:28:52.532Z
2023-07-24,1:30 PM,1,5,6,1,0,13,2023-07-24T18:31:43.021Z
2023-07-24,2:30 PM,3,3,3,4,0,13,2023-07-24T19:29:26.240Z
2023-07-24,3:30 PM,5,2,3,3,0,13,2023-07-24T20:30:25.470Z
2023-07-24,5:30 PM,5,0,2,0,3,10,2023-07-24T22:28:20.750Z
2023-07-24,6:30 PM,0,1,2,2,0,5,2023-07-24T23:38:05.747Z
2023-07-24,7:30 PM,0,0,0,0,0,0,2023-07-25T00:32:47.968Z
2023-07-25,7:30 AM,0,0,0,0,0,0,2023-07-25T12:48:35.203Z
2023-07-25,8:30 AM,1,0,0,0,0,1,2023-07-25T13:30:13.602Z
2023-07-25,9:30 AM,2,0,2,0,0,4,2023-07-25T14:50:12.817Z
2023-07-25,11:30 AM,1,3,7,2,3,16,2023-07-25T16:38:50.877Z
2023-07-25,12:30 PM,8,5,3,1,6,23,2023-07-25T17:42:37.274Z
2023-07-25,1:30 PM,5,5,5,3,4,22,2023-07-25T18:37:41.338Z
2023-07-25,2:30 PM,7,3,6,3,3,22,2023-07-25T19:37:25.830Z
2023-07-25,3:30 PM,3,3,5,2,0,13,2023-07-25T20:26:17.274Z
2023-07-25,5:30 PM,1,2,4,0,0,7,2023-07-25T22:34:34.876Z
2023-07-25,6:30 PM,1,1,5,1,0,8,2023-07-25T23:36:00.279Z
2023-07-25,7:30 PM,0,0,4,1,0,5,2023-07-26T00:36:00.288Z
2023-07-26,8:30 AM,1,2,0,0,0,3,2023-07-26T13:29:36.351Z
2023-07-26,9:30 AM,1,3,1,0,0,5,2023-07-26T14:43:52.019Z
2023-07-26,10:30 AM,2,5,1,1,0,9,2023-07-26T15:32:00.433Z
2023-07-26,11:30 AM,6,3,5,0,1,15,2023-07-26T16:44:22.895Z
2023-07-26,12:30 PM,3,4,3,2,1,13,2023-07-26T17:43:15.145Z
2023-07-26,1:30 PM,3,1,3,0,5,12,2023-07-26T18:45:20.845Z
2023-07-26,2:30 PM,2,1,4,0,5,12,2023-07-26T19:36:27.779Z
2023-07-26,5:30 PM,1,4,6,2,0,13,2023-07-26T22:34:22.001Z
2023-07-26,6:30 PM,0,3,0,2,0,5,2023-07-26T23:35:36.052Z
2023-07-26,7:30 PM,0,0,1,0,0,1,2023-07-27T00:40:11.524Z
2023-07-27,8:30 AM,2,2,0,0,0,4,2023-07-27T13:29:23.076Z
2023-07-27,9:30 AM,2,0,0,0,0,2,2023-07-27T14:38:33.532Z
2023-07-27,10:30 AM,2,1,0,1,0,4,2023-07-27T15:31:27.987Z
2023-07-27,11:30 AM,5,2,3,1,1,12,2023-07-27T16:34:34.831Z
2023-07-27,12:30 PM,5,4,4,2,1,16,2023-07-27T17:44:32.507Z
2023-07-27,1:30 PM,0,6,5,4,0,15,2023-07-27T18:39:33.500Z
2023-07-27,2:30 PM,2,3,4,3,0,12,2023-07-27T19:46:00.363Z
2023-07-27,3:30 PM,6,3,5,4,0,18,2023-07-27T20:43:33.690Z
2023-07-27,5:30 PM,3,1,1,2,0,7,2023-07-27T22:44:49.007Z
2023-07-27,6:30 PM,3,1,1,2,0,7,2023-07-27T23:37:33.613Z
2023-07-28,8:30 AM,0,1,0,0,0,1,2023-07-28T13:29:42.697Z
2023-07-28,9:30 AM,0,1,0,0,0,1,2023-07-28T14:35:31.298Z
2023-07-28,10:30 AM,2,1,1,0,0,4,2023-07-28T15:27:18.974Z
2023-07-28,11:30 AM,1,0,2,1,1,5,2023-07-28T16:34:39.086Z
2023-07-28,12:30 PM,4,2,3,1,2,12,2023-07-28T17:41:28.043Z
2023-07-28,1:30 PM,1,0,3,1,1,6,2023-07-28T18:35:49.488Z
2023-07-28,2:30 PM,2,0,3,2,0,7,2023-07-28T19:34:08.098Z
2023-07-28,3:30 PM,1,0,1,2,0,4,2023-07-28T20:33:26.139Z
2023-07-31,8:30 AM,0,1,0,0,0,1,2023-07-31T13:17:54.899Z
2023-07-31,10:30 AM,1,2,2,0,0,5,2023-07-31T15:33:35.695Z
2023-07-31,11:30 AM,3,3,3,0,0,9,2023-07-31T16:50:04.055Z
2023-07-31,12:30 PM,2,2,2,0,3,9,2023-07-31T17:51:33.261Z
2023-07-31,1:30 PM,1,2,4,0,3,10,2023-07-31T18:54:22.449Z
2023-07-31,2:30 PM,0,1,2,0,3,6,2023-07-31T19:33:08.869Z
2023-07-31,2:30 PM,0,1,2,0,2,5,2023-07-31T19:36:29.505Z
2023-07-31,3:30 PM,2,2,3,2,5,14,2023-07-31T20:34:51.880Z
2023-07-31,4:30 PM,1,1,2,2,3,9,2023-07-31T21:33:38.707Z
2023-08-01,8:30 AM,0,0,0,0,0,0,2023-08-01T13:26:19.332Z
2023-08-01,9:30 AM,0,0,1,0,0,1,2023-08-01T14:27:40.243Z
2023-08-01,10:30 AM,2,2,1,0,0,5,2023-08-01T15:31:10.207Z
2023-08-01,11:30 AM,3,1,0,0,1,5,2023-08-01T16:48:11.896Z
2023-08-01,12:30 PM,4,1,1,1,0,7,2023-08-01T17:39:23.820Z
2023-08-01,1:30 PM,0,1,3,1,0,5,2023-08-01T18:44:32.108Z
2023-08-01,2:30 PM,0,1,1,1,0,3,2023-08-01T19:51:25.886Z
2023-08-01,3:30 PM,1,0,0,0,0,1,2023-08-01T20:52:32.174Z
2023-08-01,4:30 PM,1,0,0,0,0,1,2023-08-01T21:33:23.341Z
2023-08-02,8:30 AM,0,0,0,0,0,0,2023-08-02T13:25:19.309Z
2023-08-02,9:30 AM,0,1,0,0,0,1,2023-08-02T14:34:31.640Z
2023-08-02,10:30 AM,1,1,1,0,0,3,2023-08-02T15:31:29.529Z
2023-08-02,12:30 PM,0,4,1,0,0,5,2023-08-02T17:40:03.371Z
2023-08-02,1:30 PM,3,1,3,1,1,9,2023-08-02T18:45:56.658Z
2023-08-02,4:30 PM,0,0,4,1,0,5,2023-08-02T21:48:04.977Z
2023-08-03,8:30 AM,0,0,0,0,0,0,2023-08-03T13:25:41.795Z
2023-08-03,9:30 AM,0,0,0,0,0,0,2023-08-03T14:28:26.153Z
2023-08-03,9:30 AM,0,1,1,0,0,2,2023-08-03T14:37:52.390Z
2023-08-03,10:30 AM,1,2,1,0,0,4,2023-08-03T15:29:00.537Z
2023-08-03,11:30 AM,0,1,0,0,3,4,2023-08-03T16:37:36.614Z
2023-08-03,12:30 PM,0,2,0,0,3,5,2023-08-03T17:36:32.737Z
2023-08-03,1:30 PM,4,3,2,0,4,13,2023-08-03T18:28:23.358Z
2023-08-03,2:30 PM,1,1,2,1,2,7,2023-08-03T19:32:53.930Z
2023-08-04,8:30 AM,0,1,0,0,0,1,2023-08-04T13:28:02.227Z
2023-08-04,9:30 AM,0,2,0,0,0,2,2023-08-04T14:34:50.050Z
2023-08-04,10:30 AM,0,1,1,0,0,2,2023-08-04T15:28:39.497Z
2023-08-04,12:30 PM,2,1,2,0,0,5,2023-08-04T17:23:15.460Z
2023-08-04,1:30 PM,3,1,1,0,2,7,2023-08-04T18:51:08.467Z
2023-08-04,2:30 PM,2,1,2,0,2,7,2023-08-04T19:26:49.502Z
2023-08-04,2:30 PM,3,1,1,0,2,7,2023-08-04T19:48:34.540Z
2023-08-04,3:30 PM,3,0,3,0,2,8,2023-08-04T20:33:19.287Z
2023-08-04,4:30 PM,3,0,1,0,0,4,2023-08-04T21:37:49.697Z
2023-08-07,8:30 AM,0,1,0,0,0,1,2023-08-07T13:27:41.589Z
2023-08-07,9:30 AM,0,1,0,0,0,1,2023-08-07T14:24:44.590Z
2023-08-07,10:30 AM,1,1,2,0,0,4,2023-08-07T15:29:59.338Z
2023-08-07,11:30 AM,3,3,1,0,0,7,2023-08-07T16:54:49.117Z
2023-08-07,12:30 PM,6,2,3,0,0,11,2023-08-07T17:50:05.058Z
2023-08-07,1:30 PM,2,3,0,0,0,5,2023-08-07T18:44:04.436Z
2023-08-07,2:30 PM,3,1,0,1,0,5,2023-08-07T19:36:45.372Z
2023-08-07,3:30 PM,0,0,2,1,1,4,2023-08-07T20:40:51.772Z
2023-08-07,4:30 PM,2,0,3,0,0,5,2023-08-07T21:34:29.138Z
2023-08-08,8:30 AM,1,1,0,0,0,2,2023-08-08T13:31:14.702Z
2023-08-08,9:30 AM,4,2,0,0,0,6,2023-08-08T14:30:14.176Z
2023-08-08,10:30 AM,1,2,0,1,0,4,2023-08-08T15:29:29.192Z
2023-08-08,11:30 PM,2,1,3,0,3,9,2023-08-08T17:14:29.149Z
2023-08-08,12:30 PM,0,2,2,1,0,5,2023-08-08T17:56:40.639Z
2023-08-08,2:30 PM,4,2,2,0,0,8,2023-08-08T19:32:03.864Z
2023-08-08,3:30 PM,1,2,2,0,0,5,2023-08-08T20:33:15.267Z
2023-08-08,4:30 PM,3,0,3,0,0,6,2023-08-08T21:33:00.124Z
2023-08-09,8:30 AM,1,1,0,0,0,2,2023-08-09T13:30:37.535Z
2023-08-09,9:30 AM,1,2,0,0,0,3,2023-08-09T14:34:22.131Z
2023-08-09,10:30 AM,1,3,0,0,0,4,2023-08-09T15:29:26.803Z
2023-08-09,11:30 AM,4,2,3,0,1,10,2023-08-09T16:41:46.800Z
2023-08-09,1:30 PM,4,3,1,0,5,13,2023-08-09T18:32:21.902Z
2023-08-10,8:30 AM,0,1,0,0,0,1,2023-08-10T13:30:07.684Z
2023-08-10,9:30 AM,2,2,0,0,0,4,2023-08-10T14:32:02.018Z
2023-08-10,10:30 AM,2,0,1,0,0,3,2023-08-10T15:31:53.259Z
2023-08-10,11:30 AM,1,1,2,4,0,8,2023-08-10T16:38:14.151Z
2023-08-10,12:30 PM,2,1,2,0,0,5,2023-08-10T17:32:55.639Z
2023-08-10,1:30 PM,3,1,1,0,0,5,2023-08-10T18:36:27.603Z
2023-08-10,3:30 PM,2,1,2,0,0,5,2023-08-10T20:35:08.082Z
2023-08-10,4:30 PM,4,0,2,0,0,6,2023-08-10T21:32:11.147Z
2023-08-11,8:30 AM,1,1,1,0,0,3,2023-08-11T13:31:01.169Z
2023-08-11,9:30 AM,1,2,1,0,0,4,2023-08-11T14:30:01.984Z
2023-08-11,10:30 AM,3,2,3,0,0,8,2023-08-11T15:29:22.196Z
2023-08-11,11:30 AM,4,1,1,0,1,7,2023-08-11T16:33:06.238Z
2023-08-11,12:30 PM,6,1,3,0,0,10,2023-08-11T17:36:32.523Z
2023-08-11,1:30 PM,7,1,4,0,0,12,2023-08-11T18:36:34.878Z
2023-08-11,2:30 PM,3,2,3,0,0,8,2023-08-11T19:32:39.796Z
2023-08-11,3:30 PM,2,3,2,0,0,7,2023-08-11T20:35:45.727Z
2023-08-14,5:30 PM,6,3,4,2,0,15,2023-08-14T22:42:16.297Z
2023-08-14,6:30 PM,8,3,4,0,1,16,2023-08-14T23:52:26.293Z
2023-08-14,7:30 PM,3,5,2,0,1,11,2023-08-15T00:52:28.580Z
2023-08-15,8:30 AM,0,0,1,0,0,1,2023-08-15T13:29:55.250Z
2023-08-15,9:30 AM,4,3,5,0,0,12,2023-08-15T14:30:35.768Z
2023-08-15,10:30 AM,5,2,11,1,0,19,2023-08-15T15:28:42.086Z
2023-08-15,11:30 AM,13,8,26,1,1,49,2023-08-15T16:48:09.791Z
2023-08-15,12:30 PM,15,9,28,4,1,57,2023-08-15T17:38:38.084Z
2023-08-15,2:30 PM,13,8,9,1,2,33,2023-08-15T19:45:08.142Z
2023-08-15,3:30 PM,10,4,9,0,1,24,2023-08-15T20:38:37.735Z
2023-08-15,4:30 PM,12,3,7,1,2,25,2023-08-15T21:33:39.407Z
2023-08-15,6:30 PM,4,1,1,1,0,7,2023-08-15T23:35:08.307Z
2023-08-15,7:30 PM,2,1,1,1,0,5,2023-08-16T00:59:19.441Z
2023-08-16,8:30 AM,3,1,2,0,0,6,2023-08-16T13:32:55.843Z
2023-08-16,9:30 AM,6,5,5,1,0,17,2023-08-16T14:30:11.692Z
2023-08-16,10:30 AM,4,4,9,3,0,20,2023-08-16T15:33:23.351Z
2023-08-16,11:30 AM,8,5,18,4,1,36,2023-08-16T16:42:33.938Z
2023-08-16,12:30 PM,14,8,28,1,2,53,2023-08-16T17:44:49.906Z
2023-08-16,1:30 PM,13,7,18,1,3,42,2023-08-16T18:43:16.579Z
2023-08-16,2:30 PM,14,8,13,1,2,38,2023-08-16T19:37:41.615Z
2023-08-16,3:30 PM,13,4,14,3,2,36,2023-08-16T20:31:57.769Z
2023-08-16,4:30 PM,14,3,12,3,1,33,2023-08-16T21:44:07.464Z
2023-08-16,5:30 PM,8,1,8,0,1,18,2023-08-16T22:37:07.608Z
2023-08-16,6:30 PM,8,2,5,1,1,17,2023-08-16T23:33:07.712Z
2023-08-16,7:30 PM,3,0,4,1,0,8,2023-08-17T00:39:16.005Z
2023-08-17,8:30 AM,4,0,3,0,0,7,2023-08-17T13:26:09.539Z
2023-08-17,9:30 AM,6,4,8,1,0,19,2023-08-17T14:32:06.525Z
2023-08-17,11:30 AM,17,15,2,7,4,45,2023-08-17T16:41:55.214Z
2023-08-17,4:30 PM,10,5,13,1,5,34,2023-08-17T21:37:59.636Z
2023-08-17,5:30 PM,4,0,8,4,5,21,2023-08-17T22:37:50.459Z
2023-08-17,6:30 PM,8,0,3,3,2,16,2023-08-17T23:33:10.660Z
2023-08-17,7:30 PM,2,2,2,2,0,8,2023-08-18T00:41:42.883Z
2023-08-18,8:30 AM,2,4,0,0,0,6,2023-08-18T13:30:12.595Z
2023-08-18,9:30 AM,2,4,5,0,0,11,2023-08-18T14:31:22.195Z
2023-08-18,10:30 AM,4,4,4,3,0,15,2023-08-18T15:29:23.127Z
2023-08-18,11:30 AM,11,7,8,6,10,42,2023-08-18T16:41:49.238Z
2023-08-18,12:30 PM,6,6,10,10,6,38,2023-08-18T17:32:43.717Z
2023-08-18,1:30 PM,8,4,4,1,0,17,2023-08-18T18:37:04.394Z
2023-08-18,2:30 PM,6,6,8,2,2,24,2023-08-18T19:34:33.177Z
2023-08-18,4:30 PM,5,2,3,0,2,12,2023-08-18T21:36:13.088Z
2023-08-18,5:30 PM,2,2,3,0,0,7,2023-08-18T22:34:06.921Z
2023-08-19,11:30 AM,2,1,1,1,0,5,2023-08-19T16:34:38.825Z
2023-08-19,12:30 PM,3,1,2,1,1,8,2023-08-19T17:48:21.968Z
2023-08-19,2:30 PM,5,2,7,1,3,18,2023-08-19T19:35:13.211Z
2023-08-19,4:30 PM,3,1,2,0,3,9,2023-08-19T21:30:19.260Z
2023-08-21,8:30 AM,0,3,1,0,0,4,2023-08-21T13:30:40.009Z
2023-08-21,9:30 AM,2,6,8,0,0,16,2023-08-21T14:29:12.132Z
2023-08-21,10:30 AM,10,6,11,2,0,29,2023-08-21T15:34:03.945Z
2023-08-21,11:30 AM,11,5,16,2,5,39,2023-08-21T16:44:48.108Z
2023-08-21,12:30 PM,21,8,24,3,5,61,2023-08-21T17:55:43.194Z
2023-08-21,1:30 PM,9,5,12,4,6,36,2023-08-21T18:43:14.025Z
2023-08-21,2:30 PM,13,6,12,1,4,36,2023-08-21T19:46:48.922Z
2023-08-21,3:30 PM,12,6,11,2,0,31,2023-08-21T20:42:36.663Z
2023-08-21,4:30 PM,8,3,7,5,2,25,2023-08-21T21:48:15.740Z
2023-08-21,6:30 PM,6,3,4,1,1,15,2023-08-21T23:34:12.786Z
2023-08-22,8:30 AM,1,1,0,0,0,2,2023-08-22T13:31:47.226Z
2023-08-22,9:30 AM,4,8,8,1,0,21,2023-08-22T14:31:10.489Z
2023-08-22,10:30 AM,9,7,14,1,0,31,2023-08-22T15:38:10.660Z
2023-08-22,1:30 PM,8,7,18,4,3,40,2023-08-22T18:56:20.354Z
2023-08-22,2:30 PM,17,4,23,5,1,50,2023-08-22T19:42:03.675Z
2023-08-22,3:30 PM,11,9,19,4,0,43,2023-08-22T20:35:31.943Z
2023-08-22,4:30 PM,14,5,8,2,1,30,2023-08-22T21:42:03.045Z
2023-08-22,5:30 PM,2,6,4,4,1,17,2023-08-22T22:35:43.109Z
2023-08-22,6:30 PM,3,1,4,3,2,13,2023-08-22T23:32:03.702Z
2023-08-23,8:30 AM,1,1,2,0,0,4,2023-08-23T13:33:56.283Z
2023-08-23,9:30 AM,4,3,7,0,0,14,2023-08-23T14:29:51.538Z
2023-08-23,10:30 AM,8,11,7,0,0,26,2023-08-23T15:32:26.614Z
2023-08-23,11:30 AM,11,6,16,0,0,33,2023-08-23T16:45:27.095Z
2023-08-23,12:30 PM,19,7,27,3,3,59,2023-08-23T17:58:21.275Z
2023-08-23,1:30 PM,16,5,11,3,5,40,2023-08-23T18:44:56.551Z
2023-08-23,2:30 PM,14,5,13,6,5,43,2023-08-23T19:52:42.932Z
2023-08-23,3:30 PM,10,6,13,4,3,36,2023-08-23T20:35:28.145Z
2023-08-23,4:30 PM,11,6,17,3,2,39,2023-08-23T21:33:13.575Z
2023-08-23,5:30 PM,10,3,8,2,4,27,2023-08-23T22:33:50.405Z
2023-08-23,6:30 PM,6,1,5,1,2,15,2023-08-23T23:33:14.685Z
2023-08-23,7:30 PM,5,2,5,0,0,12,2023-08-24T00:29:13.665Z
2023-08-23,7:30 PM,2,1,5,0,0,8,2023-08-24T00:35:52.389Z
2023-08-23,8:30 PM,4,1,1,0,0,6,2023-08-24T01:34:11.759Z
2023-08-24,8:30 AM,0,2,3,1,0,6,2023-08-24T13:31:46.696Z
2023-08-24,9:30 AM,1,3,10,4,0,18,2023-08-24T14:31:51.647Z
2023-08-24,10:30 AM,5,9,9,3,0,26,2023-08-24T15:33:08.553Z
2023-08-24,1:30 PM,10,4,16,3,7,40,2023-08-24T18:38:01.734Z
2023-08-24,2:30 PM,16,6,13,1,2,38,2023-08-24T19:37:57.134Z
2023-08-24,3:30 PM,10,6,9,4,2,31,2023-08-24T20:44:35.149Z
2023-08-24,5:30 PM,6,5,4,2,2,19,2023-08-24T22:34:33.308Z
2023-08-24,6:30 PM,3,1,5,1,2,12,2023-08-24T23:36:34.818Z
2023-08-24,7:30 PM,4,2,3,2,0,11,2023-08-25T00:37:48.353Z
2023-08-24,8:30 PM,2,1,4,2,0,9,2023-08-25T01:33:11.652Z
2023-08-25,8:30 AM,0,2,3,1,0,6,2023-08-25T13:33:49.776Z
2023-08-25,9:30 AM,3,3,1,1,0,8,2023-08-25T14:30:45.165Z
2023-08-25,10:30 AM,3,2,4,3,0,12,2023-08-25T15:26:53.258Z
2023-08-25,3:30 PM,8,0,5,4,3,20,2023-08-25T20:34:51.072Z
2023-08-25,4:30 PM,5,0,4,3,1,13,2023-08-25T21:34:27.035Z
2023-08-25,5:30 PM,7,3,3,1,0,14,2023-08-25T22:34:28.610Z
2023-08-25,6:30 PM,4,0,3,1,0,8,2023-08-25T23:30:13.182Z
2023-08-26,10:30 AM,2,1,1,0,1,5,2023-08-26T15:37:16.653Z
2023-08-26,10:30 AM,2,0,2,0,3,7,2023-08-26T15:44:39.362Z
2023-08-26,11:30 AM,4,1,1,0,3,9,2023-08-26T16:29:27.735Z
2023-08-26,12:30 PM,4,3,3,0,4,14,2023-08-26T17:32:59.524Z
2023-08-26,2:30 PM,5,3,2,0,1,11,2023-08-26T19:32:18.696Z
2023-08-26,3:30 PM,4,2,3,1,0,10,2023-08-26T20:32:41.032Z
2023-08-26,4:30 PM,2,3,2,1,0,8,2023-08-26T21:35:01.127Z
2023-08-28,8:30 AM,0,1,1,0,0,2,2023-08-28T13:32:07.494Z
2023-08-28,9:30 AM,3,4,8,1,0,16,2023-08-28T14:31:48.320Z
2023-08-28,10:30 AM,7,7,10,2,0,26,2023-08-28T15:39:16.483Z
2023-08-28,11:30 AM,9,8,23,2,2,44,2023-08-28T16:37:50.837Z
2023-08-28,1:30 PM,18,6,28,6,4,62,2023-08-28T18:48:45.731Z
2023-08-28,2:30 PM,20,4,12,4,4,44,2023-08-28T19:38:00.359Z
2023-08-28,3:30 PM,15,3,16,5,4,43,2023-08-28T20:40:04.554Z
2023-08-28,4:30 PM,11,7,11,4,2,35,2023-08-28T21:38:24.321Z
2023-08-28,5:30 PM,6,4,0,7,6,23,2023-08-28T22:38:50.137Z
2023-08-28,6:30 PM,7,3,6,1,2,19,2023-08-28T23:38:43.528Z
2023-08-28,7:30 PM,6,2,4,2,0,14,2023-08-29T00:38:04.248Z
2023-08-29,8:30 AM,3,4,20,0,0,27,2023-08-29T13:35:23.819Z
2023-08-29,9:30 AM,6,2,15,1,0,24,2023-08-29T14:33:39.053Z
2023-08-29,10:30 AM,6,7,14,1,0,28,2023-08-29T15:31:21.694Z
2023-08-29,1:30 PM,11,8,19,4,4,46,2023-08-29T18:41:29.472Z
2023-08-29,2:30 PM,16,9,16,2,4,47,2023-08-29T19:55:13.540Z
2023-08-29,3:30 PM,13,8,15,4,5,45,2023-08-29T20:42:35.382Z
2023-08-29,4:30 PM,8,6,10,3,5,32,2023-08-29T21:48:53.390Z
2023-08-29,5:30 PM,8,2,7,4,2,23,2023-08-29T22:33:27.999Z
2023-08-29,6:30 PM,3,0,4,6,5,18,2023-08-29T23:34:31.924Z
2023-08-29,7:30 PM,2,2,7,1,3,15,2023-08-30T00:38:09.250Z
2023-08-30,8:30 AM,2,2,2,0,0,6,2023-08-30T13:31:39.535Z
2023-08-30,9:30 AM,3,3,10,0,0,16,2023-08-30T14:37:05.624Z
2023-08-30,10:30 AM,5,6,12,0,0,23,2023-08-30T15:35:24.287Z
2023-08-30,11:30 AM,14,8,12,1,0,35,2023-08-30T16:45:23.721Z
2023-08-30,12:30 PM,26,10,27,5,8,76,2023-08-30T17:42:32.313Z
2023-08-30,1:30 PM,10,6,11,3,6,36,2023-08-30T18:41:11.810Z
2023-08-30,2:30 PM,15,5,13,3,1,37,2023-08-30T19:38:46.987Z
2023-08-30,3:30 PM,7,2,13,4,8,34,2023-08-30T20:34:10.665Z
2023-08-30,4:30 PM,12,2,9,1,5,29,2023-08-30T21:33:00.307Z
2023-08-30,5:30 PM,7,3,9,1,3,23,2023-08-30T22:33:24.430Z
2023-08-30,6:30 PM,1,1,7,0,3,12,2023-08-30T23:32:38.304Z
2023-08-30,7:30 PM,2,2,2,1,0,7,2023-08-31T00:40:31.747Z
2023-08-30,8:30 PM,1,0,1,2,0,4,2023-08-31T01:32:21.807Z
2023-08-31,8:30 AM,1,1,3,0,0,5,2023-08-31T13:31:19.388Z
2023-08-31,10:30 AM,4,6,15,1,0,26,2023-08-31T15:31:17.466Z
2023-08-31,1:30 PM,8,5,19,5,3,40,2023-08-31T18:40:53.315Z
2023-08-31,2:30 PM,12,10,14,7,3,46,2023-08-31T19:44:59.220Z
2023-08-31,3:30 PM,9,8,19,5,4,45,2023-08-31T20:34:56.755Z
2023-08-31,4:30 PM,9,1,11,3,4,28,2023-08-31T21:40:36.599Z
2023-08-31,5:30 PM,6,2,5,2,2,17,2023-08-31T22:33:49.156Z
2023-08-31,6:30 PM,5,0,5,3,1,14,2023-08-31T23:31:29.589Z
2023-08-31,7:30 PM,0,2,3,1,2,8,2023-09-01T00:40:43.986Z
2023-08-31,8:30 PM,3,2,2,3,0,10,2023-09-01T01:33:47.067Z
2023-09-01,8:30 AM,2,1,3,0,0,6,2023-09-01T13:35:21.464Z
2023-09-01,9:30 AM,0,2,5,0,0,7,2023-09-01T14:30:31.169Z
2023-09-01,10:30 AM,1,2,6,0,0,9,2023-09-01T15:34:22.940Z
2023-09-01,11:30 AM,1,0,6,0,25,32,2023-09-01T16:59:25.561Z
2023-09-01,12:30 PM,6,1,10,0,4,21,2023-09-01T17:41:09.626Z
2023-09-01,1:30 PM,4,0,4,0,1,9,2023-09-01T18:35:01.388Z
2023-09-01,2:30 PM,6,4,6,2,1,19,2023-09-01T19:27:21.139Z
2023-09-01,3:30 PM,8,4,4,2,1,19,2023-09-01T20:34:04.412Z
2023-09-01,4:30 PM,3,1,3,0,4,11,2023-09-01T21:44:45.025Z
2023-09-01,5:30 PM,5,3,2,0,2,12,2023-09-01T22:34:47.426Z
2023-09-02,10:30 AM,3,1,1,0,1,6,2023-09-02T15:33:47.375Z
2023-09-02,11:30 AM,2,0,0,0,1,3,2023-09-02T16:32:29.313Z
2023-09-02,12:30 PM,2,2,2,0,1,7,2023-09-02T17:33:34.436Z
2023-09-02,2:30 PM,4,2,5,1,2,14,2023-09-02T19:33:35.620Z
2023-09-02,3:30 PM,4,1,4,0,2,11,2023-09-02T20:31:43.392Z
2023-09-02,4:30 PM,4,1,2,0,2,9,2023-09-02T21:31:12.909Z
2023-09-06,8:30 AM,2,1,2,1,0,6,2023-09-06T13:31:21.389Z
2023-09-06,9:30 AM,4,5,9,2,0,20,2023-09-06T14:37:52.380Z
2023-09-06,10:30 AM,15,11,12,5,0,43,2023-09-06T15:33:29.480Z
2023-09-06,11:30 AM,15,6,16,2,0,39,2023-09-06T16:56:58.856Z
2023-09-06,12:30 PM,15,6,21,6,2,50,2023-09-06T17:49:51.839Z
2023-09-06,1:30 PM,13,3,12,4,5,37,2023-09-06T18:39:45.124Z
2023-09-06,3:30 PM,11,4,14,1,4,34,2023-09-06T20:35:10.299Z
2023-09-06,4:30 PM,8,4,9,2,3,26,2023-09-06T21:34:56.895Z
2023-09-06,5:30 PM,4,3,7,2,1,17,2023-09-06T22:33:34.625Z
2023-09-06,6:30 PM,7,1,3,1,1,13,2023-09-06T23:45:12.745Z
2023-09-06,7:30 PM,5,1,1,0,0,7,2023-09-07T00:38:17.886Z
2023-09-06,8:30 PM,4,0,1,0,0,5,2023-09-07T01:39:23.184Z
2023-09-07,8:30 AM,8,4,4,2,0,18,2023-09-07T13:57:41.831Z
2023-09-07,9:30 AM,6,2,12,2,0,22,2023-09-07T14:28:49.747Z
2023-09-07,10:30 AM,9,5,20,3,0,37,2023-09-07T15:33:52.768Z
2023-09-07,11:30 AM,12,6,7,6,7,38,2023-09-07T16:33:59.698Z
2023-09-07,12:30 PM,16,3,17,7,10,53,2023-09-07T17:34:22.049Z
2023-09-07,1:30 PM,9,6,19,5,15,54,2023-09-07T18:33:56.534Z
2023-09-07,2:30 PM,13,4,16,4,5,42,2023-09-07T19:32:12.800Z
2023-09-07,3:30 PM,11,3,12,2,7,35,2023-09-07T20:48:12.265Z
2023-09-07,4:30 PM,9,5,9,2,11,36,2023-09-07T21:34:53.811Z
2023-09-07,5:30 PM,5,5,5,1,5,21,2023-09-07T22:34:29.614Z
2023-09-07,6:30 PM,4,3,1,0,7,15,2023-09-07T23:34:12.034Z
2023-09-07,7:30 PM,3,2,2,2,0,9,2023-09-08T00:39:51.934Z
2023-09-07,8:30 PM,1,1,1,1,1,5,2023-09-08T01:36:54.259Z
2023-09-08,8:30 AM,2,2,1,0,0,5,2023-09-08T14:19:49.213Z
2023-09-08,9:30 AM,3,1,4,0,0,8,2023-09-08T14:30:31.960Z
2023-09-08,10:30 AM,2,1,5,4,0,12,2023-09-08T15:36:59.954Z
2023-09-08,11:30 AM,5,2,3,0,4,14,2023-09-08T16:47:25.268Z
2023-09-08,12:30 PM,4,4,4,2,8,22,2023-09-08T17:34:44.952Z
2023-09-08,1:30 PM,10,2,3,0,5,20,2023-09-08T18:49:19.762Z
2023-09-08,2:30 PM,3,2,6,0,3,14,2023-09-08T19:45:42.540Z
2023-09-08,4:30 PM,4,1,6,2,1,14,2023-09-08T21:35:20.737Z
2023-09-08,5:30 PM,5,0,0,0,5,10,2023-09-08T22:36:13.610Z
2023-09-09,10:30 AM,3,1,3,0,3,10,2023-09-09T15:50:36.316Z
2023-09-09,11:30 AM,4,0,3,0,3,10,2023-09-09T16:44:16.224Z
2023-09-09,12:30 PM,7,0,2,1,1,11,2023-09-09T17:35:52.109Z
2023-09-09,1:30 PM,7,0,4,1,2,14,2023-09-09T18:37:42.404Z
2023-09-09,2:30 PM,5,1,5,1,2,14,2023-09-09T19:32:28.996Z
2023-09-09,3:30 PM,2,1,7,1,3,14,2023-09-09T20:33:48.203Z
2023-09-09,4:30 PM,3,1,4,0,3,11,2023-09-09T21:34:40.612Z
2023-09-11,8:30 AM,2,3,4,0,0,9,2023-09-11T14:00:25.106Z
2023-09-11,9:30 AM,4,4,11,2,0,21,2023-09-11T14:57:29.735Z
2023-09-11,10:30 AM,5,11,8,1,0,25,2023-09-11T15:31:52.486Z
2023-09-11,11:30 AM,9,7,19,1,5,41,2023-09-11T16:40:52.750Z
2023-09-11,12:30 PM,21,9,22,5,10,67,2023-09-11T17:50:30.810Z
2023-09-11,1:30 PM,11,6,16,3,13,49,2023-09-11T18:36:28.132Z
2023-09-11,2:30 PM,8,4,17,4,2,35,2023-09-11T19:35:18.229Z
2023-09-11,3:30 PM,14,6,21,1,2,44,2023-09-11T20:46:45.154Z
2023-09-11,4:30 PM,9,3,8,1,5,26,2023-09-11T21:34:43.149Z
2023-09-11,5:30 PM,8,1,7,2,4,22,2023-09-11T22:40:30.554Z
2023-09-12,8:30 AM,2,2,2,0,0,6,2023-09-12T13:32:17.064Z
2023-09-12,9:30 AM,4,3,11,3,0,21,2023-09-12T14:47:20.889Z
2023-09-12,10:30 AM,5,7,20,3,0,35,2023-09-12T15:34:40.856Z
2023-09-12,11:30 AM,5,6,16,2,3,32,2023-09-12T16:40:59.924Z
2023-09-12,1:30 PM,12,6,22,8,6,54,2023-09-12T18:42:25.362Z
2023-09-12,2:30 PM,13,9,18,2,3,45,2023-09-12T19:37:35.752Z
2023-09-12,3:30 PM,3,6,21,3,2,35,2023-09-12T20:36:18.794Z
2023-09-12,4:30 PM,4,4,10,0,1,19,2023-09-12T21:33:37.373Z
2023-09-12,5:30 PM,15,2,8,0,4,29,2023-09-12T22:42:15.074Z
2023-09-12,6:30 PM,5,1,5,0,3,14,2023-09-12T23:33:00.453Z
2023-09-12,6:30 PM,5,1,5,0,3,14,2023-09-12T23:33:31.679Z
2023-09-12,7:30 PM,6,1,5,0,2,14,2023-09-13T00:29:30.784Z
2023-09-12,8:30 PM,2,2,2,0,0,6,2023-09-13T01:33:14.832Z
2023-09-13,8:30 AM,3,2,1,0,0,6,2023-09-13T13:35:45.180Z
2023-09-13,9:30 AM,3,5,8,0,0,16,2023-09-13T14:35:42.031Z
2023-09-13,10:30 AM,7,7,15,0,0,29,2023-09-13T15:50:24.995Z
2023-09-13,11:30 AM,18,7,13,5,3,46,2023-09-13T16:33:59.551Z
2023-09-13,12:30 PM,13,6,22,6,9,56,2023-09-13T17:38:09.940Z
2023-09-13,1:30 PM,17,3,17,15,6,58,2023-09-13T18:44:56.640Z
2023-09-13,2:30 PM,17,4,12,0,4,37,2023-09-13T19:40:38.356Z
2023-09-13,3:30 PM,14,2,17,7,6,46,2023-09-13T20:36:21.574Z
2023-09-13,4:30 PM,6,2,16,2,5,31,2023-09-13T21:31:39.247Z
2023-09-13,5:30 PM,4,1,6,0,5,16,2023-09-13T22:31:59.892Z
2023-09-13,7:30 PM,3,2,1,1,0,7,2023-09-14T00:46:30.009Z
2023-09-13,8:30 PM,1,1,2,2,0,6,2023-09-14T01:39:06.608Z
2023-09-14,10:30 AM,3,3,16,2,0,24,2023-09-14T16:05:45.145Z
2023-09-14,11:30 AM,11,5,14,2,2,34,2023-09-14T17:00:25.689Z
2023-09-14,12:30 PM,15,5,17,2,7,46,2023-09-14T17:41:16.293Z
2023-09-14,1:30 PM,7,7,13,3,12,42,2023-09-14T18:34:55.783Z
2023-09-14,2:30 PM,5,7,7,8,9,36,2023-09-14T19:33:57.464Z
2023-09-14,3:30 PM,10,4,3,3,6,26,2023-09-14T20:33:07.443Z
2023-09-14,4:30 PM,7,4,7,5,2,25,2023-09-14T21:34:24.816Z
2023-09-14,5:30 PM,4,5,5,2,2,18,2023-09-14T22:34:43.774Z
2023-09-14,6:30 PM,3,3,9,3,9,27,2023-09-14T23:35:41.659Z
2023-09-14,7:30 PM,5,2,3,1,1,12,2023-09-15T00:38:26.986Z
2023-09-14,8:30 PM,3,1,4,0,0,8,2023-09-15T01:41:18.459Z
2023-09-15,8:30 AM,0,2,1,1,0,4,2023-09-15T13:31:04.419Z
2023-09-15,9:30 AM,2,2,1,0,0,5,2023-09-15T14:29:11.529Z
2023-09-15,10:30 AM,0,4,4,2,0,10,2023-09-15T15:40:43.677Z
2023-09-15,11:30 AM,4,4,4,0,2,14,2023-09-15T16:27:59.490Z
2023-09-15,12:30 PM,4,1,5,3,4,17,2023-09-15T17:55:00.929Z
2023-09-15,1:30 PM,6,3,9,2,7,27,2023-09-15T18:48:54.443Z
2023-09-15,2:30 PM,5,1,7,1,2,16,2023-09-15T19:43:38.838Z
2023-09-15,3:30 PM,5,1,9,1,4,20,2023-09-15T20:32:59.296Z
2023-09-15,4:30 PM,1,1,6,0,5,13,2023-09-15T21:32:59.000Z
2023-09-15,5:30 PM,7,1,5,0,0,13,2023-09-15T22:36:26.739Z
2023-09-16,10:30 AM,1,2,0,0,0,3,2023-09-16T15:36:26.715Z
2023-09-16,11:30 AM,1,1,0,1,2,5,2023-09-16T16:30:57.847Z
2023-09-16,12:30 PM,3,1,2,0,0,6,2023-09-16T17:35:08.993Z
2023-09-16,1:30 PM,6,1,5,0,2,14,2023-09-16T18:38:54.562Z
2023-09-16,2:30 PM,8,2,4,0,2,16,2023-09-16T19:32:20.409Z
2023-09-16,3:30 PM,4,1,2,0,2,9,2023-09-16T20:30:16.273Z
2023-09-16,4:30 PM,1,0,0,0,0,1,2023-09-16T21:33:54.976Z
2023-09-18,8:30 AM,3,2,5,0,0,10,2023-09-18T13:33:38.670Z
2023-09-18,9:30 AM,1,3,11,2,0,17,2023-09-18T14:34:01.734Z
2023-09-18,10:30 AM,3,10,10,1,0,24,2023-09-18T15:31:08.161Z
2023-09-18,11:30 AM,6,5,12,5,0,28,2023-09-18T16:33:37.653Z
2023-09-18,12:30 PM,16,10,21,2,7,56,2023-09-18T17:37:28.365Z
2023-09-18,1:30 PM,14,6,18,3,4,45,2023-09-18T18:40:33.998Z
2023-09-18,2:30 PM,16,9,13,3,4,45,2023-09-18T19:31:37.754Z
2023-09-18,3:30 PM,12,5,7,3,1,28,2023-09-18T20:35:07.323Z
2023-09-18,4:30 PM,7,4,6,3,3,23,2023-09-18T21:44:58.370Z
2023-09-18,5:30 PM,5,1,4,1,5,16,2023-09-18T22:35:13.940Z
2023-09-18,6:30 PM,6,2,5,0,1,14,2023-09-18T23:35:18.652Z
2023-09-19,8:30 AM,2,2,2,0,0,6,2023-09-19T13:30:16.134Z
2023-09-19,9:30 AM,7,2,10,3,0,22,2023-09-19T14:31:28.160Z
2023-09-19,10:30 AM,7,11,19,3,0,40,2023-09-19T15:51:35.092Z
2023-09-19,11:30 AM,9,7,15,1,8,40,2023-09-19T16:37:11.022Z
2023-09-19,12:30 PM,16,5,13,6,7,47,2023-09-19T17:43:54.955Z
2023-09-19,1:30 PM,10,7,15,1,6,39,2023-09-19T18:57:16.440Z
2023-09-19,2:30 PM,9,7,16,5,7,44,2023-09-19T19:29:24.348Z
2023-09-19,4:30 PM,11,5,10,1,7,34,2023-09-19T21:34:08.352Z
2023-09-19,5:30 PM,4,4,5,1,3,17,2023-09-19T22:32:58.760Z
2023-09-19,6:30 PM,4,1,8,0,6,19,2023-09-19T23:33:18.082Z
2023-09-19,7:30 PM,6,0,7,0,0,13,2023-09-20T00:46:52.633Z
2023-09-19,8:30 PM,4,0,6,0,0,10,2023-09-20T01:40:35.116Z
2023-09-20,8:30 AM,0,1,5,0,0,6,2023-09-20T13:33:49.642Z
2023-09-20,9:30 AM,6,4,7,3,0,20,2023-09-20T14:28:14.316Z
2023-09-20,10:30 AM,7,7,13,3,0,30,2023-09-20T15:27:54.876Z
2023-09-20,11:30 AM,9,5,20,2,4,40,2023-09-20T16:54:18.147Z
2023-09-20,12:30 PM,24,10,18,1,5,58,2023-09-20T17:34:31.600Z
2023-09-20,1:30 PM,20,7,17,1,3,48,2023-09-20T18:39:48.374Z
2023-09-20,2:30 PM,14,5,14,3,4,40,2023-09-20T19:35:21.750Z
2023-09-20,4:30 PM,8,7,7,6,5,33,2023-09-20T21:33:31.091Z
2023-09-20,5:30 PM,5,3,3,1,1,13,2023-09-20T22:45:15.880Z
2023-09-20,7:30 PM,5,1,2,1,0,9,2023-09-21T00:37:05.374Z
2023-09-20,8:30 PM,3,0,1,1,0,5,2023-09-21T01:34:07.305Z
2023-09-21,8:30 AM,4,1,2,0,0,7,2023-09-21T13:38:53.572Z
2023-09-21,9:30 AM,6,4,12,0,0,22,2023-09-21T14:51:24.044Z
2023-09-21,10:30 AM,8,3,12,1,0,24,2023-09-21T15:34:08.901Z
2023-09-21,11:30 AM,11,4,7,0,2,24,2023-09-21T16:32:05.498Z
2023-09-21,12:30 PM,15,3,10,6,7,41,2023-09-21T17:42:34.768Z
2023-09-21,1:30 PM,9,9,10,4,4,36,2023-09-21T18:30:03.281Z
2023-09-21,2:30 PM,5,4,10,5,4,28,2023-09-21T19:31:33.907Z
2023-09-21,3:30 PM,5,3,10,4,10,32,2023-09-21T20:53:48.405Z
2023-09-21,5:30 PM,5,0,5,2,1,13,2023-09-21T22:32:27.427Z
2023-09-21,6:30 PM,2,3,8,0,0,13,2023-09-21T23:32:17.829Z
2023-09-21,7:30 PM,6,3,7,0,0,16,2023-09-22T00:39:24.073Z
2023-09-22,8:30 AM,1,1,1,0,0,3,2023-09-22T13:36:12.980Z
2023-09-22,9:30 AM,3,1,1,0,0,5,2023-09-22T14:29:50.419Z
2023-09-22,10:30 AM,4,2,4,1,0,11,2023-09-22T15:35:34.460Z
2023-09-22,11:30 AM,3,2,1,0,0,6,2023-09-22T16:36:33.176Z
2023-09-22,12:30 PM,3,2,5,1,2,13,2023-09-22T17:44:09.254Z
2023-09-22,1:30 PM,4,2,5,2,2,15,2023-09-22T18:39:25.184Z
2023-09-22,2:30 PM,1,2,1,2,0,6,2023-09-22T19:57:20.216Z
2023-09-22,4:30 PM,1,2,1,3,0,7,2023-09-22T21:36:27.342Z
2023-09-22,5:30 PM,1,1,3,4,2,11,2023-09-22T22:38:17.816Z
2023-09-22,6:30 PM,4,0,1,3,4,12,2023-09-22T23:44:45.896Z
2023-09-23,10:30 AM,3,1,2,0,1,7,2023-09-23T15:35:46.230Z
2023-09-23,11:30 AM,3,1,3,0,1,8,2023-09-23T16:36:41.815Z
2023-09-23,12:30 PM,9,1,3,0,3,16,2023-09-23T17:37:53.170Z
2023-09-23,1:30 PM,6,1,3,0,4,14,2023-09-23T18:34:57.166Z
2023-09-23,2:30 PM,5,1,7,1,4,18,2023-09-23T19:32:42.728Z
2023-09-23,3:30 PM,5,1,5,0,0,11,2023-09-23T20:35:04.390Z
2023-09-23,4:30 PM,5,0,4,0,0,9,2023-09-23T21:36:19.234Z
2023-09-25,8:30 AM,1,3,3,0,0,7,2023-09-25T13:27:08.530Z
2023-09-25,9:30 AM,4,7,14,1,0,26,2023-09-25T14:43:46.040Z
2023-09-25,10:30 AM,3,5,10,2,0,20,2023-09-25T15:31:27.658Z
2023-09-25,11:30 AM,10,5,16,3,27,61,2023-09-25T16:35:17.092Z
2023-09-25,12:30 PM,16,5,25,9,8,63,2023-09-25T17:45:07.952Z
2023-09-25,1:30 PM,13,8,18,4,5,48,2023-09-25T18:55:05.863Z
2023-09-25,2:30 PM,18,4,13,2,4,41,2023-09-25T19:36:46.346Z
2023-09-25,4:30 PM,10,6,7,2,2,27,2023-09-25T21:28:52.479Z
2023-09-25,5:30 PM,10,5,10,1,4,30,2023-09-25T22:33:01.112Z
2023-09-25,6:30 PM,8,11,6,0,0,25,2023-09-25T23:33:16.719Z
2023-09-25,7:30 PM,7,1,8,0,3,19,2023-09-26T00:33:27.222Z
2023-09-26,8:30 AM,1,1,2,0,0,4,2023-09-26T13:30:15.595Z
2023-09-26,9:30 AM,8,2,9,2,0,21,2023-09-26T14:31:17.233Z
2023-09-26,10:30 AM,4,6,10,2,0,22,2023-09-26T15:37:05.437Z
2023-09-26,12:30 PM,12,5,15,6,1,39,2023-09-26T17:46:29.190Z
2023-09-26,1:30 PM,12,10,18,4,7,51,2023-09-26T18:37:59.283Z
2023-09-26,2:30 PM,10,9,20,2,4,45,2023-09-26T19:35:55.481Z
2023-09-26,3:30 PM,10,8,14,3,1,36,2023-09-26T20:36:04.821Z
2023-09-26,4:30 PM,9,8,12,1,2,32,2023-09-26T21:39:29.307Z
2023-09-26,5:30 PM,13,5,7,0,2,27,2023-09-26T22:33:21.918Z
2023-09-26,6:30 PM,5,3,5,0,3,16,2023-09-26T23:35:11.742Z
2023-09-27,8:30 AM,1,0,1,0,0,2,2023-09-27T13:30:19.770Z
2023-09-27,9:30 AM,2,1,6,0,0,9,2023-09-27T14:36:14.448Z
2023-09-27,10:30 AM,2,6,12,4,0,24,2023-09-27T15:29:12.491Z
2023-09-27,11:30 AM,17,7,18,2,5,49,2023-09-27T16:54:41.278Z
2023-09-27,12:30 PM,8,6,19,5,4,42,2023-09-27T17:53:25.289Z
2023-09-27,1:30 PM,13,7,19,2,4,45,2023-09-27T18:57:37.928Z
2023-09-27,2:30 PM,11,4,13,3,11,42,2023-09-27T19:38:52.062Z
2023-09-27,4:30 PM,7,2,10,1,6,26,2023-09-27T21:40:56.423Z
2023-09-27,5:30 PM,8,4,4,2,5,23,2023-09-27T22:35:03.629Z
2023-09-27,6:30 PM,5,2,9,1,3,20,2023-09-27T23:35:19.022Z
2023-09-27,7:30 PM,0,1,1,0,0,2,2023-09-28T00:38:23.827Z
2023-09-27,4:30 PM,3,3,9,7,1,23,2023-09-28T21:34:38.298Z
2023-09-28,8:30 AM,1,3,0,0,0,4,2023-09-28T13:30:10.444Z
2023-09-28,9:30 AM,4,3,9,1,0,17,2023-09-28T14:30:42.187Z
2023-09-28,10:30 AM,6,8,9,2,0,25,2023-09-28T15:40:19.084Z
2023-09-28,11:30 AM,17,5,28,0,5,55,2023-09-28T16:36:49.730Z
2023-09-28,12:30 PM,16,4,21,6,5,52,2023-09-28T17:34:37.259Z
2023-09-28,1:30 PM,17,7,19,2,6,51,2023-09-28T18:37:39.435Z
2023-09-28,2:30 PM,8,3,13,1,8,33,2023-09-28T19:35:12.518Z
2023-09-28,5:30 PM,3,4,5,4,0,16,2023-09-28T22:48:13.877Z
2023-09-28,6:30 PM,2,4,9,2,1,18,2023-09-28T23:33:06.828Z
2023-09-29,8:30 AM,1,2,1,0,0,4,2023-09-29T13:45:44.497Z
2023-09-29,9:30 AM,1,4,4,0,0,9,2023-09-29T14:33:34.895Z
2023-09-29,10:30 AM,4,2,3,0,0,9,2023-09-29T15:39:58.021Z
2023-09-29,11:30 AM,2,2,3,0,3,10,2023-09-29T16:30:44.458Z
2023-09-29,12:30 PM,3,4,5,0,1,13,2023-09-29T17:39:39.665Z
2023-09-29,1:30 PM,4,2,6,1,1,14,2023-09-29T18:32:35.065Z
2023-09-29,2:30 PM,1,4,7,0,2,14,2023-09-29T19:32:28.153Z
2023-09-29,4:30 PM,1,2,6,0,1,10,2023-09-29T21:34:35.740Z
2023-09-29,5:30 PM,2,2,4,0,0,8,2023-09-29T22:32:52.265Z
2023-09-30,10:30 AM,1,0,2,0,1,4,2023-09-30T15:30:43.401Z
2023-09-30,11:30 AM,1,0,1,1,1,4,2023-09-30T16:33:39.437Z
2023-09-30,12:30 PM,4,1,3,3,0,11,2023-09-30T17:39:14.113Z
2023-09-30,1:30 PM,6,1,2,0,0,9,2023-09-30T18:43:30.036Z
2023-09-30,2:30 PM,1,0,2,0,0,3,2023-09-30T19:34:27.789Z
2023-09-30,3:30 PM,4,1,1,1,1,8,2023-09-30T20:34:14.211Z
2023-09-30,4:30 PM,0,1,3,1,2,7,2023-09-30T21:32:36.712Z
2023-10-02,8:30 AM,0,2,4,0,0,6,2023-10-02T13:40:02.052Z
2023-10-02,9:30 AM,9,6,15,1,0,31,2023-10-02T14:33:13.636Z
2023-10-02,10:30 AM,3,10,21,3,0,37,2023-10-02T15:33:29.665Z
2023-10-02,11:30 AM,10,5,13,5,2,35,2023-10-02T16:53:40.238Z
2023-10-02,1:30 PM,13,8,18,4,5,48,2023-10-02T19:37:50.570Z
2023-10-02,2:30 PM,16,4,15,9,10,54,2023-10-02T19:39:18.434Z
2023-10-02,4:30 PM,6,5,5,5,7,28,2023-10-02T21:38:38.823Z
2023-10-02,5:30 PM,9,3,10,0,2,24,2023-10-02T22:32:34.932Z
2023-10-02,6:30 PM,5,2,5,1,1,14,2023-10-02T23:32:44.080Z
2023-10-02,7:30 PM,4,1,6,0,3,14,2023-10-03T00:33:10.944Z
2023-10-03,8:30 AM,2,2,2,0,0,6,2023-10-03T13:33:51.688Z
2023-10-03,9:30 AM,1,2,9,3,0,15,2023-10-03T14:40:17.126Z
2023-10-03,10:30 AM,11,6,9,0,0,26,2023-10-03T15:34:30.948Z
2023-10-03,11:30 AM,7,3,16,14,14,54,2023-10-03T16:37:35.357Z
2023-10-03,1:30 PM,10,5,15,2,9,41,2023-10-03T18:53:24.190Z
2023-10-03,2:30 PM,7,5,19,4,9,44,2023-10-03T19:58:10.655Z
2023-10-03,3:30 PM,9,7,15,2,9,42,2023-10-03T20:40:53.925Z
2023-10-03,4:30 PM,8,7,10,3,5,33,2023-10-03T21:34:04.759Z
2023-10-03,5:30 PM,1,7,11,2,4,25,2023-10-03T22:34:25.340Z
2023-10-03,6:30 PM,2,1,7,2,3,15,2023-10-03T23:32:57.265Z
2023-10-04,8:30 AM,4,0,3,0,2,9,2023-10-04T13:36:36.995Z
2023-10-04,9:30 AM,5,4,10,0,7,26,2023-10-04T14:41:23.591Z
2023-10-04,10:30 AM,22,7,21,0,7,57,2023-10-04T15:52:04.748Z
2023-10-04,12:30 PM,17,7,20,7,5,56,2023-10-04T17:30:32.929Z
2023-10-04,1:30 PM,19,6,22,8,8,63,2023-10-04T18:52:38.525Z
2023-10-04,2:30 PM,8,3,15,7,18,51,2023-10-04T19:49:16.916Z
2023-10-04,3:30 PM,9,6,13,3,8,39,2023-10-04T20:50:59.391Z
2023-10-04,4:30 PM,8,5,14,2,6,35,2023-10-04T21:35:58.295Z
2023-10-04,5:30 PM,6,0,7,2,5,20,2023-10-04T22:49:38.342Z
2023-10-04,6:30 PM,0,0,6,1,4,11,2023-10-04T23:32:40.933Z
2023-10-04,7:30 PM,3,0,2,3,1,9,2023-10-05T00:37:47.053Z
2023-10-05,8:30 AM,0,1,2,0,0,3,2023-10-05T13:28:08.396Z
2023-10-05,9:30 AM,2,2,4,1,0,9,2023-10-05T14:33:28.425Z
2023-10-05,10:30 AM,3,4,12,2,0,21,2023-10-05T15:29:23.099Z
2023-10-05,12:30 PM,16,4,23,5,0,48,2023-10-05T17:35:38.045Z
2023-10-05,1:30 PM,7,5,13,6,5,36,2023-10-05T18:45:19.603Z
2023-10-05,2:30 PM,6,7,15,2,5,35,2023-10-05T19:37:04.841Z
2023-10-05,3:30 PM,7,3,9,0,1,20,2023-10-05T20:39:19.203Z
2023-10-05,4:30 PM,6,3,5,2,2,18,2023-10-05T21:33:23.919Z
2023-10-05,5:30 PM,1,1,6,1,3,12,2023-10-05T22:31:45.780Z
2023-10-05,7:30 PM,4,1,2,2,1,10,2023-10-06T00:36:52.489Z
2023-10-06,8:30 AM,0,1,0,0,0,1,2023-10-06T13:30:53.336Z
2023-10-06,9:30 AM,3,2,1,0,0,6,2023-10-06T14:32:00.432Z
2023-10-06,10:30 AM,1,4,1,0,0,6,2023-10-06T15:33:23.730Z
2023-10-06,11:30 AM,4,5,3,2,1,15,2023-10-06T16:36:57.548Z
2023-10-06,12:30 PM,13,4,5,1,3,26,2023-10-06T17:36:53.651Z
2023-10-06,1:30 PM,6,5,3,2,6,22,2023-10-06T18:36:04.356Z
2023-10-06,2:30 PM,4,4,6,3,5,22,2023-10-06T19:39:49.459Z
2023-10-06,3:30 PM,7,4,4,1,10,26,2023-10-06T20:41:17.292Z
2023-10-06,4:30 PM,5,3,4,2,9,23,2023-10-06T21:33:59.910Z
2023-10-06,5:30 PM,1,1,3,0,12,17,2023-10-06T22:35:21.872Z
2023-10-07,10:30 AM,0,0,2,0,0,2,2023-10-07T15:46:40.932Z
2023-10-07,11:30 AM,3,0,2,0,0,5,2023-10-07T16:58:11.611Z
2023-10-07,12:30 PM,6,0,1,1,2,10,2023-10-07T17:33:44.028Z
2023-10-07,1:30 PM,2,1,2,0,4,9,2023-10-07T18:45:49.443Z
2023-10-07,2:30 PM,2,1,1,0,4,8,2023-10-07T19:35:50.014Z
2023-10-07,3:30 PM,5,1,1,0,3,10,2023-10-07T20:31:46.212Z
2023-10-07,4:30 PM,5,1,0,0,1,7,2023-10-07T21:33:45.649Z
2023-10-09,8:30 AM,7,2,16,0,0,25,2023-10-09T13:38:54.122Z
2023-10-09,9:30 AM,5,8,13,3,0,29,2023-10-09T14:34:22.856Z
2023-10-09,10:30 AM,12,9,22,4,0,47,2023-10-09T15:29:10.731Z
2023-10-09,11:30 AM,7,5,12,8,3,35,2023-10-09T16:33:39.152Z
2023-10-09,12:30 PM,17,9,18,1,4,49,2023-10-09T17:27:48.305Z
2023-10-09,1:30 PM,9,7,21,3,3,43,2023-10-09T18:44:42.568Z
2023-10-09,2:30 PM,7,6,14,3,3,33,2023-10-09T20:42:10.286Z
2023-10-09,3:30 PM,13,8,14,1,3,39,2023-10-09T20:45:09.998Z
2023-10-09,4:30 PM,6,4,10,1,4,25,2023-10-09T21:32:38.799Z
2023-10-09,5:30 PM,5,4,11,2,2,24,2023-10-09T22:51:48.342Z
2023-10-09,6:30 PM,4,4,10,2,0,20,2023-10-09T23:40:43.825Z
2023-10-10,8:30 AM,3,5,14,0,0,22,2023-10-10T13:25:30.720Z
2023-10-10,9:30 AM,7,7,9,2,0,25,2023-10-10T14:27:12.430Z
2023-10-10,10:30 AM,16,10,16,4,0,46,2023-10-10T15:42:55.615Z
2023-10-10,12:30 PM,11,6,19,4,2,42,2023-10-10T17:40:42.873Z
2023-10-10,1:30 PM,10,5,10,2,4,31,2023-10-10T18:53:55.091Z
2023-10-10,2:30 PM,14,9,12,4,4,43,2023-10-10T19:52:25.314Z
2023-10-10,3:30 PM,15,6,18,4,2,45,2023-10-10T20:40:39.584Z
2023-10-10,4:30 PM,10,4,15,5,1,35,2023-10-10T21:34:50.174Z
2023-10-10,5:30 PM,11,4,13,3,1,32,2023-10-10T22:35:53.026Z
2023-10-10,6:30 PM,6,3,3,2,1,15,2023-10-10T23:32:28.724Z
2023-10-10,7:30 PM,6,2,2,1,0,11,2023-10-11T00:34:32.806Z
2023-10-10,7:30 PM,3,2,1,0,1,7,2023-10-11T00:44:33.014Z
2023-10-11,8:30 AM,0,1,11,0,0,12,2023-10-11T13:29:52.923Z
2023-10-11,9:30 AM,1,6,10,2,0,19,2023-10-11T14:34:56.560Z
2023-10-11,10:30 AM,5,6,22,4,0,37,2023-10-11T15:53:35.093Z
2023-10-11,11:30 AM,7,9,13,1,7,37,2023-10-11T16:31:24.653Z
2023-10-11,12:30 PM,12,10,26,5,7,60,2023-10-11T17:35:24.593Z
2023-10-11,1:30 PM,12,8,25,5,6,56,2023-10-11T18:42:13.527Z
2023-10-11,2:30 PM,9,8,16,2,6,41,2023-10-11T19:38:09.160Z
2023-10-11,3:30 PM,11,4,11,2,0,28,2023-10-11T20:45:27.269Z
2023-10-11,4:30 PM,9,6,9,1,1,26,2023-10-11T21:34:27.135Z
2023-10-11,6:30 PM,6,5,4,1,0,16,2023-10-11T23:34:07.033Z
2023-10-11,7:30 PM,5,0,3,1,3,12,2023-10-12T00:37:18.829Z
2023-10-12,8:30 AM,3,3,9,0,0,15,2023-10-12T13:32:36.539Z
2023-10-12,9:30 AM,7,5,4,1,0,17,2023-10-12T14:28:47.982Z
2023-10-12,10:30 AM,10,10,14,4,0,38,2023-10-12T15:51:28.926Z
2023-10-12,1:30 PM,13,6,15,5,5,44,2023-10-12T18:39:55.209Z
2023-10-12,2:30 PM,9,4,10,2,1,26,2023-10-12T19:40:28.971Z
2023-10-12,3:30 PM,9,4,6,1,9,29,2023-10-12T20:37:07.099Z
2023-10-12,4:30 PM,4,2,7,3,0,16,2023-10-12T21:33:35.506Z
2023-10-12,5:30 PM,7,1,5,2,0,15,2023-10-12T22:33:10.083Z
2023-10-12,6:30 PM,3,3,6,0,0,12,2023-10-12T23:33:14.247Z
2023-10-13,8:30 AM,1,2,0,0,0,3,2023-10-13T13:31:24.544Z
2023-10-13,9:30 AM,4,2,1,1,0,8,2023-10-13T14:27:32.762Z
2023-10-13,10:30 AM,0,6,2,1,0,9,2023-10-13T15:31:44.645Z
2023-10-13,11:30 AM,5,4,1,0,1,11,2023-10-13T16:40:16.502Z
2023-10-13,12:30 PM,6,2,4,0,1,13,2023-10-13T17:33:16.818Z
2023-10-13,1:30 PM,3,1,3,0,0,7,2023-10-13T18:37:20.674Z
2023-10-13,2:30 PM,2,2,5,0,2,11,2023-10-13T19:40:23.995Z
2023-10-13,3:30 PM,0,1,5,1,0,7,2023-10-13T20:41:53.413Z
2023-10-13,4:30 PM,2,1,3,0,0,6,2023-10-13T21:34:36.639Z
2023-10-13,5:30 PM,5,0,4,0,0,9,2023-10-13T22:36:06.707Z
2023-10-14,10:30 AM,3,1,3,1,0,8,2023-10-14T15:35:51.059Z
2023-10-14,11:30 AM,4,1,5,1,0,11,2023-10-14T16:39:33.988Z
2023-10-14,12:30 PM,5,0,5,1,1,12,2023-10-14T17:40:21.158Z
2023-10-14,1:30 PM,6,0,8,2,0,16,2023-10-14T18:35:29.105Z
2023-10-14,2:30 PM,3,0,6,0,0,9,2023-10-14T19:37:13.527Z
2023-10-14,3:30 PM,0,0,4,0,0,4,2023-10-14T20:33:41.468Z
2023-10-14,4:30 PM,3,0,5,0,0,8,2023-10-14T21:33:34.255Z
2023-10-16,8:30 AM,3,1,5,0,0,9,2023-10-16T13:46:33.537Z
2023-10-16,9:30 AM,6,2,7,1,0,16,2023-10-16T14:33:19.525Z
2023-10-16,10:30 AM,5,7,15,2,0,29,2023-10-16T15:45:25.901Z
2023-10-16,11:30 AM,5,3,14,4,3,29,2023-10-16T16:29:58.038Z
2023-10-16,12:30 PM,10,2,22,3,0,37,2023-10-16T17:32:45.215Z
2023-10-16,1:30 PM,13,6,23,4,1,47,2023-10-16T18:41:06.056Z
2023-10-16,2:30 PM,8,3,16,8,9,44,2023-10-16T19:40:15.045Z
2023-10-16,3:30 PM,10,4,9,7,9,39,2023-10-16T20:47:09.320Z
2023-10-16,4:30 PM,6,4,8,4,0,22,2023-10-16T21:40:29.811Z
2023-10-16,5:30 PM,18,4,6,2,0,30,2023-10-16T22:33:10.175Z
2023-10-16,6:30 PM,5,2,0,3,0,10,2023-10-16T23:33:36.212Z
2023-10-16,7:30 PM,5,1,2,2,0,10,2023-10-17T00:38:23.944Z
2023-10-17,8:30 AM,3,2,3,0,0,8,2023-10-17T13:38:56.258Z
2023-10-17,9:30 AM,7,3,8,1,0,19,2023-10-17T14:28:59.329Z
2023-10-17,10:30 AM,10,6,16,4,0,36,2023-10-17T15:32:51.452Z
2023-10-17,12:30 PM,16,8,28,4,4,60,2023-10-17T17:30:22.519Z
2023-10-17,1:30 PM,7,5,11,1,12,36,2023-10-17T18:41:21.241Z
2023-10-17,3:30 PM,13,4,2,3,8,30,2023-10-17T20:42:40.020Z
2023-10-17,4:30 PM,9,7,11,4,0,31,2023-10-17T21:33:44.326Z
2023-10-17,5:30 PM,6,3,6,5,0,20,2023-10-17T22:34:18.367Z
2023-10-17,7:30 PM,2,2,3,2,1,10,2023-10-18T00:47:45.022Z
2023-10-18,8:30 AM,4,1,4,0,0,9,2023-10-18T13:31:15.912Z
2023-10-18,9:30 AM,3,4,12,1,0,20,2023-10-18T14:43:23.705Z
2023-10-18,10:30 AM,6,6,13,0,0,25,2023-10-18T15:22:55.983Z
2023-10-18,11:30 AM,27,3,13,1,4,48,2023-10-18T16:34:28.217Z
2023-10-18,12:30 PM,14,7,20,5,15,61,2023-10-18T17:38:41.687Z
2023-10-18,1:30 PM,19,5,14,1,12,51,2023-10-18T18:40:31.293Z
2023-10-18,2:30 PM,14,3,14,0,11,42,2023-10-18T19:31:00.771Z
2023-10-18,5:30 PM,8,3,8,1,4,24,2023-10-18T22:41:03.297Z
2023-10-18,6:30 PM,4,3,3,1,1,12,2023-10-18T23:46:23.475Z
2023-10-18,7:30 PM,1,3,1,0,1,6,2023-10-19T00:41:06.920Z
2023-10-19,8:30 AM,1,2,3,1,0,7,2023-10-19T13:32:44.709Z
2023-10-19,9:30 AM,1,2,6,0,0,9,2023-10-19T14:46:03.140Z
2023-10-19,10:30 AM,4,7,9,3,0,23,2023-10-19T15:31:46.276Z
2023-10-19,1:30 PM,19,6,15,0,2,42,2023-10-19T18:31:26.582Z
2023-10-19,2:30 PM,16,5,16,3,4,44,2023-10-19T19:36:33.843Z
2023-10-19,3:30 PM,9,7,8,0,6,30,2023-10-19T20:41:55.152Z
2023-10-19,4:30 PM,10,6,9,2,3,30,2023-10-19T21:36:15.538Z
2023-10-19,5:30 PM,8,0,4,0,2,14,2023-10-19T22:52:43.293Z
2023-10-19,6:30 PM,2,0,2,0,0,4,2023-10-19T23:32:41.476Z
2023-10-20,8:30 AM,0,1,1,0,0,2,2023-10-20T13:30:32.339Z
2023-10-20,9:30 AM,0,2,1,0,0,3,2023-10-20T14:30:33.900Z
2023-10-20,10:30 AM,0,2,2,0,0,4,2023-10-20T15:28:13.956Z
2023-10-20,11:30 AM,2,1,3,1,5,12,2023-10-20T16:33:45.205Z
2023-10-20,12:30 PM,1,2,3,1,5,12,2023-10-20T17:35:28.406Z
2023-10-20,1:30 PM,2,2,5,1,4,14,2023-10-20T18:44:45.740Z
2023-10-20,2:30 PM,2,1,5,0,2,10,2023-10-20T19:37:41.799Z
2023-10-20,4:30 PM,10,1,5,0,5,21,2023-10-20T21:38:38.430Z
2023-10-20,5:30 PM,6,0,3,0,7,16,2023-10-20T22:36:02.516Z
2023-10-20,6:30 PM,2,0,1,0,3,6,2023-10-20T23:36:16.869Z
2023-10-21,10:30 AM,3,1,2,1,0,7,2023-10-21T15:33:44.102Z
2023-10-21,11:30 AM,2,1,2,1,0,6,2023-10-21T16:38:18.054Z
2023-10-21,12:30 PM,8,1,0,2,0,11,2023-10-21T17:48:59.866Z
2023-10-21,1:30 PM,8,2,3,0,0,13,2023-10-21T18:36:14.966Z
2023-10-21,2:30 PM,7,2,6,1,1,17,2023-10-21T19:35:11.033Z
2023-10-21,3:30 PM,4,2,3,0,0,9,2023-10-21T20:36:00.875Z
2023-10-23,8:30 AM,5,5,14,1,0,25,2023-10-23T13:46:51.509Z
2023-10-23,9:30 AM,5,4,15,1,0,25,2023-10-23T14:32:48.463Z
2023-10-23,11:30 AM,8,6,21,2,0,37,2023-10-23T16:47:55.431Z
2023-10-23,12:30 PM,13,9,19,4,7,52,2023-10-23T17:39:03.369Z
2023-10-23,1:30 PM,22,6,22,5,10,65,2023-10-23T18:34:25.319Z
2023-10-23,2:30 PM,22,5,10,6,0,43,2023-10-23T19:33:56.217Z
2023-10-23,4:30 PM,5,3,6,3,9,26,2023-10-23T21:40:30.929Z
2023-10-23,5:30 PM,9,0,5,0,7,21,2023-10-23T22:47:08.123Z
2023-10-23,6:30 PM,2,2,3,0,0,7,2023-10-23T23:35:49.116Z
2023-10-23,7:30 PM,7,1,3,2,0,13,2023-10-24T00:40:02.154Z
2023-10-24,8:30 AM,2,1,0,0,0,3,2023-10-24T13:34:18.978Z
2023-10-24,9:30 AM,4,6,6,4,0,20,2023-10-24T14:29:45.763Z
2023-10-24,10:30 AM,9,7,26,1,0,43,2023-10-24T15:32:32.443Z
2023-10-24,12:30 PM,16,6,20,4,2,48,2023-10-24T17:43:56.073Z
2023-10-24,1:30 PM,10,7,10,1,7,35,2023-10-24T18:42:58.318Z
2023-10-24,2:30 PM,28,6,15,5,5,59,2023-10-24T19:34:12.355Z
2023-10-24,3:30 PM,13,2,12,3,0,30,2023-10-24T20:43:39.802Z
2023-10-24,4:30 PM,7,4,4,2,0,17,2023-10-24T21:33:17.823Z
2023-10-24,5:30 PM,6,3,5,1,0,15,2023-10-24T22:33:55.924Z
2023-10-24,6:30 PM,3,0,6,1,0,10,2023-10-24T23:34:08.940Z
2023-10-25,8:30 AM,1,0,4,0,0,5,2023-10-25T13:35:18.583Z
2023-10-25,9:30 AM,2,4,11,1,0,18,2023-10-25T14:38:36.180Z
2023-10-25,10:30 AM,3,7,14,2,0,26,2023-10-25T15:32:12.939Z
2023-10-25,3:30 PM,10,6,16,8,0,40,2023-10-25T20:36:26.053Z
2023-10-25,4:30 PM,6,3,7,4,0,20,2023-10-25T21:34:47.882Z
2023-10-25,5:30 PM,5,3,1,1,1,11,2023-10-25T22:30:36.896Z
2023-10-25,6:30 PM,3,1,0,0,0,4,2023-10-25T23:34:15.242Z
2023-10-26,8:30 AM,2,2,17,1,0,22,2023-10-26T13:42:10.524Z
2023-10-26,9:30 AM,5,3,4,3,0,15,2023-10-26T14:33:56.716Z
2023-10-26,10:30 AM,5,4,8,6,0,23,2023-10-26T15:25:14.615Z
2023-10-26,12:30 PM,15,8,21,7,9,60,2023-10-26T17:40:11.296Z
2023-10-26,1:30 PM,28,4,22,5,9,68,2023-10-26T18:30:21.860Z
2023-10-26,2:30 PM,25,4,22,9,5,65,2023-10-26T19:31:09.064Z
2023-10-26,3:30 PM,22,5,13,1,3,44,2023-10-26T20:44:37.290Z
2023-10-26,4:30 PM,5,4,7,3,0,19,2023-10-26T21:34:25.350Z
2023-10-26,5:30 PM,5,3,5,5,0,18,2023-10-26T22:35:36.051Z
2023-10-26,6:30 PM,1,2,4,3,1,11,2023-10-26T23:34:50.425Z
2023-10-26,7:30 PM,3,0,3,0,3,9,2023-10-27T00:45:17.312Z
2023-10-27,9:30 AM,0,1,0,0,0,1,2023-10-27T14:17:38.803Z
2023-10-27,8:30 AM,0,1,0,0,0,1,2023-10-27T14:18:13.266Z
2023-10-27,9:30 AM,1,1,1,0,0,3,2023-10-27T14:35:36.935Z
2023-10-27,10:30 AM,1,1,4,0,0,6,2023-10-27T15:43:56.711Z
2023-10-27,11:30 AM,4,0,4,0,6,14,2023-10-27T16:34:17.952Z
2023-10-27,12:30 PM,8,1,5,0,6,20,2023-10-27T17:40:40.111Z
2023-10-27,1:30 PM,11,1,5,2,7,26,2023-10-27T18:39:18.161Z
2023-10-27,2:30 PM,3,2,5,2,3,15,2023-10-27T19:40:18.530Z
2023-10-27,3:30 PM,6,2,5,1,0,14,2023-10-27T20:49:54.483Z
2023-10-27,4:30 PM,2,2,1,0,0,5,2023-10-27T21:36:24.353Z
2023-10-27,5:30 PM,2,0,1,0,0,3,2023-10-27T22:32:24.390Z
2023-10-28,10:30 AM,1,0,3,0,0,4,2023-10-28T15:42:31.769Z
2023-10-28,11:30 AM,2,0,3,0,3,8,2023-10-28T16:47:55.750Z
2023-10-28,1:30 PM,10,0,5,0,0,15,2023-10-28T18:40:27.859Z
2023-10-28,2:30 PM,8,0,8,0,0,16,2023-10-28T19:33:01.028Z
2023-10-28,3:30 PM,3,0,3,0,0,6,2023-10-28T20:33:57.857Z
2023-10-28,4:30 PM,1,0,1,0,0,2,2023-10-28T21:31:27.031Z
2023-10-30,8:30 AM,2,3,7,0,0,12,2023-10-30T14:30:54.708Z
2023-10-30,9:30 AM,6,4,9,1,0,20,2023-10-30T14:31:40.938Z
2023-10-30,10:30 AM,7,4,7,3,0,21,2023-10-30T15:39:36.493Z
2023-10-30,11:30 AM,8,5,13,2,3,31,2023-10-30T16:46:52.360Z
2023-10-30,12:30 PM,14,10,20,11,6,61,2023-10-30T17:39:20.338Z
2023-10-30,1:30 PM,11,5,20,2,6,44,2023-10-30T18:38:29.868Z
2023-10-30,2:30 PM,10,2,8,3,10,33,2023-10-30T19:52:27.665Z
2023-10-30,3:30 PM,11,5,8,4,3,31,2023-10-30T20:51:26.278Z
2023-10-30,4:30 PM,6,2,11,4,5,28,2023-10-30T21:29:21.178Z
2023-10-31,8:30 AM,7,3,2,4,0,16,2023-10-31T14:17:58.862Z
2023-10-31,9:30 AM,4,1,3,1,0,9,2023-10-31T14:34:24.712Z
2023-10-31,10:30 AM,5,5,7,3,0,20,2023-10-31T15:36:55.628Z
2023-10-31,11:30 AM,11,3,8,3,12,37,2023-10-31T16:32:35.416Z
2023-10-31,12:30 PM,11,6,14,13,12,56,2023-10-31T18:12:43.423Z
2023-10-31,1:30 PM,13,4,17,4,10,48,2023-10-31T18:56:50.711Z
2023-10-31,2:30 PM,13,9,13,4,0,39,2023-10-31T19:44:35.094Z
2023-10-31,3:30 PM,9,8,12,2,0,31,2023-10-31T20:36:39.426Z
2023-10-31,4:30 PM,6,8,1,4,1,20,2023-10-31T21:37:00.821Z
2023-10-31,5:30 PM,7,3,3,0,0,13,2023-10-31T22:34:04.971Z
2023-10-31,6:30 PM,3,3,2,0,0,8,2023-10-31T23:34:45.221Z
2023-10-31,7:30 PM,1,4,2,0,0,7,2023-11-01T00:33:50.879Z
2023-11-01,8:30 AM,2,3,8,0,0,13,2023-11-01T14:15:59.837Z
2023-11-01,9:30 AM,0,4,8,1,0,13,2023-11-01T14:39:18.871Z
2023-11-01,10:30 AM,2,9,10,0,0,21,2023-11-01T15:30:43.479Z
2023-11-01,11:30 AM,11,6,15,0,4,36,2023-11-01T16:32:39.624Z
2023-11-01,12:30 PM,23,8,17,0,4,52,2023-11-01T17:37:04.210Z
2023-11-01,1:30 PM,11,3,12,1,11,38,2023-11-01T18:39:55.244Z
2023-11-01,2:30 PM,10,4,11,3,3,31,2023-11-01T19:43:20.296Z
2023-11-01,3:30 PM,5,4,15,1,0,25,2023-11-01T20:38:17.400Z
2023-11-01,4:30 PM,5,1,7,1,1,15,2023-11-01T21:34:03.363Z
2023-11-01,5:30 PM,7,1,8,3,0,19,2023-11-01T22:41:30.396Z
2023-11-02,8:30 AM,2,2,0,1,0,5,2023-11-02T13:31:37.979Z
2023-11-02,9:30 AM,3,1,4,1,0,9,2023-11-02T14:33:37.906Z
2023-11-02,10:30 AM,3,5,10,1,0,19,2023-11-02T15:30:56.884Z
2023-11-02,11:30 AM,6,5,5,3,3,22,2023-11-02T16:35:54.450Z
2023-11-02,1:30 PM,11,4,13,1,9,38,2023-11-02T18:37:23.578Z
2023-11-02,2:30 PM,10,6,11,1,5,33,2023-11-02T19:30:22.951Z
2023-11-02,3:30 PM,6,6,10,3,7,32,2023-11-02T20:44:58.076Z
2023-11-02,4:30 PM,6,7,13,4,9,39,2023-11-02T21:34:27.877Z
2023-11-02,5:30 PM,6,1,4,0,0,11,2023-11-02T22:47:59.493Z
2023-11-02,6:30 PM,3,1,1,0,0,5,2023-11-02T23:36:28.970Z
2023-11-03,8:30 AM,0,1,1,0,0,2,2023-11-03T13:31:59.294Z
2023-11-03,9:30 AM,1,2,1,1,0,5,2023-11-03T14:40:17.194Z
2023-11-03,10:30 AM,0,2,2,0,0,4,2023-11-03T15:39:19.497Z
2023-11-03,11:30 AM,6,1,0,1,2,10,2023-11-03T16:36:20.100Z
2023-11-03,12:30 PM,5,0,4,2,4,15,2023-11-03T17:37:26.241Z
2023-11-03,1:30 PM,3,1,4,2,1,11,2023-11-03T18:36:31.999Z
2023-11-03,2:30 PM,4,3,7,2,0,16,2023-11-03T19:35:30.992Z
2023-11-03,3:30 PM,7,1,7,3,1,19,2023-11-03T20:44:49.629Z
2023-11-03,4:30 PM,5,1,5,1,0,12,2023-11-03T21:32:37.440Z
2023-11-03,5:30 PM,0,2,3,1,0,6,2023-11-03T22:30:48.054Z
2023-11-03,6:30 PM,1,1,0,2,0,4,2023-11-03T23:31:21.588Z
2023-11-04,10:30 AM,0,0,0,0,0,0,2023-11-04T15:44:22.174Z
2023-11-04,11:30 AM,2,1,1,2,0,6,2023-11-04T16:46:46.744Z
2023-11-04,12:30 PM,1,2,6,1,1,11,2023-11-04T17:42:50.269Z
2023-11-04,2:30 PM,4,0,4,2,0,10,2023-11-04T19:37:30.933Z
2023-11-04,3:30 PM,3,1,5,2,2,13,2023-11-04T20:39:03.890Z
2023-11-04,4:30 PM,2,1,5,2,2,12,2023-11-04T22:12:21.899Z
2023-11-06,8:30 AM,3,1,1,0,0,5,2023-11-06T14:31:37.282Z
2023-11-06,9:30 AM,3,3,7,3,0,16,2023-11-06T15:46:16.976Z
2023-11-06,10:30 AM,7,6,8,2,0,23,2023-11-06T16:35:31.797Z
2023-11-06,11:30 AM,11,3,14,3,5,36,2023-11-06T17:41:21.524Z
2023-11-06,12:30 PM,20,4,19,1,4,48,2023-11-06T18:29:33.806Z
2023-11-06,1:30 PM,14,4,21,1,6,46,2023-11-06T19:36:23.422Z
2023-11-06,2:30 PM,12,4,14,3,2,35,2023-11-06T21:29:05.623Z
2023-11-06,3:30 PM,9,3,15,6,3,36,2023-11-06T21:35:24.123Z
2023-11-06,4:30 PM,4,4,7,2,0,17,2023-11-06T22:51:13.795Z
2023-11-06,6:30 PM,5,1,1,0,0,7,2023-11-07T00:41:35.507Z
2023-11-06,7:30 PM,5,2,5,0,0,12,2023-11-07T01:48:45.673Z
2023-11-07,8:30 AM,3,0,3,0,0,6,2023-11-07T14:25:15.277Z
2023-11-07,9:30 AM,5,5,7,1,0,18,2023-11-07T15:30:55.263Z
2023-11-07,10:30 AM,13,8,13,4,0,38,2023-11-07T16:39:53.610Z
2023-11-07,1:30 PM,13,5,10,7,7,42,2023-11-07T19:39:51.040Z
2023-11-07,3:30 PM,15,4,12,8,4,43,2023-11-07T21:09:31.050Z
2023-11-07,3:30 PM,11,11,15,8,0,45,2023-11-07T21:39:39.102Z
2023-11-07,4:30 PM,6,10,10,3,0,29,2023-11-07T22:34:27.285Z
2023-11-07,5:30 PM,8,4,7,3,0,22,2023-11-07T23:33:08.428Z
2023-11-07,6:30 PM,6,0,4,0,1,11,2023-11-08T00:39:10.656Z
2023-11-08,8:30 AM,1,0,3,0,0,4,2023-11-08T14:37:33.593Z
2023-11-08,9:30 AM,1,5,14,1,0,21,2023-11-08T15:39:42.829Z
2023-11-08,10:30 AM,5,4,11,1,0,21,2023-11-08T16:31:13.049Z
2023-11-08,11:30 AM,11,4,29,4,3,51,2023-11-08T17:36:39.530Z
2023-11-08,12:30 PM,20,13,29,5,4,71,2023-11-08T18:35:47.953Z
2023-11-08,1:30 PM,16,7,17,1,2,43,2023-11-08T19:38:59.260Z
2023-11-08,2:30 PM,14,2,19,4,6,45,2023-11-08T20:42:02.273Z
2023-11-08,3:30 PM,6,4,8,2,0,20,2023-11-08T21:47:48.142Z
2023-11-08,4:30 PM,9,3,5,4,0,21,2023-11-08T22:34:15.743Z
2023-11-08,5:30 PM,4,2,3,3,0,12,2023-11-08T23:34:02.518Z
2023-11-08,5:30 PM,5,2,4,3,0,14,2023-11-08T23:40:26.532Z
2023-11-08,6:30 PM,6,1,3,4,0,14,2023-11-09T00:33:21.419Z
2023-11-09,8:30 AM,3,3,2,1,1,10,2023-11-09T14:40:07.054Z
2023-11-09,9:30 AM,1,2,5,1,0,9,2023-11-09T15:35:54.263Z
2023-11-09,10:30 AM,4,6,5,2,0,17,2023-11-09T16:32:00.435Z
2023-11-09,11:30 AM,7,6,10,2,1,26,2023-11-09T17:39:36.209Z
2023-11-09,1:30 PM,13,4,18,4,5,44,2023-11-09T19:43:16.970Z
2023-11-09,2:30 PM,11,5,11,6,8,41,2023-11-09T20:48:35.440Z
2023-11-09,3:30 PM,14,4,14,9,14,55,2023-11-09T21:28:38.731Z
2023-11-09,4:30 PM,8,2,11,1,2,24,2023-11-09T22:35:12.331Z
2023-11-09,5:30 PM,5,3,8,2,1,19,2023-11-09T23:37:59.688Z
2023-11-09,6:30 PM,4,2,3,0,1,10,2023-11-10T00:36:43.822Z
2023-11-10,8:30 AM,0,1,1,0,0,2,2023-11-10T14:33:25.843Z
2023-11-10,10:30 AM,3,2,1,0,0,6,2023-11-10T16:35:57.894Z
2023-11-10,11:30 AM,6,0,1,0,4,11,2023-11-10T17:36:03.709Z
2023-11-10,12:30 PM,4,2,1,0,6,13,2023-11-10T18:42:25.473Z
2023-11-10,1:30 PM,6,2,2,1,6,17,2023-11-10T19:37:01.514Z
2023-11-10,2:30 PM,5,1,2,0,6,14,2023-11-10T20:32:56.003Z
2023-11-10,3:30 PM,5,1,4,0,0,10,2023-11-10T21:39:46.738Z
2023-11-10,4:30 PM,4,0,4,0,0,8,2023-11-10T22:33:17.733Z
2023-11-10,5:30 PM,1,1,3,2,0,7,2023-11-10T23:47:24.584Z
2023-11-11,10:30 AM,2,3,2,2,0,9,2023-11-11T16:41:08.433Z
2023-11-11,11:30 AM,5,4,0,2,0,11,2023-11-11T17:51:12.598Z
2023-11-11,12:30 PM,3,3,5,2,0,13,2023-11-11T18:35:31.523Z
2023-11-11,1:30 PM,6,3,4,2,0,15,2023-11-11T19:28:37.539Z
2023-11-11,2:30 PM,5,0,2,1,0,8,2023-11-11T20:34:22.969Z
2023-11-11,3:30 PM,7,1,2,1,0,11,2023-11-11T21:35:10.463Z
2023-11-11,4:30 PM,3,1,1,1,0,6,2023-11-11T22:31:57.942Z
2023-11-13,8:30 AM,8,4,4,2,0,18,2023-11-13T14:38:38.509Z
2023-11-13,9:30 AM,6,4,7,1,0,18,2023-11-13T15:31:26.048Z
2023-11-13,10:30 AM,9,8,12,3,0,32,2023-11-13T16:29:03.041Z
2023-11-13,11:30 AM,8,7,15,1,0,31,2023-11-13T17:32:12.866Z
2023-11-13,12:30 PM,12,5,21,0,10,48,2023-11-13T18:34:28.759Z
2023-11-13,1:30 PM,13,6,21,9,7,56,2023-11-13T19:35:56.676Z
2023-11-13,2:30 PM,7,5,2,5,4,23,2023-11-13T20:46:55.993Z
2023-11-13,3:30 PM,6,5,10,3,4,28,2023-11-13T21:40:34.873Z
2023-11-13,4:30 PM,7,0,3,1,5,16,2023-11-13T22:38:34.202Z
2023-11-13,5:30 PM,5,2,5,2,4,18,2023-11-13T23:38:10.128Z
2023-11-14,8:30 AM,5,3,2,1,1,12,2023-11-14T14:32:58.233Z
2023-11-14,9:30 AM,7,4,9,1,0,21,2023-11-14T15:35:51.688Z
2023-11-14,10:30 AM,4,6,15,3,0,28,2023-11-14T16:29:54.366Z
2023-11-14,12:30 PM,26,7,18,2,3,56,2023-11-14T18:34:08.600Z
2023-11-14,1:30 PM,7,6,4,2,3,22,2023-11-14T19:31:37.946Z
2023-11-14,2:30 PM,9,7,5,3,8,32,2023-11-14T20:58:20.250Z
2023-11-14,3:30 PM,10,4,12,2,0,28,2023-11-14T21:52:53.826Z
2023-11-14,4:30 PM,7,5,9,1,0,22,2023-11-14T22:36:29.738Z
2023-11-14,5:30 PM,6,3,3,4,2,18,2023-11-14T23:33:20.271Z
2023-11-15,8:30 AM,2,0,3,0,0,5,2023-11-15T14:40:19.565Z
2023-11-15,9:30 AM,3,3,5,0,0,11,2023-11-15T15:28:42.145Z
2023-11-15,10:30 AM,5,4,11,1,0,21,2023-11-15T16:32:33.931Z
2023-11-15,11:30 AM,17,6,16,5,6,50,2023-11-15T17:34:18.021Z
2023-11-15,12:30 PM,7,7,20,6,5,45,2023-11-15T18:34:47.995Z
2023-11-15,1:30 PM,20,5,10,2,5,42,2023-11-15T19:37:48.225Z
2023-11-15,2:30 PM,7,6,9,5,5,32,2023-11-15T20:36:20.571Z
2023-11-15,3:30 PM,8,2,9,6,2,27,2023-11-15T21:38:22.738Z
2023-11-15,4:30 PM,9,0,7,3,0,19,2023-11-15T22:33:39.374Z
2023-11-15,5:30 PM,6,1,2,7,0,16,2023-11-15T23:36:47.228Z
2023-11-15,6:30 PM,4,1,4,7,0,16,2023-11-16T00:33:56.953Z
2023-11-16,8:30 AM,5,0,15,0,0,20,2023-11-16T14:30:51.568Z
2023-11-16,9:30 AM,6,2,7,2,0,17,2023-11-16T15:37:23.440Z
2023-11-16,10:30 AM,4,5,8,0,0,17,2023-11-16T16:31:50.372Z
2023-11-16,1:30 PM,30,3,16,12,7,68,2023-11-16T19:40:26.041Z
2023-11-16,2:30 PM,26,5,10,4,8,53,2023-11-16T20:32:40.091Z
2023-11-16,3:30 PM,16,4,6,4,0,30,2023-11-16T21:35:00.223Z
2023-11-16,4:30 PM,9,1,6,4,0,20,2023-11-16T22:33:43.368Z
2023-11-16,5:30 PM,5,1,2,0,0,8,2023-11-16T23:31:15.710Z
2023-11-16,6:30 PM,2,2,1,0,0,5,2023-11-17T00:43:17.158Z
2023-11-17,8:30 AM,1,1,0,0,0,2,2023-11-17T14:24:17.141Z
2023-11-17,9:30 AM,0,2,0,2,0,4,2023-11-17T15:32:38.439Z
2023-11-17,10:30 AM,2,2,1,0,0,5,2023-11-17T16:30:02.455Z
2023-11-17,11:30 AM,3,1,2,0,0,6,2023-11-17T17:40:03.650Z
2023-11-17,12:30 PM,3,2,1,0,1,7,2023-11-17T18:35:16.339Z
2023-11-17,1:30 PM,1,0,3,0,2,6,2023-11-17T19:37:45.177Z
2023-11-17,2:30 PM,2,1,1,1,2,7,2023-11-17T20:34:12.922Z
2023-11-17,3:30 PM,3,0,1,2,0,6,2023-11-17T21:48:40.856Z
2023-11-17,4:30 PM,0,0,1,1,0,2,2023-11-17T22:34:35.374Z
2023-11-17,5:30 PM,1,0,1,0,0,2,2023-11-17T23:34:54.964Z
2023-11-18,10:30 AM,3,0,1,0,1,5,2023-11-18T16:42:39.948Z
2023-11-18,11:30 AM,2,2,1,2,4,11,2023-11-18T17:43:19.988Z
2023-11-18,12:30 PM,6,2,1,2,6,17,2023-11-18T18:44:23.355Z
2023-11-18,1:30 PM,8,1,0,0,0,9,2023-11-18T19:35:41.831Z
2023-11-18,2:30 PM,9,1,9,0,0,19,2023-11-18T20:33:08.825Z
2023-11-18,3:30 PM,3,0,2,0,0,5,2023-11-18T21:34:39.854Z
2023-11-18,4:30 PM,4,0,0,0,0,4,2023-11-18T22:33:16.317Z
2023-11-20,8:30 AM,4,4,3,0,0,11,2023-11-20T14:42:37.126Z
2023-11-20,9:30 AM,7,2,4,0,0,13,2023-11-20T15:27:28.007Z
2023-11-20,10:30 AM,9,5,11,1,0,26,2023-11-20T16:46:41.202Z
2023-11-20,11:30 AM,11,6,16,2,10,45,2023-11-20T17:34:05.136Z
2023-11-20,12:30 PM,11,9,12,2,7,41,2023-11-20T18:40:31.852Z
2023-11-20,1:30 PM,9,4,12,2,8,35,2023-11-20T19:42:02.762Z
2023-11-20,2:30 PM,9,3,13,0,6,31,2023-11-20T20:34:15.660Z
2023-11-20,3:30 PM,8,7,8,3,8,34,2023-11-20T21:47:29.751Z
2023-11-20,4:30 PM,9,1,8,2,8,28,2023-11-20T22:59:59.845Z
2023-11-20,8:30 PM,3,4,2,2,0,11,2023-11-21T02:47:29.824Z
2023-11-21,10:30 AM,5,2,2,0,0,9,2023-11-21T16:34:29.428Z
2023-11-21,11:30 AM,6,1,9,5,4,25,2023-11-21T18:19:09.429Z
2023-11-21,12:30 PM,14,5,13,5,0,37,2023-11-21T18:29:23.873Z
2023-11-21,1:30 PM,7,2,10,2,6,27,2023-11-21T19:38:16.768Z
2023-11-21,2:30 PM,15,2,8,0,8,33,2023-11-21T20:37:41.806Z
2023-11-21,3:30 PM,6,3,11,2,0,22,2023-11-21T21:52:18.353Z
2023-11-21,4:30 PM,1,3,6,1,0,11,2023-11-21T22:32:44.159Z
2023-11-21,5:30 PM,1,3,5,1,0,10,2023-11-21T23:31:39.099Z
2023-11-21,6:30 PM,2,1,1,1,0,5,2023-11-22T00:34:48.321Z
2023-11-27,8:30 AM,5,3,9,1,0,18,2023-11-27T14:41:10.245Z
2023-11-27,9:30 AM,9,4,6,5,0,24,2023-11-27T15:39:49.874Z
2023-11-27,11:30 AM,9,7,14,6,7,43,2023-11-27T17:33:59.609Z
2023-11-27,12:30 PM,13,6,15,9,6,49,2023-11-27T18:55:54.662Z
2023-11-27,1:30 PM,11,6,17,0,11,45,2023-11-27T19:37:38.463Z
2023-11-27,2:30 PM,14,2,17,7,8,48,2023-11-27T20:36:26.123Z
2023-11-27,3:30 PM,8,2,14,3,9,36,2023-11-27T21:36:33.075Z
2023-11-27,4:30 PM,11,2,4,3,3,23,2023-11-27T22:39:26.627Z
2023-11-27,5:30 PM,10,3,6,6,4,29,2023-11-27T23:28:06.942Z
2023-11-27,6:30 PM,4,2,5,3,1,15,2023-11-28T00:47:42.455Z
2023-11-28,8:30 AM,15,3,3,1,0,22,2023-11-28T14:30:55.058Z
2023-11-28,9:30 AM,7,3,8,3,0,21,2023-11-28T15:50:22.857Z
2023-11-28,10:30 AM,10,10,14,4,0,38,2023-11-28T16:51:58.399Z
2023-11-28,1:30 PM,13,9,9,3,5,39,2023-11-28T19:42:48.994Z
2023-11-28,2:30 PM,10,7,15,2,4,38,2023-11-28T20:34:56.112Z
2023-11-28,3:30 PM,14,5,17,1,1,38,2023-11-28T21:45:35.483Z
2023-11-28,4:30 PM,9,5,11,1,0,26,2023-11-28T22:34:34.415Z
2023-11-28,5:30 PM,10,2,8,1,2,23,2023-11-28T23:34:14.681Z
2023-11-28,6:30 PM,7,3,3,0,0,13,2023-11-29T00:33:10.955Z
2023-11-29,8:30 AM,3,0,3,0,0,6,2023-11-29T14:25:48.620Z
2023-11-29,9:30 AM,11,4,10,0,0,25,2023-11-29T15:41:47.156Z
2023-11-29,10:30 AM,11,10,12,0,1,34,2023-11-29T16:41:19.054Z
2023-11-29,11:30 AM,18,3,10,4,4,39,2023-11-29T17:36:48.241Z
2023-11-29,12:30 PM,15,7,10,6,2,40,2023-11-29T18:31:58.904Z
2023-11-29,1:30 PM,11,5,14,1,6,37,2023-11-29T19:36:36.118Z
2023-11-29,2:30 PM,8,8,9,6,12,43,2023-11-29T20:35:51.079Z
2023-11-29,3:30 PM,13,5,7,7,0,32,2023-11-29T21:46:58.139Z
2023-11-29,4:30 PM,9,3,8,1,0,21,2023-11-29T22:37:51.700Z
2023-11-29,5:30 PM,8,3,5,1,0,17,2023-11-29T23:35:33.290Z
2023-11-29,6:30 PM,7,3,4,1,3,18,2023-11-30T00:43:53.713Z
2023-11-30,8:30 AM,2,1,2,0,0,5,2023-11-30T14:42:18.142Z
2023-11-30,9:30 AM,3,3,7,1,1,15,2023-11-30T15:50:30.569Z
2023-11-30,10:30 AM,5,6,12,6,0,29,2023-11-30T16:33:33.380Z
2023-11-30,12:30 PM,25,7,21,5,8,66,2023-11-30T18:42:39.683Z
2023-11-30,1:30 PM,28,7,22,2,7,66,2023-11-30T19:35:42.820Z
2023-11-30,2:30 PM,37,5,20,1,6,69,2023-11-30T20:38:06.033Z
2023-11-30,3:30 PM,22,7,14,3,1,47,2023-11-30T21:43:00.855Z
2023-11-30,4:30 PM,8,4,10,1,1,24,2023-11-30T22:34:48.881Z
2023-11-30,5:30 PM,5,3,10,1,0,19,2023-11-30T23:31:40.564Z
2023-11-30,6:30 PM,4,3,5,0,4,16,2023-12-01T00:41:59.689Z
2023-11-30,7:30 PM,3,1,2,0,6,12,2023-12-01T01:37:20.973Z
2023-12-01,8:30 AM,1,0,0,0,0,1,2023-12-01T14:48:56.031Z
2023-12-01,9:30 AM,3,3,1,1,0,8,2023-12-01T15:31:09.917Z
2023-12-01,10:30 AM,3,2,1,0,0,6,2023-12-01T16:37:18.293Z
2023-12-01,11:30 AM,3,2,3,0,3,11,2023-12-01T17:37:40.029Z
2023-12-01,12:30 PM,5,1,2,0,0,8,2023-12-01T18:39:02.630Z
2023-12-01,1:30 PM,6,1,3,1,2,13,2023-12-01T19:37:49.445Z
2023-12-01,2:30 PM,6,1,4,0,3,14,2023-12-01T20:38:28.392Z
2023-12-01,3:30 PM,3,1,6,0,0,10,2023-12-01T21:41:52.242Z
2023-12-01,4:30 PM,2,1,7,0,0,10,2023-12-01T22:32:34.218Z
2023-12-01,5:30 PM,1,1,2,1,0,5,2023-12-01T23:36:58.221Z
2023-12-02,10:30 AM,2,0,0,0,13,15,2023-12-02T16:47:20.755Z
2023-12-02,11:30 AM,6,0,1,0,14,21,2023-12-02T17:38:37.164Z
2023-12-02,12:30 PM,5,0,2,0,13,20,2023-12-02T18:32:44.791Z
2023-12-02,1:30 PM,9,0,4,0,0,13,2023-12-02T19:38:52.398Z
2023-12-02,2:30 PM,6,0,6,0,0,12,2023-12-02T20:32:58.066Z
2023-12-02,3:30 PM,4,0,2,0,0,6,2023-12-02T21:33:24.595Z
2023-12-02,4:30 PM,4,0,5,1,0,10,2023-12-02T22:34:27.757Z
2023-12-04,8:30 AM,3,2,4,0,0,9,2023-12-04T14:57:03.528Z
2023-12-04,9:30 AM,3,3,12,1,0,19,2023-12-04T15:33:03.829Z
2023-12-04,11:30 AM,8,4,17,11,8,48,2023-12-04T17:46:22.951Z
2023-12-04,12:30 PM,9,6,20,3,8,46,2023-12-04T18:44:51.164Z
2023-12-04,1:30 PM,8,9,19,0,8,44,2023-12-04T19:49:25.404Z
2023-12-04,2:30 PM,9,7,15,1,9,41,2023-12-04T20:38:42.387Z
2023-12-04,3:30 PM,7,9,21,4,5,46,2023-12-04T21:35:51.746Z
2023-12-04,4:30 PM,4,3,16,4,5,32,2023-12-04T22:35:34.953Z
2023-12-04,7:30 PM,3,1,6,1,5,16,2023-12-05T01:28:45.091Z
2023-12-05,8:30 AM,3,0,3,0,0,6,2023-12-05T14:37:19.819Z
2023-12-05,9:30 AM,4,3,10,4,0,21,2023-12-05T15:50:01.743Z
2023-12-05,10:30 AM,4,8,9,8,0,29,2023-12-05T16:28:45.333Z
2023-12-05,11:30 AM,7,7,17,4,10,45,2023-12-05T17:39:29.322Z
2023-12-05,12:30 PM,7,9,17,3,12,48,2023-12-05T18:36:01.717Z
2023-12-05,1:30 PM,8,5,16,1,6,36,2023-12-05T19:38:39.961Z
2023-12-05,2:30 PM,10,7,16,1,4,38,2023-12-05T20:52:07.372Z
2023-12-05,3:30 PM,11,6,13,0,0,30,2023-12-05T21:39:07.372Z
2023-12-05,4:30 PM,8,5,14,0,0,27,2023-12-05T22:40:21.718Z
2023-12-05,6:30 PM,2,4,6,0,0,12,2023-12-06T00:37:48.558Z
2023-12-06,8:30 AM,1,1,9,0,0,11,2023-12-06T14:38:20.625Z
2023-12-06,9:30 AM,2,2,10,0,0,14,2023-12-06T15:35:51.697Z
2023-12-06,10:30 AM,10,8,20,0,0,38,2023-12-06T16:34:13.508Z
2023-12-06,11:30 AM,13,6,10,2,8,39,2023-12-06T17:44:54.583Z
2023-12-06,12:30 PM,16,6,10,2,2,36,2023-12-06T18:36:09.527Z
2023-12-06,1:30 PM,9,3,8,2,2,24,2023-12-06T19:49:03.120Z
2023-12-06,2:30 PM,8,3,11,2,4,28,2023-12-06T20:58:01.640Z
2023-12-06,3:30 PM,5,4,11,2,0,22,2023-12-06T21:45:58.775Z
2023-12-06,4:30 PM,9,4,6,0,0,19,2023-12-06T22:34:00.720Z
2023-12-06,5:30 PM,7,3,6,6,3,25,2023-12-06T23:51:26.986Z
2023-12-07,7:30 AM,1,0,0,0,1,2,2023-12-07T13:44:59.435Z
2023-12-07,8:30 AM,1,3,3,0,3,10,2023-12-07T14:50:08.664Z
2023-12-07,9:30 AM,3,3,2,0,1,9,2023-12-07T15:36:22.724Z
2023-12-07,10:30 AM,8,11,12,3,4,38,2023-12-07T16:32:37.514Z
2023-12-07,1:30 PM,5,2,4,0,1,12,2023-12-07T19:50:21.212Z
2023-12-07,2:30 PM,10,9,7,3,2,31,2023-12-07T20:33:41.620Z
2023-12-07,3:30 PM,7,3,5,2,0,17,2023-12-07T22:40:36.532Z
2023-12-07,4:30 PM,8,2,8,1,0,19,2023-12-07T22:40:58.370Z
2023-12-07,5:30 PM,4,1,5,1,0,11,2023-12-07T23:35:36.516Z
2023-12-07,6:30 PM,0,3,2,2,0,7,2023-12-08T00:59:25.074Z
2023-12-07,7:30 PM,0,5,1,0,0,6,2023-12-08T01:58:49.062Z
2023-12-07,8:30 PM,0,0,2,0,0,2,2023-12-08T02:46:16.450Z
2023-12-08,7:30 AM,0,0,0,0,0,0,2023-12-08T13:33:01.017Z
2023-12-08,8:30 AM,1,1,0,0,0,2,2023-12-08T14:45:02.197Z
2023-12-08,8:30 AM,1,1,0,0,0,2,2023-12-08T14:52:44.404Z
2023-12-08,9:30 AM,0,1,0,0,0,1,2023-12-08T15:36:46.306Z
2023-12-08,11:30 AM,1,0,2,0,0,3,2023-12-08T17:43:17.647Z
2023-12-08,1:30 PM,3,1,4,1,0,9,2023-12-08T19:20:15.572Z
2023-12-08,12:30 PM,5,1,3,0,0,9,2023-12-08T19:48:29.775Z
2023-12-08,2:30 PM,2,0,0,0,0,2,2023-12-08T20:37:31.083Z
2023-12-08,3:30 PM,2,1,0,0,0,3,2023-12-08T21:44:02.558Z
2023-12-08,4:30 PM,1,0,0,1,0,2,2023-12-08T22:38:16.236Z
2023-12-08,5:30 PM,2,0,0,1,0,3,2023-12-08T23:39:19.547Z
2023-12-09,10:30 AM,2,0,1,0,0,3,2023-12-09T16:38:45.317Z
2023-12-09,11:30 AM,2,0,2,1,0,5,2023-12-09T17:36:11.544Z
2023-12-09,12:30 PM,1,0,2,2,2,7,2023-12-09T18:43:58.115Z
2023-12-09,1:30 PM,1,0,2,2,0,5,2023-12-09T19:41:44.988Z
2023-12-09,2:30 PM,1,0,1,0,0,2,2023-12-09T20:33:16.243Z
2023-12-09,3:30 PM,2,0,1,0,0,3,2023-12-09T21:35:20.633Z
2023-12-09,4:30 PM,2,0,1,0,0,3,2023-12-09T22:33:07.582Z
2023-12-11,7:30 AM,0,0,0,0,0,0,2023-12-11T13:30:18.808Z
2023-12-11,8:30 AM,2,0,0,0,0,2,2023-12-11T14:32:19.784Z
2023-12-11,9:30 AM,2,0,0,0,0,2,2023-12-11T15:39:23.755Z
2023-12-11,11:30 AM,0,0,1,0,0,1,2023-12-11T17:38:25.969Z
2023-12-11,12:30 PM,2,0,1,0,0,3,2023-12-11T18:32:03.651Z
2023-12-11,1:30 PM,2,0,2,0,0,4,2023-12-11T19:40:29.299Z
2023-12-11,3:30 PM,3,1,2,0,0,6,2023-12-11T21:35:09.093Z
2023-12-11,4:30 PM,2,0,1,0,0,3,2023-12-11T22:38:36.672Z
2023-12-12,7:30 AM,0,0,0,0,0,0,2023-12-12T13:40:48.616Z
2023-12-12,8:30 AM,0,0,0,0,0,0,2023-12-12T15:02:37.604Z
2023-12-12,9:30 AM,0,0,2,0,0,2,2023-12-12T15:33:40.059Z
2023-12-12,10:30 AM,1,0,2,0,0,3,2023-12-12T16:35:36.537Z
2023-12-12,11:30 AM,0,0,1,1,0,2,2023-12-12T17:57:57.099Z
2023-12-12,12:30 PM,1,0,3,0,1,5,2023-12-12T19:10:44.135Z
2023-12-12,1:30 PM,0,0,6,1,0,7,2023-12-12T19:52:11.307Z
2023-12-12,2:30 PM,1,0,5,0,0,6,2023-12-12T20:30:56.030Z
2023-12-12,3:30 PM,2,1,6,1,0,10,2023-12-12T21:34:56.183Z
2023-12-12,4:30 PM,3,0,4,2,0,9,2023-12-12T23:04:28.398Z
2023-12-13,12:30 PM,15,6,12,2,5,40,2023-02-13T19:05:06.451Z
2023-12-13,7:30 AM,0,0,0,0,0,0,2023-12-13T13:36:33.699Z
2023-12-13,8:30 AM,0,0,0,0,0,0,2023-12-13T14:27:52.709Z
2023-12-13,9:30 AM,1,0,0,0,0,1,2023-12-13T15:31:50.010Z
2023-12-13,10:30 AM,0,0,0,0,1,1,2023-12-13T16:37:54.672Z
2023-12-13,12:30 PM,1,0,0,0,0,1,2023-12-13T18:33:45.687Z
2023-12-13,11:30 AM,1,0,0,0,0,1,2023-12-13T18:34:06.573Z
2023-12-13,3:30 PM,3,0,1,0,0,4,2023-12-13T21:33:10.476Z
2023-12-13,4:30 PM,1,0,2,0,0,3,2023-12-13T22:47:49.973Z
2023-12-14,7:30 AM,0,0,0,0,0,0,2023-12-14T13:34:37.675Z
2023-12-14,8:30 AM,0,0,0,0,0,0,2023-12-14T14:26:32.322Z
2023-12-14,9:30 AM,1,0,0,0,1,2,2023-12-14T15:32:08.429Z
2023-12-14,10:30 AM,1,0,1,0,1,3,2023-12-14T16:29:34.765Z
2023-12-14,11:30 AM,2,0,0,1,0,3,2023-12-14T17:44:31.599Z
2023-12-14,1:30 PM,1,1,0,1,0,3,2023-12-14T19:02:50.488Z
2023-12-14,3:30 PM,1,0,1,0,0,2,2023-12-14T21:38:40.779Z
2023-12-15,7:30 AM,1,0,0,0,0,1,2023-12-15T13:36:55.217Z
2023-12-15,8:30 AM,1,0,1,0,0,2,2023-12-15T14:33:51.745Z
2023-12-15,9:30 AM,2,0,0,0,0,2,2023-12-15T15:33:03.447Z
2023-12-15,10:30 AM,0,2,0,0,0,2,2023-12-15T16:26:35.391Z
2023-12-15,3:30 PM,0,0,0,1,0,1,2023-12-15T21:35:23.744Z
2023-12-15,4:30 PM,0,0,0,1,0,1,2023-12-15T22:36:48.080Z
2023-12-18,7:30 AM,0,0,0,0,0,0,2023-12-18T14:27:12.971Z
2023-12-18,8:30 AM,0,1,0,0,1,2,2023-12-18T14:27:31.298Z
2023-12-18,9:30 AM,1,1,0,0,0,2,2023-12-18T15:32:20.849Z
2023-12-18,10:30 AM,1,0,0,0,0,1,2023-12-18T16:34:25.099Z
2023-12-18,11:30 AM,1,0,0,0,0,1,2023-12-18T17:45:17.168Z
2023-12-18,12:30 PM,1,0,0,0,0,1,2023-12-18T18:39:04.788Z
2023-12-18,1:30 PM,0,0,1,0,0,1,2023-12-18T19:49:40.396Z
2023-12-18,2:30 PM,2,0,1,0,0,3,2023-12-18T20:53:35.152Z
2023-12-18,3:30 PM,3,0,0,0,0,3,2023-12-18T21:45:20.511Z
2023-12-18,4:30 PM,2,0,0,0,0,2,2023-12-18T22:44:15.908Z
2023-12-19,7:30 AM,0,0,0,0,0,0,2023-12-19T13:50:12.475Z
2023-12-19,8:30 AM,0,0,0,0,0,0,2023-12-19T14:31:50.299Z
2023-12-19,9:30 AM,0,1,1,0,0,2,2023-12-19T15:28:24.783Z
2023-12-19,10:30 AM,2,0,0,0,1,3,2023-12-19T16:33:35.867Z
2023-12-19,11:30 AM,2,0,0,0,0,2,2023-12-19T17:32:50.105Z
2023-12-19,12:30 PM,0,0,0,0,0,0,2023-12-19T18:32:36.995Z
2023-12-19,1:30 PM,0,2,1,2,0,5,2023-12-19T19:32:22.033Z
2023-12-19,2:30 PM,0,0,1,0,2,3,2023-12-19T20:40:25.700Z
2023-12-19,3:30 PM,1,0,3,0,2,6,2023-12-19T21:52:33.387Z
2023-12-20,7:30 AM,0,0,0,0,0,0,2023-12-20T13:32:40.681Z
2023-12-20,8:30 AM,0,0,0,0,0,0,2023-12-20T14:36:39.123Z
2023-12-20,9:30 AM,0,0,1,0,0,1,2023-12-20T15:27:14.922Z
2023-12-20,10:30 AM,1,0,1,0,0,2,2023-12-20T16:27:53.571Z
2023-12-20,11:30 AM,2,0,0,0,0,2,2023-12-20T17:36:57.398Z
2023-12-20,2:30 PM,0,0,0,0,0,0,2023-12-20T20:53:14.706Z
2023-12-20,4:30 PM,2,0,0,0,0,2,2023-12-20T22:34:26.452Z
2023-12-21,7:30 AM,0,0,0,0,0,0,2023-12-21T13:42:43.863Z
2023-12-21,8:30 AM,0,0,1,0,0,1,2023-12-21T14:40:47.766Z
2023-12-21,9:30 AM,0,0,0,0,0,0,2023-12-21T15:46:51.561Z
2023-12-21,10:30 AM,0,0,0,0,0,0,2023-12-21T16:25:54.082Z
2023-12-21,11:30 AM,1,0,1,0,0,2,2023-12-21T17:36:54.851Z
2023-12-21,12:30 PM,1,1,1,0,0,3,2023-12-21T18:32:13.274Z
2023-12-21,1:30 PM,1,0,0,0,0,1,2023-12-21T19:35:09.193Z
2023-12-21,3:30 PM,2,1,0,0,0,3,2023-12-21T21:51:51.621Z
2023-12-21,4:30 PM,1,0,1,0,0,2,2023-12-21T22:48:02.327Z
2024-01-02,8:30 AM,0,0,0,0,0,0,2024-01-02T14:25:33.573Z
2024-01-02,9:30 AM,0,0,0,0,0,0,2024-01-02T15:26:38.075Z
2024-01-02,10:30 AM,0,0,0,0,0,0,2024-01-02T16:22:08.166Z
2024-01-02,11:30 AM,1,0,0,0,0,1,2024-01-02T17:59:15.789Z
2024-01-02,12:30 PM,2,0,1,0,0,3,2024-01-02T19:46:22.745Z
2024-01-02,1:30 PM,0,0,2,0,0,2,2024-01-02T19:46:39.065Z
2024-01-02,2:30 PM,1,0,0,0,0,1,2024-01-02T20:33:28.934Z
2024-01-02,3:30 PM,0,0,1,0,0,1,2024-01-02T21:39:44.693Z
2024-01-02,4:30 PM,0,0,0,0,0,0,2024-01-02T22:36:37.829Z
2024-01-03,7:30 AM,0,0,0,0,0,0,2024-01-03T14:16:08.036Z
2024-01-03,8:30 AM,1,0,0,0,0,1,2024-01-03T14:35:12.386Z
2024-01-03,9:30 AM,0,0,3,0,0,3,2024-01-03T15:29:07.041Z
2024-01-03,9:30 AM,0,0,3,1,0,4,2024-01-03T15:32:47.074Z
2024-01-03,10:30 AM,0,0,0,0,0,0,2024-01-03T16:33:02.881Z
2024-01-03,11:30 AM,2,0,0,0,0,2,2024-01-03T17:43:10.812Z
2024-01-03,12:30 PM,3,0,0,0,0,3,2024-01-03T18:36:37.792Z
2024-01-03,2:30 PM,1,0,0,0,0,1,2024-01-03T20:13:45.397Z
2024-01-03,3:30 PM,1,0,1,0,1,3,2024-01-03T21:30:54.021Z
2024-01-03,4:30 PM,2,1,1,0,0,4,2024-01-03T22:52:48.876Z
2024-01-04,7:30 AM,0,0,0,0,0,0,2024-01-04T14:42:27.889Z
2024-01-04,8:30 AM,0,0,0,0,0,0,2024-01-04T14:42:39.761Z
2024-01-04,8:30 AM,0,0,0,0,0,0,2024-01-04T14:46:10.270Z
2024-01-04,9:30 AM,0,0,1,0,0,1,2024-01-04T15:32:36.858Z
2024-01-04,10:30 AM,0,0,0,0,0,0,2024-01-04T16:26:59.306Z
2024-01-04,12:30 PM,2,0,1,0,0,3,2024-01-04T18:01:23.321Z
2024-01-04,12:30 PM,0,0,1,0,0,1,2024-01-04T19:06:45.824Z
2024-01-04,1:30 PM,0,0,2,0,1,3,2024-01-04T19:41:16.663Z
2024-01-04,2:30 PM,0,0,2,3,0,5,2024-01-04T20:40:50.849Z
2024-01-04,3:30 PM,0,0,2,0,0,2,2024-01-04T21:37:29.702Z
2024-01-04,4:30 PM,1,0,1,0,0,2,2024-01-04T22:34:12.331Z
2024-01-05,7:30 AM,0,1,0,0,0,1,2024-01-05T13:56:55.292Z
2024-01-05,8:30 AM,2,1,0,0,0,3,2024-01-05T14:25:26.954Z
2024-01-05,9:30 AM,2,1,2,0,0,5,2024-01-05T15:26:48.693Z
2024-01-05,10:30 AM,2,1,0,0,0,3,2024-01-05T16:28:28.591Z
2024-01-05,11:30 AM,1,0,1,0,0,2,2024-01-05T17:44:48.171Z
2024-01-05,12:30 PM,0,0,0,0,0,0,2024-01-05T18:40:21.567Z
2024-01-05,1:30 PM,0,0,0,0,0,0,2024-01-05T20:12:41.207Z
2024-01-05,2:30 PM,1,1,1,0,0,3,2024-01-05T20:36:33.049Z
2024-01-05,3:30 PM,2,0,1,0,0,3,2024-01-05T21:39:19.242Z
2024-01-05,4:30 PM,2,0,1,0,0,3,2024-01-05T22:45:10.771Z
2024-01-08,7:30 AM,0,0,0,0,0,0,2024-01-08T13:14:35.171Z
2024-01-08,8:30 AM,1,0,1,0,0,2,2024-01-08T14:32:38.639Z
2024-01-08,9:30 AM,1,0,0,0,0,1,2024-01-08T15:47:57.348Z
2024-01-08,10:30 AM,1,0,0,0,0,1,2024-01-08T16:32:26.159Z
2024-01-08,11:30 AM,1,0,3,0,0,4,2024-01-08T17:45:49.068Z
2024-01-08,12:30 PM,2,0,4,0,0,6,2024-01-08T18:46:57.541Z
2024-01-08,1:30 PM,1,1,4,0,0,6,2024-01-08T19:38:02.090Z
2024-01-08,2:30 PM,1,0,4,0,0,5,2024-01-08T20:37:20.720Z
2024-01-08,3:30 PM,2,0,1,0,0,3,2024-01-08T21:48:55.672Z
2024-01-08,4:30 PM,1,0,1,0,0,2,2024-01-08T22:47:18.368Z
2024-01-09,7:30 AM,0,0,0,0,0,0,2024-01-09T13:32:30.327Z
2024-01-09,8:30 AM,0,0,0,0,0,0,2024-01-09T14:29:58.293Z
2024-01-09,9:30 AM,0,0,0,0,0,0,2024-01-09T15:30:20.986Z
2024-01-09,10:30 AM,0,0,0,0,0,0,2024-01-09T16:36:29.807Z
2024-01-09,11:30 AM,2,0,0,0,0,2,2024-01-09T17:44:57.614Z
2024-01-09,12:30 PM,1,0,1,0,0,2,2024-01-09T18:39:23.888Z
2024-01-09,1:30 PM,3,0,3,0,0,6,2024-01-09T20:03:24.608Z
2024-01-09,2:30 PM,5,0,2,0,0,7,2024-01-09T20:53:28.601Z
2024-01-09,3:30 PM,4,0,2,0,0,6,2024-01-09T21:27:52.770Z
2024-01-09,4:30 PM,2,0,3,0,0,5,2024-01-09T22:31:50.717Z
2024-01-10,7:30 AM,0,0,0,0,0,0,2024-01-10T13:31:01.539Z
2024-01-10,8:30 AM,1,0,1,0,0,2,2024-01-10T14:31:16.677Z
2024-01-10,9:30 AM,1,0,1,0,0,2,2024-01-10T15:33:20.342Z
2024-01-10,10:30 AM,3,1,1,0,0,5,2024-01-10T16:32:25.497Z
2024-01-10,11:30 AM,2,0,2,0,0,4,2024-01-10T17:49:27.317Z
2024-01-10,12:30 PM,3,1,3,0,0,7,2024-01-10T18:41:03.600Z
2024-01-10,1:30 PM,3,1,3,0,0,7,2024-01-10T19:42:39.014Z
2024-01-10,2:30 PM,5,1,4,0,0,10,2024-01-10T20:46:57.189Z
2024-01-10,3:30 PM,1,1,0,0,5,7,2024-01-10T21:38:57.744Z
2024-01-10,4:30 PM,4,0,0,0,5,9,2024-01-10T22:58:08.069Z
2024-01-11,8:30 AM,2,0,0,0,0,2,2024-01-11T14:34:41.442Z
2024-01-11,9:30 AM,2,0,0,0,0,2,2024-01-11T15:35:10.915Z
2024-01-11,10:30 AM,0,0,1,0,0,1,2024-01-11T16:37:47.255Z
2024-01-11,11:30 AM,1,0,0,0,0,1,2024-01-11T17:31:49.715Z
2024-01-11,12:30 PM,1,0,2,0,0,3,2024-01-11T18:45:17.457Z
2024-01-11,1:30 PM,4,0,4,0,2,10,2024-01-11T19:42:44.984Z
2024-01-11,2:30 PM,4,0,3,0,0,7,2024-01-11T20:42:57.087Z
2024-01-11,3:30 PM,3,1,2,1,0,7,2024-01-11T21:40:24.796Z
2024-01-11,4:30 PM,3,0,8,0,0,11,2024-01-11T22:37:13.955Z
2024-01-12,10:30 AM,1,0,0,0,0,1,2024-01-12T16:36:31.630Z
2024-01-12,11:30 AM,4,0,3,0,0,7,2024-01-12T17:47:44.293Z
2024-01-12,12:30 PM,2,0,4,0,0,6,2024-01-12T18:37:22.166Z
2024-01-12,1:30 PM,2,0,2,0,0,4,2024-01-12T19:46:24.815Z
2024-01-12,2:30 PM,3,0,2,0,0,5,2024-01-12T20:48:46.513Z
2024-01-12,3:30 PM,2,0,0,0,0,2,2024-01-12T21:40:51.562Z
2024-01-12,4:30 PM,2,1,3,0,0,6,2024-01-12T23:30:19.838Z
2024-01-12,5:30 PM,2,1,0,0,0,3,2024-01-12T23:32:15.558Z
2024-01-17,8:30 AM,2,2,3,0,0,7,2024-01-17T14:35:28.492Z
2024-01-17,9:30 AM,7,4,5,0,0,16,2024-01-17T15:28:40.683Z
2024-01-17,10:30 AM,9,3,12,3,0,27,2024-01-17T16:34:38.681Z
2024-01-17,11:30 AM,12,1,13,2,2,30,2024-01-17T17:51:14.100Z
2024-01-17,12:30 PM,13,1,21,2,6,43,2024-01-17T19:25:34.357Z
2024-01-17,1:30 PM,12,1,11,3,8,35,2024-01-17T19:29:13.942Z
2024-01-17,2:30 PM,13,3,11,3,5,35,2024-01-17T20:40:04.896Z
2024-01-17,3:30 PM,13,3,6,4,3,29,2024-01-17T21:43:19.708Z
2024-01-17,4:30 PM,17,3,4,4,0,28,2024-01-17T22:41:53.325Z
2024-01-17,5:30 PM,4,2,2,3,0,11,2024-01-17T23:33:40.018Z
2024-01-17,6:30 PM,4,0,2,4,1,11,2024-01-18T00:34:00.240Z
2024-01-17,7:30 PM,5,0,2,2,0,9,2024-01-18T01:32:51.229Z
2024-01-17,8:30 PM,4,0,0,0,0,4,2024-01-18T02:48:28.540Z
2024-01-18,7:30 AM,0,0,0,0,1,1,2024-01-18T13:30:41.825Z
2024-01-18,8:30 AM,3,0,1,0,0,4,2024-01-18T14:33:23.189Z
2024-01-18,9:30 AM,4,3,9,0,0,16,2024-01-18T15:32:51.087Z
2024-01-18,10:30 AM,5,3,13,2,0,23,2024-01-18T16:48:14.616Z
2024-01-18,11:30 AM,8,3,13,2,1,27,2024-01-18T17:24:14.799Z
2024-01-18,12:30 PM,15,7,13,2,1,38,2024-01-18T18:38:41.572Z
2024-01-18,1:30 PM,9,2,6,2,1,20,2024-01-18T19:55:41.997Z
2024-01-18,2:30 PM,6,1,7,2,1,17,2024-01-18T20:38:28.346Z
2024-01-18,3:30 PM,7,2,5,1,1,16,2024-01-18T21:36:59.498Z
2024-01-18,4:30 PM,4,4,3,0,0,11,2024-01-18T22:34:30.942Z
2024-01-18,5:30 PM,6,3,3,1,2,15,2024-01-18T23:32:01.815Z
2024-01-18,6:30 PM,4,1,1,1,0,7,2024-01-19T00:36:39.866Z
2024-01-18,7:30 PM,1,1,2,0,0,4,2024-01-19T01:49:15.380Z
2024-01-19,7:30 AM,0,0,0,0,0,0,2024-01-19T15:55:56.592Z
2024-01-19,8:30 AM,6,0,1,0,0,7,2024-01-19T15:56:26.848Z
2024-01-19,9:30 AM,2,0,0,0,0,2,2024-01-19T15:56:40.655Z
2024-01-19,10:30 AM,4,0,3,0,0,7,2024-01-19T16:28:33.965Z
2024-01-19,12:30 PM,4,1,8,0,1,14,2024-01-19T18:37:12.206Z
2024-01-19,1:30 PM,5,7,0,0,0,12,2024-01-19T20:36:35.064Z
2024-01-19,2:30 PM,5,1,6,0,0,12,2024-01-19T20:36:52.368Z
2024-01-19,4:30 PM,6,3,2,1,1,13,2024-01-19T22:54:25.345Z
2024-01-19,6:30 PM,1,1,0,0,0,2,2024-01-20T00:29:33.057Z
2024-01-20,10:30 AM,3,2,5,0,1,11,2024-01-20T16:31:22.552Z
2024-01-20,11:30 AM,3,2,2,0,1,8,2024-01-20T17:51:29.226Z
2024-01-20,12:30 PM,6,2,2,0,1,11,2024-01-20T18:37:07.275Z
2024-01-20,1:30 PM,5,3,1,0,1,10,2024-01-20T19:35:00.699Z
2024-01-20,2:30 PM,6,1,4,1,1,13,2024-01-20T20:35:38.862Z
2024-01-20,3:30 PM,6,0,4,1,0,11,2024-01-20T21:33:20.974Z
2024-01-20,4:30 PM,7,0,0,1,0,8,2024-01-20T22:35:15.049Z
2024-01-23,8:30 AM,0,0,0,0,2,2,2024-01-23T14:07:42.797Z
2024-01-23,7:30 AM,0,0,0,0,2,2,2024-01-23T14:08:45.724Z
2024-01-23,8:30 AM,9,1,1,0,0,11,2024-01-23T14:38:06.019Z
2024-01-23,9:30 AM,5,2,2,1,0,10,2024-01-23T15:35:29.076Z
2024-01-23,10:30 AM,11,4,8,1,0,24,2024-01-23T16:36:39.898Z
2024-01-23,11:30 AM,7,3,9,0,7,26,2024-01-23T17:29:56.622Z
2024-01-23,12:30 PM,13,9,21,3,8,54,2024-01-23T18:35:20.578Z
2024-01-23,1:30 PM,17,7,16,3,3,46,2024-01-23T19:37:48.687Z
2024-01-23,3:30 PM,14,3,10,2,0,29,2024-01-23T21:50:40.545Z
2024-01-23,4:30 PM,4,5,4,1,0,14,2024-01-23T22:40:02.884Z
2024-01-23,5:30 PM,6,3,4,0,0,13,2024-01-23T23:29:45.703Z
2024-01-23,6:30 PM,5,0,1,0,0,6,2024-01-24T00:40:14.392Z
2024-01-23,7:30 PM,3,0,0,0,0,3,2024-01-24T01:30:10.176Z
2024-01-24,7:30 AM,0,0,0,0,1,1,2024-01-24T13:30:32.959Z
2024-01-24,8:30 AM,2,1,1,0,0,4,2024-01-24T14:28:44.114Z
2024-01-24,9:30 AM,6,4,6,1,0,17,2024-01-24T15:32:57.731Z
2024-01-24,10:30 AM,4,6,11,0,0,21,2024-01-24T16:29:51.210Z
2024-01-24,11:30 AM,5,7,8,1,1,22,2024-01-24T17:33:11.791Z
2024-01-24,12:30 PM,17,8,31,0,2,58,2024-01-24T18:40:58.369Z
2024-01-24,1:30 PM,9,9,10,1,1,30,2024-01-24T19:44:25.477Z
2024-01-24,2:30 PM,12,4,13,6,3,38,2024-01-24T20:53:50.177Z
2024-01-24,3:30 PM,8,4,10,5,1,28,2024-01-24T21:36:57.990Z
2024-01-24,4:30 PM,8,2,7,3,2,22,2024-01-24T22:36:09.491Z
2024-01-24,5:30 PM,4,1,8,1,1,15,2024-01-24T23:45:43.355Z
2024-01-24,6:30 PM,5,1,4,0,0,10,2024-01-25T00:34:33.815Z
2024-01-24,7:30 PM,4,2,1,0,0,7,2024-01-25T01:31:06.360Z
2024-01-24,8:30 PM,3,1,0,0,0,4,2024-01-25T02:30:53.679Z
2024-01-25,7:30 AM,0,0,0,0,0,0,2024-01-25T13:31:12.908Z
2024-01-25,9:30 AM,5,5,4,0,0,14,2024-01-25T15:28:45.095Z
2024-01-25,10:30 AM,6,3,6,0,2,17,2024-01-25T16:32:26.100Z
2024-01-25,11:30 AM,6,1,13,0,5,25,2024-01-25T17:47:40.961Z
2024-01-25,12:30 PM,18,4,13,2,1,38,2024-01-25T18:35:02.204Z
2024-01-25,1:30 PM,12,4,12,3,2,33,2024-01-25T19:34:04.198Z
2024-01-25,2:30 PM,11,3,10,3,2,29,2024-01-25T20:44:07.403Z
2024-01-25,3:30 PM,8,4,6,2,0,20,2024-01-25T21:37:39.905Z
2024-01-25,4:30 PM,8,4,8,1,1,22,2024-01-25T22:32:48.124Z
2024-01-25,6:30 PM,5,1,3,0,0,9,2024-01-26T00:33:35.649Z
2024-01-25,6:30 PM,2,2,4,2,0,10,2024-01-26T00:40:08.700Z
2024-01-25,7:30 PM,6,0,6,0,0,12,2024-01-26T01:28:16.098Z
2024-01-26,8:30 AM,4,0,0,0,0,4,2024-01-26T14:28:50.601Z
2024-01-26,9:30 AM,1,0,0,0,0,1,2024-01-26T15:32:43.368Z
2024-01-26,10:30 AM,1,1,5,1,0,8,2024-01-26T16:33:38.734Z
2024-01-26,11:30 AM,4,1,7,0,1,13,2024-01-26T17:33:01.878Z
2024-01-26,12:30 PM,4,0,10,3,2,19,2024-01-26T18:37:54.635Z
2024-01-26,1:30 PM,5,1,6,2,1,15,2024-01-26T19:34:41.184Z
2024-01-26,3:30 PM,2,1,4,0,1,8,2024-01-26T21:48:50.413Z
2024-01-26,4:30 PM,1,0,2,0,0,3,2024-01-26T22:57:31.254Z
2024-01-26,5:30 PM,2,1,1,0,0,4,2024-01-26T23:43:49.815Z
2024-01-27,10:30 AM,1,0,1,1,3,6,2024-01-27T16:49:10.438Z
2024-01-27,11:30 AM,2,2,1,0,0,5,2024-01-27T17:38:14.906Z
2024-01-27,12:30 PM,8,2,2,1,1,14,2024-01-27T18:42:54.934Z
2024-01-27,1:30 PM,2,2,2,1,0,7,2024-01-27T19:36:05.411Z
2024-01-27,2:30 PM,5,2,7,2,0,16,2024-01-27T20:33:55.292Z
2024-01-27,3:30 PM,4,0,8,2,0,14,2024-01-27T21:34:20.989Z
2024-01-27,4:30 PM,2,1,1,0,0,4,2024-01-27T22:32:49.463Z
2024-01-29,7:30 AM,0,0,0,0,0,0,2024-01-29T13:47:08.914Z
2024-01-29,8:30 AM,3,2,6,0,0,11,2024-01-29T14:49:27.402Z
2024-01-29,9:30 AM,5,2,12,0,0,19,2024-01-29T15:31:57.205Z
2024-01-29,10:30 AM,7,3,11,2,0,23,2024-01-29T16:51:52.139Z
2024-01-29,11:30 AM,11,5,11,2,0,29,2024-01-29T17:40:34.312Z
2024-01-29,12:30 PM,20,4,16,1,6,47,2024-01-29T19:08:39.408Z
2024-01-29,1:30 PM,7,5,13,2,6,33,2024-01-29T19:42:24.437Z
2024-01-29,2:30 PM,10,10,7,4,3,34,2024-01-29T20:38:03.727Z
2024-01-29,3:30 PM,11,6,9,2,0,28,2024-01-29T21:40:33.052Z
2024-01-29,4:30 PM,12,8,12,1,2,35,2024-01-29T22:36:49.038Z
2024-01-29,5:30 PM,8,5,11,0,0,24,2024-01-29T23:32:22.213Z
2024-01-29,6:30 PM,5,1,6,1,0,13,2024-01-30T00:36:09.510Z
2024-01-29,7:30 PM,0,0,4,0,0,4,2024-01-30T01:34:22.300Z
2024-01-30,7:30 AM,3,1,0,0,0,4,2024-01-30T13:31:11.002Z
2024-01-30,8:30 AM,0,2,3,1,0,6,2024-01-30T14:36:10.362Z
2024-01-30,9:30 AM,3,4,8,1,0,16,2024-01-30T15:51:54.682Z
2024-01-30,10:30 AM,13,4,6,0,0,23,2024-01-30T16:31:37.244Z
2024-01-30,11:30 AM,6,2,9,0,4,21,2024-01-30T17:53:52.960Z
2024-01-30,12:30 PM,15,8,11,0,6,40,2024-01-30T18:37:03.944Z
2024-01-30,1:30 PM,9,7,20,5,1,42,2024-01-30T19:33:52.082Z
2024-01-30,2:30 PM,5,3,14,5,5,32,2024-01-30T20:40:27.828Z
2024-01-30,3:30 PM,3,3,8,3,1,18,2024-01-30T21:38:02.959Z
2024-01-30,4:30 PM,4,6,4,2,2,18,2024-01-30T22:35:12.204Z
2024-01-30,5:30 PM,6,5,6,1,1,19,2024-01-30T23:37:03.366Z
2024-01-30,6:30 PM,3,4,5,0,0,12,2024-01-31T00:40:15.113Z
2024-01-30,8:30 PM,1,1,0,0,0,2,2024-01-31T02:28:23.617Z
2024-01-31,8:30 AM,3,0,5,0,0,8,2024-01-31T14:43:11.546Z
2024-01-31,9:30 AM,5,4,3,0,0,12,2024-01-31T15:33:02.006Z
2024-01-31,10:30 AM,4,10,8,1,0,23,2024-01-31T16:36:16.189Z
2024-01-31,2:30 PM,8,4,8,4,6,30,2024-01-31T20:37:31.693Z
2024-01-31,3:30 PM,8,2,7,6,2,25,2024-01-31T21:30:25.637Z
2024-01-31,4:30 PM,8,3,7,2,2,22,2024-01-31T22:52:25.757Z
2024-01-31,5:30 PM,4,2,5,3,0,14,2024-01-31T23:38:31.889Z
2024-01-31,6:30 PM,1,1,1,3,0,6,2024-02-01T00:33:55.596Z
2024-01-31,7:30 PM,1,2,1,0,0,4,2024-02-01T01:34:35.855Z
2024-02-01,8:30 AM,0,2,2,0,1,5,2024-02-01T14:43:14.704Z
2024-02-01,9:30 AM,4,2,8,0,1,15,2024-02-01T15:33:34.892Z
2024-02-01,10:30 AM,10,3,7,0,0,20,2024-02-01T16:40:22.920Z
2024-02-01,11:30 AM,7,0,9,1,3,20,2024-02-01T17:41:59.980Z
2024-02-01,12:30 PM,12,5,26,3,2,48,2024-02-01T18:35:25.367Z
2024-02-01,1:30 PM,5,0,17,5,3,30,2024-02-01T19:47:40.230Z
2024-02-01,2:30 PM,7,2,7,3,6,25,2024-02-01T20:48:29.945Z
2024-02-01,3:30 PM,5,4,6,3,2,20,2024-02-01T21:43:55.612Z
2024-02-01,4:30 PM,5,3,6,2,0,16,2024-02-01T22:39:34.452Z
2024-02-01,5:30 PM,9,5,5,3,0,22,2024-02-01T23:35:23.060Z
2024-02-01,6:30 PM,5,4,5,3,0,17,2024-02-02T00:35:50.513Z
2024-02-01,7:30 PM,2,2,6,3,0,13,2024-02-02T01:30:33.977Z
2024-02-02,8:30 AM,2,2,0,0,0,4,2024-02-02T14:34:18.107Z
2024-02-02,9:30 AM,1,2,0,0,1,4,2024-02-02T15:31:35.267Z
2024-02-02,10:30 AM,4,2,2,1,0,9,2024-02-02T16:29:22.954Z
2024-02-02,11:30 AM,3,3,5,1,0,12,2024-02-02T17:30:17.349Z
2024-02-02,12:30 PM,7,1,14,6,0,28,2024-02-02T18:36:59.336Z
2024-02-02,3:30 PM,3,2,1,1,2,9,2024-02-02T22:02:43.350Z
2024-02-02,4:30 PM,4,2,4,1,10,21,2024-02-02T22:38:58.836Z
2024-02-02,5:30 PM,3,2,0,0,4,9,2024-02-03T00:40:18.001Z
2024-02-02,6:30 PM,2,2,0,0,0,4,2024-02-03T00:40:39.538Z
2024-02-03,10:30 AM,2,1,1,0,0,4,2024-02-03T16:42:05.133Z
2024-02-03,11:30 AM,2,3,1,0,2,8,2024-02-03T17:45:11.053Z
2024-02-03,12:30 PM,1,2,2,0,1,6,2024-02-03T18:34:45.009Z
2024-02-03,1:30 PM,6,2,2,0,0,10,2024-02-03T19:36:00.177Z
2024-02-03,2:30 PM,6,2,1,2,0,11,2024-02-03T20:36:04.207Z
2024-02-03,3:30 PM,2,1,1,2,0,6,2024-02-03T21:32:36.226Z
2024-02-03,4:30 PM,0,1,1,2,0,4,2024-02-03T22:36:32.483Z
2024-02-05,7:30 AM,0,0,0,0,0,0,2024-02-05T14:25:39.008Z
2024-02-05,8:30 AM,0,0,7,0,0,7,2024-02-05T14:25:52.927Z
2024-02-05,9:30 AM,6,3,5,0,0,14,2024-02-05T15:29:01.602Z
2024-02-05,10:30 AM,6,7,7,1,0,21,2024-02-05T16:51:26.665Z
2024-02-05,11:30 AM,15,3,12,4,2,36,2024-02-05T17:54:51.796Z
2024-02-05,12:30 PM,26,5,16,2,0,49,2024-02-05T18:36:03.735Z
2024-02-05,1:30 PM,10,4,14,0,0,28,2024-02-05T19:43:23.669Z
2024-02-05,2:30 PM,14,4,13,1,6,38,2024-02-05T20:35:23.758Z
2024-02-05,3:30 PM,13,3,6,3,5,30,2024-02-05T21:36:09.727Z
2024-02-05,4:30 PM,7,2,8,2,7,26,2024-02-05T22:48:13.411Z
2024-02-05,5:30 PM,7,5,11,2,1,26,2024-02-05T23:43:46.363Z
2024-02-05,6:30 PM,4,3,3,1,0,11,2024-02-06T00:33:29.380Z
2024-02-05,7:30 PM,6,0,6,0,0,12,2024-02-06T01:39:22.809Z
2024-02-06,7:30 AM,0,0,0,0,1,1,2024-02-06T14:02:32.055Z
2024-02-06,8:30 AM,0,1,2,0,0,3,2024-02-06T14:45:56.698Z
2024-02-06,9:30 AM,4,2,5,0,0,11,2024-02-06T15:33:08.776Z
2024-02-06,10:30 AM,5,7,7,5,0,24,2024-02-06T16:44:34.017Z
2024-02-06,11:30 AM,5,3,6,5,4,23,2024-02-06T17:41:00.563Z
2024-02-06,12:30 PM,12,8,26,5,3,54,2024-02-06T18:36:05.941Z
2024-02-06,12:30 PM,8,9,17,4,3,41,2024-02-06T18:50:44.399Z
2024-02-06,2:30 PM,4,6,11,4,2,27,2024-02-06T20:28:58.745Z
2024-02-06,1:30 PM,6,9,15,5,0,35,2024-02-06T20:38:29.000Z
2024-02-06,3:30 PM,7,3,8,2,0,20,2024-02-06T21:38:18.900Z
2024-02-06,4:30 PM,6,4,10,6,1,27,2024-02-06T22:34:21.846Z
2024-02-06,5:30 PM,6,4,10,4,0,24,2024-02-06T23:32:45.616Z
2024-02-06,6:30 PM,3,2,7,0,2,14,2024-02-07T00:33:50.804Z
2024-02-07,7:30 AM,0,0,0,0,1,1,2024-02-07T13:39:41.008Z
2024-02-07,8:30 AM,2,1,2,0,1,6,2024-02-07T14:32:40.780Z
2024-02-07,9:30 AM,5,3,7,0,1,16,2024-02-07T15:37:27.175Z
2024-02-07,10:30 AM,7,10,12,1,0,30,2024-02-07T16:40:10.479Z
2024-02-07,1:30 PM,8,5,11,4,1,29,2024-02-07T19:30:21.234Z
2024-02-07,2:30 PM,10,5,13,10,7,45,2024-02-07T20:40:42.912Z
2024-02-07,3:30 PM,9,3,10,6,12,40,2024-02-07T21:31:08.100Z
2024-02-07,4:30 PM,9,2,3,4,7,25,2024-02-07T22:45:47.799Z
2024-02-07,5:30 PM,8,3,5,3,4,23,2024-02-07T23:27:42.020Z
2024-02-07,5:30 PM,8,3,4,1,0,16,2024-02-07T23:39:09.778Z
2024-02-07,6:30 PM,6,1,5,1,0,13,2024-02-08T00:41:03.228Z
2024-02-07,7:30 PM,4,2,6,0,0,12,2024-02-08T01:33:15.251Z
2024-02-07,8:30 PM,6,1,4,0,0,11,2024-02-08T02:32:11.777Z
2024-02-08,7:30 AM,0,0,0,0,1,1,2024-02-08T14:26:32.737Z
2024-02-08,8:30 AM,1,1,1,0,0,3,2024-02-08T14:27:44.523Z
2024-02-08,10:30 AM,4,5,11,1,1,22,2024-02-08T16:30:01.929Z
2024-02-08,11:30 AM,8,6,10,3,3,30,2024-02-08T17:40:02.838Z
2024-02-08,12:30 PM,12,3,14,4,5,38,2024-02-08T18:43:20.279Z
2024-02-08,1:30 PM,8,7,14,1,3,33,2024-02-08T20:26:16.935Z
2024-02-08,2:30 PM,15,4,8,2,3,32,2024-02-08T20:29:59.585Z
2024-02-08,3:30 PM,6,1,3,1,0,11,2024-02-08T21:40:19.149Z
2024-02-08,4:30 PM,7,1,9,3,0,20,2024-02-08T22:39:44.586Z
2024-02-08,5:30 PM,6,4,7,3,0,20,2024-02-08T23:36:23.004Z
2024-02-08,6:30 PM,4,2,4,0,0,10,2024-02-09T00:38:02.250Z
2024-02-09,8:30 AM,0,1,0,0,0,1,2024-02-09T14:26:30.882Z
2024-02-09,9:30 AM,1,1,0,0,0,2,2024-02-09T15:32:43.794Z
2024-02-09,10:30 AM,3,2,1,0,9,15,2024-02-09T16:34:15.084Z
2024-02-09,11:30 AM,5,1,4,1,3,14,2024-02-09T17:31:37.891Z
2024-02-09,12:30 PM,6,2,6,2,0,16,2024-02-09T18:37:57.184Z
2024-02-09,1:30 PM,4,2,7,1,1,15,2024-02-09T19:34:17.789Z
2024-02-09,2:30 PM,4,1,5,0,1,11,2024-02-09T20:35:34.771Z
2024-02-09,3:30 PM,3,2,2,1,1,9,2024-02-09T21:55:50.474Z
2024-02-09,4:30 PM,1,1,1,0,0,3,2024-02-09T22:58:30.912Z
2024-02-10,10:30 AM,3,0,0,0,1,4,2024-02-10T16:34:43.575Z
2024-02-10,11:30 AM,3,2,0,0,2,7,2024-02-10T17:34:18.893Z
2024-02-10,12:30 PM,2,3,3,0,2,10,2024-02-10T18:32:11.646Z
2024-02-10,1:30 PM,7,3,3,1,0,14,2024-02-10T19:50:59.284Z
2024-02-10,2:30 PM,7,2,1,3,0,13,2024-02-10T20:33:49.050Z
2024-02-10,3:30 PM,2,2,1,2,0,7,2024-02-10T21:34:17.928Z
2024-02-10,4:30 PM,0,2,0,0,0,2,2024-02-10T22:40:13.495Z
2024-02-12,8:30 AM,1,1,2,0,0,4,2024-02-12T14:50:26.842Z
2024-02-12,9:30 AM,3,3,8,1,0,15,2024-02-12T15:36:08.757Z
2024-02-12,10:30 AM,4,2,16,1,0,23,2024-02-12T16:35:01.200Z
2024-02-12,12:30 PM,16,3,21,3,3,46,2024-02-12T18:39:51.864Z
2024-02-12,1:30 PM,6,2,13,3,0,24,2024-02-12T19:59:04.422Z
2024-02-12,2:30 PM,7,3,13,3,5,31,2024-02-12T20:36:06.956Z
2024-02-12,4:30 PM,7,3,10,3,6,29,2024-02-12T22:38:28.944Z
2024-02-12,5:30 PM,6,3,7,4,0,20,2024-02-12T23:32:57.407Z
2024-02-12,6:30 PM,3,3,6,3,0,15,2024-02-13T00:36:00.579Z
2024-02-12,7:30 PM,5,3,5,1,0,14,2024-02-13T01:32:19.452Z
2024-02-13,8:30 AM,1,0,0,0,0,1,2024-02-13T14:29:35.692Z
2024-02-13,9:30 AM,7,3,3,0,0,13,2024-02-13T15:42:54.519Z
2024-02-13,10:30 AM,8,3,8,2,0,21,2024-02-13T16:35:13.014Z
2024-02-13,11:30 AM,6,3,14,1,1,25,2024-02-13T17:40:39.403Z
2024-02-13,12:30 PM,12,7,13,4,2,38,2024-02-13T18:43:05.529Z
2024-02-13,1:30 PM,12,4,22,3,1,42,2024-02-13T19:40:59.492Z
2024-02-13,2:30 PM,7,2,16,2,2,29,2024-02-13T20:36:42.490Z
2024-02-13,3:30 PM,5,1,15,3,0,24,2024-02-13T21:36:55.995Z
2024-02-13,4:30 PM,2,3,10,2,0,17,2024-02-13T22:34:42.165Z
2024-02-13,5:30 PM,3,2,14,2,0,21,2024-02-13T23:34:57.801Z
2024-02-13,6:30 PM,3,2,11,0,0,16,2024-02-14T00:34:50.653Z
2024-02-14,8:30 AM,3,2,3,0,0,8,2024-02-14T14:28:59.193Z
2024-02-14,9:30 AM,3,3,7,2,0,15,2024-02-14T15:33:27.878Z
2024-02-14,11:30 AM,6,4,12,3,2,27,2024-02-14T17:56:25.489Z
2024-02-14,12:30 PM,12,2,22,2,1,39,2024-02-14T18:44:19.241Z
2024-02-14,1:30 PM,7,2,9,2,0,20,2024-02-14T19:47:47.698Z
2024-02-14,2:30 PM,10,2,8,3,1,24,2024-02-14T20:46:32.251Z
2024-02-14,3:30 PM,21,2,4,0,3,30,2024-02-14T21:40:10.701Z
2024-02-14,4:30 PM,9,4,6,0,0,19,2024-02-14T22:32:47.469Z
2024-02-14,6:30 PM,3,2,0,0,0,5,2024-02-15T00:35:33.398Z
2024-02-14,7:30 PM,1,1,2,0,0,4,2024-02-15T01:38:00.102Z
2024-02-15,7:30 AM,0,0,0,0,2,2,2024-02-15T13:33:46.243Z
2024-02-15,8:30 AM,5,0,2,0,0,7,2024-02-15T14:27:00.548Z
2024-02-15,9:30 AM,3,4,3,0,0,10,2024-02-15T15:29:35.205Z
2024-02-15,10:30 AM,4,6,6,0,0,16,2024-02-15T16:32:25.672Z
2024-02-15,12:30 PM,9,5,13,4,1,32,2024-02-15T18:31:33.946Z
2024-02-15,11:30 PM,4,4,6,1,2,17,2024-02-15T18:32:32.474Z
2024-02-15,1:30 PM,4,4,21,4,2,35,2024-02-15T19:32:01.952Z
2024-02-15,2:30 PM,6,3,6,4,1,20,2024-02-15T20:35:27.587Z
2024-02-15,3:30 PM,3,1,4,1,0,9,2024-02-15T21:47:28.551Z
2024-02-15,4:30 PM,9,3,2,1,2,17,2024-02-15T22:34:27.651Z
2024-02-15,5:30 PM,10,3,9,0,0,22,2024-02-15T23:34:59.909Z
2024-02-15,6:30 PM,6,1,7,1,0,15,2024-02-16T00:33:26.289Z
2024-02-16,8:30 AM,2,1,1,0,0,4,2024-02-16T14:32:15.580Z
2024-02-16,9:30 AM,1,3,1,0,0,5,2024-02-16T15:34:33.623Z
2024-02-16,10:30 AM,1,4,0,0,0,5,2024-02-16T16:34:22.716Z
2024-02-16,11:30 AM,3,3,2,2,0,10,2024-02-16T17:27:26.499Z
2024-02-16,12:30 PM,9,0,1,2,0,12,2024-02-16T18:34:15.995Z
2024-02-16,1:30 PM,2,0,2,2,0,6,2024-02-16T20:07:47.158Z
2024-02-16,2:30 PM,1,0,3,2,0,6,2024-02-16T20:35:52.745Z
2024-02-16,3:30 PM,3,0,2,2,0,7,2024-02-16T21:31:19.506Z
2024-02-16,4:30 PM,2,0,0,0,0,2,2024-02-16T22:44:29.242Z
2024-02-16,5:30 PM,2,0,0,0,0,2,2024-02-16T23:57:25.465Z
2024-02-16,6:30 PM,2,1,0,0,0,3,2024-02-17T00:38:09.386Z
2024-02-17,10:30 AM,3,0,0,1,0,4,2024-02-17T16:42:25.555Z
2024-02-17,11:30 AM,0,2,1,0,0,3,2024-02-17T17:44:20.036Z
2024-02-17,12:30 PM,4,0,0,0,0,4,2024-02-17T18:44:20.908Z
2024-02-17,1:30 PM,2,0,1,4,0,7,2024-02-17T19:38:26.433Z
2024-02-17,2:30 PM,3,0,2,3,0,8,2024-02-17T20:33:41.586Z
2024-02-17,3:30 PM,3,0,3,4,0,10,2024-02-17T21:35:15.104Z
2024-02-17,4:30 PM,1,0,3,2,0,6,2024-02-17T22:32:52.065Z
2024-02-19,8:30 AM,0,0,3,0,0,3,2024-02-19T14:36:32.736Z
2024-02-19,9:30 AM,3,2,3,0,0,8,2024-02-19T15:33:04.802Z
2024-02-19,10:30 AM,3,2,10,0,0,15,2024-02-19T16:31:06.088Z
2024-02-19,11:30 AM,9,2,7,2,0,20,2024-02-19T17:49:54.420Z
2024-02-19,12:30 PM,8,4,10,2,3,27,2024-02-19T18:39:25.163Z
2024-02-19,1:30 PM,4,7,12,0,0,23,2024-02-19T19:37:53.404Z
2024-02-19,2:30 PM,7,5,7,0,3,22,2024-02-19T20:41:23.823Z
2024-02-19,3:30 PM,18,2,8,0,5,33,2024-02-19T21:36:48.264Z
2024-02-19,4:30 PM,4,5,8,0,2,19,2024-02-19T22:38:10.969Z
2024-02-19,5:30 PM,5,2,8,0,1,16,2024-02-19T23:37:06.881Z
2024-02-19,6:30 PM,2,2,4,0,0,8,2024-02-20T00:37:39.580Z
2024-02-19,7:30 PM,1,1,2,2,0,6,2024-02-20T01:33:57.327Z
2024-02-19,8:30 PM,0,0,0,2,0,2,2024-02-20T02:38:51.339Z
2024-02-20,8:30 AM,0,1,2,0,0,3,2024-02-20T14:31:53.622Z
2024-02-20,9:30 AM,5,3,5,0,0,13,2024-02-20T15:29:48.348Z
2024-02-20,10:30 AM,9,4,13,1,1,28,2024-02-20T16:27:58.493Z
2024-02-20,11:30 AM,8,4,10,1,1,24,2024-02-20T17:36:31.354Z
2024-02-20,12:30 PM,11,5,19,3,3,41,2024-02-20T18:42:01.618Z
2024-02-20,1:30 PM,7,4,17,3,2,33,2024-02-20T19:32:50.692Z
2024-02-20,2:30 PM,5,2,4,5,2,18,2024-02-20T20:38:27.126Z
2024-02-20,3:30 PM,3,2,6,2,1,14,2024-02-20T21:43:07.967Z
2024-02-20,4:30 PM,4,2,5,2,0,13,2024-02-20T22:35:12.967Z
2024-02-20,5:30 PM,3,2,3,1,0,9,2024-02-20T23:39:01.284Z
2024-02-20,6:30 PM,4,0,1,1,0,6,2024-02-21T00:33:33.152Z
2024-02-21,7:30 AM,0,0,0,0,2,2,2024-02-21T13:42:36.778Z
2024-02-21,8:30 AM,3,0,3,0,0,6,2024-02-21T14:43:01.660Z
2024-02-21,9:30 AM,9,4,10,2,0,25,2024-02-21T15:59:18.863Z
2024-02-21,10:30 AM,6,5,8,2,0,21,2024-02-21T16:30:36.086Z
2024-02-21,12:30 PM,5,5,17,3,2,32,2024-02-21T18:43:13.319Z
2024-02-21,2:30 PM,5,10,4,2,3,24,2024-02-21T20:37:28.607Z
2024-02-21,3:30 PM,4,4,6,2,2,18,2024-02-21T21:34:55.977Z
2024-02-21,5:30 PM,5,2,3,1,0,11,2024-02-21T23:33:46.460Z
2024-02-21,6:30 PM,3,2,1,1,0,7,2024-02-22T00:35:11.176Z
2024-02-22,8:30 AM,0,2,3,0,0,5,2024-02-22T14:35:09.338Z
2024-02-22,9:30 AM,3,6,4,2,0,15,2024-02-22T15:44:32.726Z
2024-02-22,10:30 AM,5,9,9,1,0,24,2024-02-22T16:28:43.311Z
2024-02-22,11:30 AM,7,6,9,1,2,25,2024-02-22T17:36:06.904Z
2024-02-22,12:30 PM,10,5,11,3,2,31,2024-02-22T18:49:50.978Z
2024-02-22,1:30 PM,11,2,11,3,1,28,2024-02-22T19:35:50.781Z
2024-02-22,2:30 PM,2,3,3,1,2,11,2024-02-22T20:40:57.404Z
2024-02-22,3:30 PM,6,3,4,0,2,15,2024-02-22T21:34:43.406Z
2024-02-22,4:30 PM,5,3,3,0,0,11,2024-02-22T22:34:45.524Z
2024-02-22,5:30 PM,9,2,4,1,0,16,2024-02-22T23:34:45.351Z
2024-02-22,6:30 PM,5,3,4,2,0,14,2024-02-23T00:33:59.596Z
2024-02-23,7:30 AM,0,0,0,0,2,2,2024-02-23T13:46:22.103Z
2024-02-23,8:30 AM,2,2,0,0,0,4,2024-02-23T14:31:07.599Z
2024-02-23,9:30 AM,1,3,2,0,0,6,2024-02-23T15:28:40.344Z
2024-02-23,10:30 AM,3,2,1,0,0,6,2024-02-23T16:36:44.290Z
2024-02-23,11:30 AM,6,1,0,2,0,9,2024-02-23T17:48:32.067Z
2024-02-23,12:30 PM,6,0,0,0,1,7,2024-02-23T18:34:45.352Z
2024-02-23,1:30 PM,4,0,1,0,1,6,2024-02-23T19:32:46.306Z
2024-02-23,2:30 PM,3,0,4,0,0,7,2024-02-23T20:53:54.610Z
2024-02-23,3:30 PM,1,0,3,0,0,4,2024-02-23T21:43:34.290Z
2024-02-23,4:30 PM,1,1,1,1,0,4,2024-02-23T22:48:07.194Z
2024-02-23,5:30 PM,2,1,2,1,0,6,2024-02-23T23:48:18.560Z
2024-02-23,6:30 PM,3,1,1,0,0,5,2024-02-24T00:38:40.002Z
2024-02-24,10:30 AM,1,0,1,0,0,2,2024-02-24T16:47:05.078Z
2024-02-24,11:30 AM,2,0,3,1,1,7,2024-02-24T17:35:04.722Z
2024-02-24,12:30 PM,3,1,4,1,0,9,2024-02-24T18:32:12.043Z
2024-02-24,1:30 PM,0,1,1,0,0,2,2024-02-24T19:37:29.332Z
2024-02-24,2:30 PM,2,1,2,0,0,5,2024-02-24T20:36:00.262Z
2024-02-24,3:30 PM,2,1,1,0,0,4,2024-02-24T21:32:05.213Z
2024-02-24,4:30 PM,2,1,3,0,0,6,2024-02-24T22:34:49.001Z
2024-02-26,7:30 AM,0,0,0,0,2,2,2024-02-26T14:22:49.961Z
2024-02-26,8:30 AM,1,0,2,0,0,3,2024-02-26T14:32:24.005Z
2024-02-26,9:30 AM,1,3,5,0,0,9,2024-02-26T15:28:56.270Z
2024-02-26,10:30 AM,5,4,7,1,0,17,2024-02-26T16:31:11.374Z
2024-02-26,11:30 AM,7,5,12,3,1,28,2024-02-26T17:37:28.299Z
2024-02-26,12:30 PM,12,6,24,1,2,45,2024-02-26T18:31:48.746Z
2024-02-26,2:30 PM,7,5,7,5,3,27,2024-02-26T20:45:20.828Z
2024-02-26,3:30 PM,6,3,6,3,7,25,2024-02-26T21:36:26.049Z
2024-02-26,4:30 PM,8,5,10,2,6,31,2024-02-26T22:40:23.607Z
2024-02-26,5:30 PM,7,2,9,0,3,21,2024-02-26T23:34:11.416Z
2024-02-26,6:30 PM,2,4,6,0,0,12,2024-02-27T00:43:12.745Z
2024-02-26,7:30 PM,5,3,4,2,2,16,2024-02-27T01:32:32.402Z
2024-02-26,8:30 PM,0,1,3,2,0,6,2024-02-27T02:58:18.885Z
2024-02-27,8:30 AM,1,0,1,0,0,2,2024-02-27T14:30:13.056Z
2024-02-27,9:30 AM,5,5,5,0,0,15,2024-02-27T15:28:41.560Z
2024-02-27,10:30 AM,13,8,9,1,0,31,2024-02-27T16:32:44.990Z
2024-02-27,11:30 AM,4,2,9,3,1,19,2024-02-27T17:38:33.406Z
2024-02-27,12:30 PM,9,7,29,3,2,50,2024-02-27T18:43:41.025Z
2024-02-27,1:30 PM,6,3,14,2,2,27,2024-02-27T19:38:44.649Z
2024-02-27,2:30 PM,8,2,9,1,3,23,2024-02-27T20:39:53.641Z
2024-02-27,3:30 PM,7,2,12,0,0,21,2024-02-27T21:37:23.756Z
2024-02-27,4:30 PM,6,2,8,1,0,17,2024-02-27T22:39:50.669Z
2024-02-27,5:30 PM,4,7,3,2,0,16,2024-02-27T23:30:01.034Z
2024-02-27,6:30 PM,2,3,3,0,1,9,2024-02-28T00:40:16.274Z
2024-02-28,7:30 AM,0,0,0,0,3,3,2024-02-28T13:54:15.847Z
2024-02-28,8:30 AM,3,1,4,0,0,8,2024-02-28T14:43:48.051Z
2024-02-28,9:30 AM,6,6,4,0,0,16,2024-02-28T15:27:49.918Z
2024-02-28,10:30 AM,5,6,9,6,0,26,2024-02-28T16:27:28.478Z
2024-02-28,11:30 AM,3,6,10,4,2,25,2024-02-28T17:49:15.889Z
2024-02-28,12:30 PM,13,8,24,5,4,54,2024-02-28T18:33:50.590Z
2024-02-28,1:30 PM,7,5,13,5,0,30,2024-02-28T20:01:01.816Z
2024-02-28,2:30 PM,11,4,14,3,3,35,2024-02-28T20:33:47.414Z
2024-02-28,3:30 PM,6,2,14,3,6,31,2024-02-28T21:32:57.055Z
2024-02-28,4:30 PM,5,2,5,1,8,21,2024-02-28T22:51:03.612Z
2024-02-28,5:30 PM,8,0,8,1,0,17,2024-02-28T23:34:44.171Z
2024-02-28,6:30 PM,4,3,4,0,1,12,2024-02-29T01:42:26.517Z
2024-02-28,7:30 PM,4,1,2,1,0,8,2024-02-29T01:45:23.934Z
2024-02-29,7:30 AM,0,0,0,0,1,1,2024-02-29T13:31:33.637Z
2024-02-29,8:30 AM,1,1,3,1,0,6,2024-02-29T14:34:58.962Z
2024-02-29,9:30 AM,3,3,4,1,0,11,2024-02-29T15:30:28.476Z
2024-02-29,10:30 AM,6,5,8,3,3,25,2024-02-29T16:48:13.422Z
2024-02-29,11:30 AM,5,2,13,0,1,21,2024-02-29T17:42:33.184Z
2024-02-29,12:30 PM,8,5,17,5,3,38,2024-02-29T18:51:09.791Z
2024-02-29,1:30 PM,4,4,20,8,1,37,2024-02-29T19:40:58.904Z
2024-02-29,3:30 PM,10,3,4,6,0,23,2024-02-29T21:39:35.479Z
2024-02-29,4:30 PM,8,4,4,0,0,16,2024-02-29T22:40:21.735Z
2024-02-29,5:30 PM,5,2,5,1,0,13,2024-02-29T23:34:28.263Z
2024-03-01,8:30 AM,1,1,0,2,0,4,2024-03-01T14:32:48.602Z
2024-03-01,9:30 AM,2,1,0,2,0,5,2024-03-01T15:32:53.310Z
2024-03-01,10:30 AM,3,2,1,4,0,10,2024-03-01T16:33:10.571Z
2024-03-01,11:30 AM,2,4,1,5,0,12,2024-03-01T17:28:43.202Z
2024-03-01,12:30 PM,5,1,5,3,0,14,2024-03-01T18:55:15.062Z
2024-03-01,1:30 PM,2,3,5,3,1,14,2024-03-01T19:41:57.032Z
2024-03-01,2:30 PM,6,4,4,3,0,17,2024-03-01T20:42:19.222Z
2024-03-01,3:30 PM,2,2,2,1,0,7,2024-03-01T21:38:35.312Z
2024-03-01,4:30 PM,2,3,2,0,1,8,2024-03-01T22:46:57.089Z
2024-03-01,5:30 PM,2,3,0,0,2,7,2024-03-02T00:00:53.286Z
2024-03-01,6:30 PM,3,4,1,2,0,10,2024-03-02T00:51:15.901Z
2024-03-02,10:30 AM,2,1,1,0,0,4,2024-03-02T16:52:59.781Z
2024-03-02,11:30 AM,3,2,3,0,0,8,2024-03-02T17:38:48.065Z
2024-03-02,12:30 PM,6,1,3,1,2,13,2024-03-02T18:43:39.401Z
2024-03-02,1:30 PM,5,0,6,0,2,13,2024-03-02T19:36:24.289Z
2024-03-02,2:30 PM,9,0,4,0,0,13,2024-03-02T20:35:01.013Z
2024-03-02,3:30 PM,6,0,1,0,0,7,2024-03-02T21:33:31.968Z
2024-03-02,4:30 PM,6,0,0,0,1,7,2024-03-02T22:35:44.284Z
2024-03-04,8:30 AM,1,1,4,0,0,6,2024-03-04T14:37:01.282Z
2024-03-04,10:30 AM,5,5,17,3,0,30,2024-03-04T16:38:59.597Z
2024-03-04,11:30 AM,11,7,18,3,2,41,2024-03-04T17:48:44.390Z
2024-03-04,12:30 PM,17,5,20,3,5,50,2024-03-04T18:37:21.510Z
2024-03-04,1:30 PM,3,2,17,6,3,31,2024-03-04T19:46:08.734Z
2024-03-04,2:30 PM,9,2,9,5,4,29,2024-03-04T20:41:59.197Z
2024-03-04,3:30 PM,6,2,9,3,2,22,2024-03-04T21:38:23.431Z
2024-03-04,4:30 PM,6,6,8,3,8,31,2024-03-04T22:37:38.058Z
2024-03-04,5:30 PM,5,4,10,1,0,20,2024-03-04T23:39:10.061Z
2024-03-04,6:30 PM,4,0,6,0,0,10,2024-03-05T00:43:19.640Z
2024-03-04,7:30 PM,5,0,3,0,0,8,2024-03-05T01:41:19.282Z
2024-03-04,8:30 PM,3,0,0,0,0,3,2024-03-05T02:28:52.847Z
2024-03-05,8:30 AM,2,2,0,0,0,4,2024-03-05T14:34:22.722Z
2024-03-05,10:30 AM,9,7,9,2,0,27,2024-03-05T16:37:01.123Z
2024-03-05,11:30 AM,7,3,8,1,0,19,2024-03-05T17:32:27.266Z
2024-03-05,12:30 PM,7,6,20,1,2,36,2024-03-05T18:41:40.478Z
2024-03-05,1:30 PM,9,5,20,2,0,36,2024-03-05T19:36:45.699Z
2024-03-05,2:30 PM,2,6,14,2,6,30,2024-03-05T20:49:11.739Z
2024-03-05,3:30 PM,3,7,7,1,0,18,2024-03-05T21:40:06.538Z
2024-03-05,5:30 PM,2,3,8,0,1,14,2024-03-05T23:33:48.982Z
2024-03-05,6:30 PM,0,5,7,0,0,12,2024-03-06T00:34:05.501Z
2024-03-06,8:30 AM,2,2,4,0,0,8,2024-03-06T14:43:32.325Z
2024-03-06,9:30 AM,5,8,7,1,2,23,2024-03-06T15:32:38.965Z
2024-03-06,10:30 AM,17,8,5,5,2,37,2024-03-06T16:30:29.833Z
2024-03-06,11:30 AM,8,7,12,5,2,34,2024-03-06T17:33:11.343Z
2024-03-06,1:30 PM,5,4,13,4,2,28,2024-03-06T19:42:30.233Z
2024-03-06,2:30 PM,4,9,12,2,7,34,2024-03-06T20:31:44.137Z
2024-03-06,3:30 PM,7,5,12,3,0,27,2024-03-06T21:41:35.129Z
2024-03-06,4:30 PM,5,4,12,2,1,24,2024-03-06T22:33:47.402Z
2024-03-06,5:30 PM,9,3,7,0,0,19,2024-03-06T23:32:51.730Z
2024-03-06,6:30 PM,2,2,5,3,2,14,2024-03-07T00:36:02.264Z
2024-03-06,7:30 PM,1,1,4,3,0,9,2024-03-07T01:45:52.471Z
2024-03-07,8:30 AM,2,1,1,0,0,4,2024-03-07T14:31:27.987Z
2024-03-07,9:30 AM,6,3,2,0,1,12,2024-03-07T15:31:32.978Z
2024-03-07,10:30 AM,4,6,11,0,0,21,2024-03-07T16:33:09.848Z
2024-03-07,11:30 AM,7,4,11,0,1,23,2024-03-07T17:30:00.446Z
2024-03-07,12:30 PM,10,6,13,2,2,33,2024-03-07T18:34:50.157Z
2024-03-07,1:30 PM,9,4,7,0,1,21,2024-03-07T19:29:58.794Z
2024-03-07,2:30 PM,9,5,9,0,2,25,2024-03-07T20:43:45.479Z
2024-03-07,3:30 PM,9,5,12,1,3,30,2024-03-07T21:39:46.969Z
2024-03-07,4:30 PM,6,2,6,4,0,18,2024-03-07T22:34:48.897Z
2024-03-07,5:30 PM,4,1,8,4,0,17,2024-03-07T23:32:50.874Z
2024-03-07,6:30 PM,4,2,4,2,1,13,2024-03-08T00:33:23.666Z
2024-03-08,8:30 AM,1,2,0,0,0,3,2024-03-08T14:33:01.659Z
2024-03-08,9:30 AM,1,3,2,1,0,7,2024-03-08T15:31:52.424Z
2024-03-08,10:30 AM,5,5,4,1,0,15,2024-03-08T16:24:10.718Z
2024-03-08,11:30 AM,15,1,6,0,0,22,2024-03-08T17:37:40.240Z
2024-03-08,12:30 PM,4,2,4,2,2,14,2024-03-08T18:35:08.494Z
2024-03-08,1:30 PM,5,2,4,0,3,14,2024-03-08T19:33:48.506Z
2024-03-08,2:30 PM,2,2,7,1,1,13,2024-03-08T20:44:37.915Z
2024-03-08,3:30 PM,3,1,1,1,3,9,2024-03-08T21:38:01.138Z
2024-03-08,4:30 PM,1,1,3,0,0,5,2024-03-08T22:38:18.437Z
2024-03-08,5:30 PM,3,1,0,0,0,4,2024-03-08T23:40:22.231Z
2024-03-08,6:30 PM,2,1,0,0,0,3,2024-03-09T00:54:03.780Z
2024-03-09,10:30 AM,2,0,4,0,0,6,2024-03-09T16:34:08.484Z
2024-03-09,11:30 AM,3,0,5,0,0,8,2024-03-09T17:33:32.244Z
2024-03-09,12:30 PM,4,1,5,2,5,17,2024-03-09T18:30:00.481Z
2024-03-09,1:30 PM,7,0,7,2,0,16,2024-03-09T19:41:02.459Z
2024-03-09,2:30 PM,4,1,3,2,0,10,2024-03-09T20:34:58.960Z
2024-03-09,3:30 PM,7,1,3,2,0,13,2024-03-09T21:33:44.988Z
2024-03-09,4:30 PM,7,0,2,0,1,10,2024-03-09T22:34:16.574Z
2024-03-09,5:30 PM,1,0,0,0,0,1,2024-03-09T23:22:18.337Z
2024-03-11,7:30 AM,1,0,1,0,0,2,2024-03-11T12:33:28.335Z
2024-03-11,8:30 AM,3,5,1,0,0,9,2024-03-11T13:45:04.772Z
2024-03-11,9:30 AM,5,3,5,0,0,13,2024-03-11T14:34:41.603Z
2024-03-11,10:30 AM,2,3,7,1,3,16,2024-03-11T15:31:28.335Z
2024-03-11,1:30 PM,7,3,11,2,0,23,2024-03-11T18:39:49.351Z
2024-03-11,2:30 PM,12,4,9,2,8,35,2024-03-11T19:52:16.738Z
2024-03-11,3:30 PM,9,5,5,1,9,29,2024-03-11T20:48:12.507Z
2024-03-11,4:30 PM,7,3,8,2,2,22,2024-03-11T21:36:33.582Z
2024-03-11,5:30 PM,7,5,7,3,4,26,2024-03-11T22:34:07.816Z
2024-03-11,6:30 PM,5,3,9,5,0,22,2024-03-11T23:36:35.363Z
2024-03-11,7:30 PM,4,1,5,1,1,12,2024-03-12T00:34:02.047Z
2024-03-11,8:30 PM,3,0,2,1,0,6,2024-03-12T01:28:34.931Z
2024-03-12,7:30 AM,2,0,0,0,2,4,2024-03-12T12:39:26.250Z
2024-03-12,8:30 AM,1,0,2,0,0,3,2024-03-12T13:32:46.562Z
2024-03-12,9:30 AM,3,3,6,0,0,12,2024-03-12T14:30:00.325Z
2024-03-12,10:30 AM,6,3,10,6,0,25,2024-03-12T15:15:44.703Z
2024-03-12,11:30 AM,8,2,8,3,1,22,2024-03-12T16:37:50.105Z
2024-03-12,12:30 PM,13,7,25,9,4,58,2024-03-12T17:36:00.603Z
2024-03-12,1:30 PM,11,6,19,3,2,41,2024-03-12T18:39:11.212Z
2024-03-12,2:30 PM,5,2,16,2,1,26,2024-03-12T19:32:04.632Z
2024-03-12,3:30 PM,6,2,10,2,1,21,2024-03-12T20:34:03.491Z
2024-03-12,4:30 PM,6,1,6,1,0,14,2024-03-12T21:32:54.595Z
2024-03-12,5:30 PM,3,1,7,0,1,12,2024-03-12T22:35:30.649Z
2024-03-12,6:30 PM,3,1,5,0,0,9,2024-03-12T23:32:39.726Z
2024-03-12,7:30 PM,2,1,4,1,4,12,2024-03-13T00:34:12.152Z
2024-03-12,8:30 PM,3,0,3,1,2,9,2024-03-13T01:37:04.345Z
2024-03-13,7:30 AM,0,0,1,0,0,1,2024-03-13T13:22:16.568Z
2024-03-13,8:30 AM,3,2,7,0,0,12,2024-03-13T13:34:12.661Z
2024-03-13,9:30 AM,2,5,5,2,0,14,2024-03-13T14:34:19.438Z
2024-03-13,10:30 AM,2,5,6,1,0,14,2024-03-13T15:30:50.246Z
2024-03-13,11:30 AM,5,3,12,2,0,22,2024-03-13T16:33:28.976Z
2024-03-13,12:30 PM,7,6,24,3,0,40,2024-03-13T17:45:57.107Z
2024-03-13,1:30 PM,6,3,11,6,1,27,2024-03-13T18:32:52.292Z
2024-03-13,2:30 PM,9,6,9,0,10,34,2024-03-13T19:37:28.877Z
2024-03-13,3:30 PM,7,4,9,4,10,34,2024-03-13T20:33:58.971Z
2024-03-13,6:30 PM,4,1,1,0,2,8,2024-03-13T23:37:13.519Z
2024-03-14,7:30 AM,1,0,0,0,0,1,2024-03-14T12:46:36.844Z
2024-03-14,8:30 AM,1,0,3,0,0,4,2024-03-14T13:31:41.001Z
2024-03-14,9:30 AM,2,3,4,0,0,9,2024-03-14T14:35:49.041Z
2024-03-14,10:30 AM,3,3,6,2,0,14,2024-03-14T15:34:13.495Z
2024-03-14,11:30 AM,4,3,7,1,2,17,2024-03-14T16:38:10.897Z
2024-03-14,12:30 PM,9,3,21,3,0,36,2024-03-14T17:40:09.206Z
2024-03-14,1:30 PM,12,2,8,0,0,22,2024-03-14T18:40:05.946Z
2024-03-14,2:30 PM,11,1,5,0,1,18,2024-03-14T19:35:43.898Z
2024-03-14,3:30 PM,8,2,3,1,0,14,2024-03-14T20:37:31.705Z
2024-03-14,4:30 PM,6,2,4,1,3,16,2024-03-14T21:35:47.051Z
2024-03-14,5:30 PM,3,2,3,1,0,9,2024-03-14T22:35:16.084Z
2024-03-14,6:30 PM,4,1,3,0,1,9,2024-03-14T23:33:02.310Z
2024-03-14,7:30 PM,2,1,1,1,2,7,2024-03-15T00:49:27.244Z
2024-03-14,8:30 PM,1,0,1,1,1,4,2024-03-15T01:30:14.459Z
2024-03-15,7:30 AM,1,0,0,0,0,1,2024-03-15T12:40:04.409Z
2024-03-15,8:30 AM,2,1,2,0,0,5,2024-03-15T13:43:11.346Z
2024-03-15,9:30 AM,1,0,0,0,0,1,2024-03-15T14:27:52.571Z
2024-03-15,10:30 AM,3,1,2,1,0,7,2024-03-15T15:32:03.178Z
2024-03-15,11:30 AM,3,1,1,0,0,5,2024-03-15T16:34:04.837Z
2024-03-15,12:30 PM,6,0,1,0,0,7,2024-03-15T17:35:42.337Z
2024-03-15,1:30 PM,2,0,5,0,0,7,2024-03-15T18:48:57.266Z
2024-03-15,2:30 PM,2,0,2,0,0,4,2024-03-15T19:40:03.643Z
2024-03-15,3:30 PM,1,1,3,1,0,6,2024-03-15T20:40:57.914Z
2024-03-15,4:30 PM,2,0,4,1,0,7,2024-03-15T21:41:00.466Z
2024-03-15,5:30 PM,1,1,3,1,0,6,2024-03-15T22:36:38.856Z
2024-03-15,6:30 PM,1,1,0,0,0,2,2024-03-15T23:42:25.607Z
2024-03-16,10:30 AM,1,1,0,1,0,3,2024-03-16T15:40:58.629Z
2024-03-16,11:30 AM,1,0,1,1,0,3,2024-03-16T16:37:47.979Z
2024-03-16,12:30 PM,3,1,1,1,0,6,2024-03-16T17:49:33.414Z
2024-03-16,1:30 PM,1,0,0,0,0,1,2024-03-16T19:01:34.174Z
2024-03-16,2:30 PM,1,0,0,0,0,1,2024-03-16T19:32:59.371Z
2024-03-16,3:30 PM,1,0,1,1,0,3,2024-03-16T20:33:27.101Z
2024-03-18,9:30 AM,1,0,0,0,0,1,2024-03-18T14:47:03.051Z
2024-03-18,10:30 AM,4,0,0,0,0,4,2024-03-18T15:34:09.930Z
2024-03-18,11:30 AM,2,1,1,2,0,6,2024-03-18T16:33:28.384Z
2024-03-18,12:30 PM,6,1,0,1,0,8,2024-03-18T17:33:56.312Z
2024-03-18,1:30 PM,1,0,0,1,0,2,2024-03-18T18:37:00.936Z
2024-03-18,2:30 PM,1,1,0,0,0,2,2024-03-18T19:38:17.143Z
2024-03-18,5:30 PM,2,0,0,1,0,3,2024-03-18T22:43:52.592Z
2024-03-19,9:30 AM,1,0,0,0,0,1,2024-03-19T14:06:29.547Z
2024-03-19,11:30 AM,3,0,0,0,0,3,2024-03-19T16:33:48.882Z
2024-03-19,12:30 PM,3,0,1,1,0,5,2024-03-19T17:44:28.716Z
2024-03-19,1:30 PM,2,0,2,0,0,4,2024-03-19T18:33:26.789Z
2024-03-19,2:30 PM,4,0,4,0,0,8,2024-03-19T19:44:58.554Z
2024-03-19,3:30 PM,3,0,4,0,0,7,2024-03-19T20:40:39.406Z
2024-03-19,4:30 PM,3,0,3,0,0,6,2024-03-19T21:36:48.724Z
2024-03-20,9:30 AM,1,0,0,0,0,1,2024-03-20T14:34:43.815Z
2024-03-20,10:30 AM,3,0,0,0,0,3,2024-03-20T15:37:43.641Z
2024-03-20,11:30 AM,5,0,3,0,0,8,2024-03-20T16:33:08.290Z
2024-03-20,12:30 PM,4,1,4,0,0,9,2024-03-20T17:30:24.233Z
2024-03-20,1:30 PM,4,2,4,0,0,10,2024-03-20T18:34:54.813Z
2024-03-20,2:30 PM,3,2,4,0,2,11,2024-03-20T19:33:04.903Z
2024-03-20,4:30 PM,2,1,3,0,0,6,2024-03-20T21:32:56.238Z
2024-03-21,10:30 AM,3,0,2,0,0,5,2024-03-21T15:34:06.108Z
2024-03-21,11:30 AM,2,0,5,0,0,7,2024-03-21T16:34:46.658Z
2024-03-21,12:30 PM,3,0,7,0,0,10,2024-03-21T17:36:11.409Z
2024-03-21,1:30 PM,5,0,4,0,0,9,2024-03-21T18:32:57.503Z
2024-03-21,2:30 PM,4,0,0,0,0,4,2024-03-21T19:37:44.273Z
2024-03-21,3:30 PM,4,1,1,1,0,7,2024-03-21T20:34:46.038Z
2024-03-21,4:30 PM,2,0,0,0,0,2,2024-03-21T21:46:46.372Z
2024-03-22,9:30 AM,1,0,0,0,0,1,2024-03-22T14:34:22.051Z
2024-03-22,10:30 AM,3,0,0,0,1,4,2024-03-22T15:32:10.771Z
2024-03-22,11:30 AM,2,0,2,0,1,5,2024-03-22T16:33:20.359Z
2024-03-22,12:30 PM,4,0,1,0,1,6,2024-03-22T17:30:27.904Z
2024-03-22,1:30 PM,2,0,1,0,0,3,2024-03-22T18:45:28.776Z
2024-03-22,2:30 PM,2,1,2,0,0,5,2024-03-22T19:32:41.932Z
2024-03-22,4:30 PM,1,1,0,1,0,3,2024-03-22T21:33:14.658Z
2024-03-25,8:30 AM,5,2,5,1,0,13,2024-03-25T13:29:11.022Z
2024-03-25,9:30 AM,1,3,6,0,0,10,2024-03-25T14:40:24.083Z
2024-03-25,10:30 AM,5,5,5,1,0,16,2024-03-25T15:31:38.355Z
2024-03-25,12:30 PM,13,2,16,1,2,34,2024-03-25T18:10:31.831Z
2024-03-25,1:30 PM,5,1,11,4,1,22,2024-03-25T18:35:04.212Z
2024-03-25,2:30 PM,8,1,7,1,3,20,2024-03-25T19:39:33.398Z
2024-03-25,3:30 PM,5,2,5,2,1,15,2024-03-25T20:39:01.856Z
2024-03-25,4:30 PM,2,7,11,2,2,24,2024-03-25T21:40:14.986Z
2024-03-25,5:30 PM,5,7,9,3,0,24,2024-03-25T22:35:00.101Z
2024-03-25,6:30 PM,1,4,4,3,0,12,2024-03-25T23:33:31.664Z
2024-03-25,7:30 PM,9,3,7,1,0,20,2024-03-26T00:33:56.053Z
2024-03-25,8:30 PM,3,2,3,1,1,10,2024-03-26T01:32:49.831Z
2024-03-26,8:30 AM,0,0,2,0,0,2,2024-03-26T13:32:50.757Z
2024-03-26,9:30 AM,2,5,8,2,0,17,2024-03-26T14:48:46.804Z
2024-03-26,10:30 AM,5,7,10,1,0,23,2024-03-26T15:34:58.423Z
2024-03-26,11:30 AM,6,3,10,1,2,22,2024-03-26T16:41:54.796Z
2024-03-26,12:30 PM,15,4,17,7,1,44,2024-03-26T17:39:51.353Z
2024-03-26,1:30 PM,10,6,16,2,4,38,2024-03-26T18:39:00.408Z
2024-03-26,2:30 PM,9,3,7,2,5,26,2024-03-26T19:44:50.476Z
2024-03-26,3:30 PM,10,3,8,2,0,23,2024-03-26T20:42:22.889Z
2024-03-26,4:30 PM,3,2,7,2,0,14,2024-03-26T21:32:45.024Z
2024-03-26,5:30 PM,8,3,6,2,0,19,2024-03-26T22:34:58.097Z
2024-03-26,6:30 PM,3,2,7,6,0,18,2024-03-26T23:32:53.561Z
2024-03-26,7:30 PM,4,1,3,1,1,10,2024-03-27T00:49:57.923Z
2024-03-26,8:30 PM,2,0,0,1,1,4,2024-03-27T01:48:39.236Z
2024-03-27,7:30 AM,2,0,0,0,0,2,2024-03-27T13:38:17.466Z
2024-03-27,8:30 AM,4,2,3,0,0,9,2024-03-27T13:38:35.385Z
2024-03-27,9:30 AM,5,5,5,0,0,15,2024-03-27T14:32:36.038Z
2024-03-27,10:30 AM,6,7,10,3,0,26,2024-03-27T15:32:36.777Z
2024-03-27,12:30 PM,21,6,20,3,0,50,2024-03-27T17:35:37.743Z
2024-03-27,1:30 PM,17,5,7,1,2,32,2024-03-27T18:32:05.943Z
2024-03-27,2:30 PM,9,3,5,2,4,23,2024-03-27T19:34:47.207Z
2024-03-27,3:30 PM,16,3,6,3,8,36,2024-03-27T20:31:29.675Z
2024-03-27,4:30 PM,4,1,4,3,2,14,2024-03-27T21:34:42.983Z
2024-03-27,6:30 PM,3,0,1,0,0,4,2024-03-27T23:34:00.040Z
2024-03-27,7:30 PM,4,2,0,1,0,7,2024-03-28T00:54:32.739Z
2024-03-27,8:30 PM,1,0,0,0,0,1,2024-03-28T01:40:10.161Z
2024-03-28,8:30 AM,2,0,0,0,0,2,2024-03-28T13:19:57.653Z
2024-03-28,7:30 AM,1,0,1,0,0,2,2024-03-28T13:36:44.023Z
2024-03-28,9:30 AM,4,2,1,0,0,7,2024-03-28T14:34:03.663Z
2024-03-28,10:30 AM,7,5,4,2,0,18,2024-03-28T15:35:07.494Z
2024-03-28,11:30 AM,3,3,5,1,1,13,2024-03-28T16:33:03.175Z
2024-03-28,12:30 PM,7,6,12,3,2,30,2024-03-28T17:37:26.315Z
2024-03-28,1:30 PM,5,5,13,6,2,31,2024-03-28T18:42:08.811Z
2024-03-28,2:30 PM,12,1,11,4,1,29,2024-03-28T19:34:55.571Z
2024-03-28,3:30 PM,12,2,4,2,0,20,2024-03-28T20:47:53.556Z
2024-03-28,4:30 PM,8,1,3,2,0,14,2024-03-28T21:33:58.332Z
2024-03-28,5:30 PM,6,2,5,3,0,16,2024-03-28T22:33:14.105Z
2024-03-28,6:30 PM,6,1,5,1,0,13,2024-03-28T23:44:22.088Z
2024-03-28,7:30 PM,2,1,1,3,0,7,2024-03-29T00:44:44.150Z
2024-03-29,7:30 AM,2,0,0,0,0,2,2024-03-29T13:07:40.917Z
2024-03-29,8:30 AM,1,0,0,0,0,1,2024-03-29T13:24:49.241Z
2024-03-29,9:30 AM,1,1,0,0,0,2,2024-03-29T14:24:47.840Z
2024-03-29,10:30 AM,2,2,3,0,0,7,2024-03-29T15:34:59.031Z
2024-03-29,11:30 AM,3,1,6,0,0,10,2024-03-29T16:39:04.843Z
2024-03-29,12:30 PM,4,1,5,0,0,10,2024-03-29T17:35:21.458Z
2024-03-29,1:30 PM,3,1,1,1,1,7,2024-03-29T18:36:55.335Z
2024-03-29,2:30 PM,0,1,2,1,0,4,2024-03-29T19:29:41.290Z
2024-03-29,3:30 PM,4,2,3,1,1,11,2024-03-29T20:54:48.304Z
2024-03-29,4:30 PM,3,3,3,1,2,12,2024-03-29T21:36:29.358Z
2024-03-29,5:30 PM,3,0,0,1,0,4,2024-03-29T22:32:50.813Z
2024-03-29,6:30 PM,1,1,0,0,0,2,2024-03-29T23:58:57.001Z
2024-03-30,10:30 AM,3,0,1,1,0,5,2024-03-30T15:41:31.601Z
2024-03-30,11:30 AM,4,0,5,1,1,11,2024-03-30T16:32:53.992Z
2024-03-30,12:30 PM,6,0,5,1,0,12,2024-03-30T17:42:48.539Z
2024-03-30,1:30 PM,7,0,3,0,0,10,2024-03-30T18:51:29.609Z
2024-03-30,2:30 PM,6,0,3,0,0,9,2024-03-30T19:33:27.856Z
2024-03-30,3:30 PM,3,0,0,3,0,6,2024-03-30T20:38:19.220Z
2024-03-30,4:30 PM,4,0,0,4,0,8,2024-03-30T21:34:13.244Z
2024-04-01,7:30 AM,0,0,1,0,0,1,2024-04-01T12:31:02.693Z
2024-04-01,8:30 AM,3,1,4,0,0,8,2024-04-01T13:31:00.108Z
2024-04-01,9:30 AM,2,2,5,0,1,10,2024-04-01T14:31:31.494Z
2024-04-01,10:30 AM,8,4,7,1,0,20,2024-04-01T15:34:29.724Z
2024-04-01,12:30 PM,16,6,20,5,5,52,2024-04-01T17:33:46.006Z
2024-04-01,1:30 PM,30,7,15,2,1,55,2024-04-01T18:35:09.613Z
2024-04-01,2:30 PM,9,4,8,1,4,26,2024-04-01T19:45:18.363Z
2024-04-01,3:30 PM,13,3,7,5,0,28,2024-04-01T20:34:30.551Z
2024-04-01,4:30 PM,4,4,10,0,2,20,2024-04-01T21:36:30.820Z
2024-04-01,5:30 PM,4,3,8,1,0,16,2024-04-01T22:35:09.792Z
2024-04-01,6:30 PM,1,2,6,0,0,9,2024-04-01T23:37:41.277Z
2024-04-01,7:30 PM,0,0,0,0,0,0,2024-04-02T00:38:53.036Z
2024-04-01,8:30 PM,0,0,0,0,0,0,2024-04-02T01:44:03.788Z
2024-04-02,7:30 AM,4,0,2,0,0,6,2024-04-02T12:40:34.022Z
2024-04-02,8:30 AM,2,0,5,0,0,7,2024-04-02T13:36:58.088Z
2024-04-02,9:30 AM,4,1,4,0,0,9,2024-04-02T14:33:03.117Z
2024-04-02,10:30 AM,4,4,11,1,0,20,2024-04-02T15:30:33.057Z
2024-04-02,11:30 AM,4,2,13,1,3,23,2024-04-02T16:36:52.251Z
2024-04-02,12:30 PM,12,4,17,3,3,39,2024-04-02T17:36:58.106Z
2024-04-02,1:30 PM,6,5,12,2,2,27,2024-04-02T18:36:18.897Z
2024-04-02,2:30 PM,10,2,6,2,1,21,2024-04-02T19:35:21.539Z
2024-04-02,3:30 PM,6,1,6,2,0,15,2024-04-02T20:40:30.668Z
2024-04-02,4:30 PM,9,0,5,2,2,18,2024-04-02T21:33:32.006Z
2024-04-02,5:30 PM,7,1,8,2,0,18,2024-04-02T22:33:38.703Z
2024-04-02,6:30 PM,4,1,0,1,2,8,2024-04-02T23:44:57.167Z
2024-04-02,7:30 PM,1,1,1,1,0,4,2024-04-03T00:42:16.314Z
2024-04-02,8:30 PM,1,0,0,1,0,2,2024-04-03T01:32:47.011Z
2024-04-03,7:30 AM,1,0,2,0,0,3,2024-04-03T12:55:06.403Z
2024-04-03,8:30 AM,1,0,4,0,0,5,2024-04-03T13:34:54.418Z
2024-04-03,9:30 AM,1,1,8,1,0,11,2024-04-03T14:32:08.004Z
2024-04-03,10:30 AM,4,6,13,3,1,27,2024-04-03T15:36:05.825Z
2024-04-03,12:30 PM,10,3,22,11,6,52,2024-04-03T17:41:06.065Z
2024-04-03,1:30 PM,10,7,11,11,0,39,2024-04-03T19:01:49.350Z
2024-04-03,2:30 PM,6,1,12,1,3,23,2024-04-03T19:41:11.741Z
2024-04-03,3:30 PM,8,4,9,10,3,34,2024-04-03T20:50:01.386Z
2024-04-03,4:30 PM,5,5,7,8,0,25,2024-04-03T21:35:08.889Z
2024-04-03,5:30 PM,8,3,9,2,1,23,2024-04-03T22:44:43.176Z
2024-04-03,6:30 PM,5,0,5,2,1,13,2024-04-03T23:38:20.485Z
2024-04-03,7:30 PM,5,1,2,2,1,11,2024-04-04T00:33:27.822Z
2024-04-03,8:30 PM,2,0,1,0,0,3,2024-04-04T01:50:28.511Z
2024-04-04,7:30 AM,2,0,1,0,0,3,2024-04-04T12:46:35.217Z
2024-04-04,8:30 AM,2,0,2,0,0,4,2024-04-04T13:25:39.673Z
2024-04-04,9:30 AM,0,3,4,0,0,7,2024-04-04T14:29:49.803Z
2024-04-04,10:30 AM,2,4,4,1,0,11,2024-04-04T15:31:39.486Z
2024-04-04,11:30 AM,5,3,9,1,0,18,2024-04-04T16:35:17.265Z
2024-04-04,1:30 PM,5,2,16,2,1,26,2024-04-04T18:39:39.074Z
2024-04-04,12:30 PM,9,1,20,5,1,36,2024-04-04T19:33:35.671Z
2024-04-04,2:30 PM,2,5,8,0,1,16,2024-04-04T19:40:51.495Z
2024-04-04,3:30 PM,7,2,6,1,0,16,2024-04-04T20:41:20.174Z
2024-04-04,4:30 PM,8,3,9,2,0,22,2024-04-04T21:40:29.544Z
2024-04-04,5:30 PM,4,3,10,4,1,22,2024-04-04T22:36:31.083Z
2024-04-04,6:30 PM,4,1,2,2,0,9,2024-04-04T23:33:52.285Z
2024-04-04,7:30 PM,5,1,0,0,0,6,2024-04-05T00:42:50.859Z
2024-04-04,8:30 PM,3,1,0,0,5,9,2024-04-05T01:35:44.557Z
2024-04-05,8:30 AM,4,0,0,0,0,4,2024-04-05T13:31:23.035Z
2024-04-05,9:30 AM,2,1,0,2,0,5,2024-04-05T14:31:11.047Z
2024-04-05,7:30 AM,1,0,0,0,0,1,2024-04-05T15:27:50.087Z
2024-04-05,10:30 AM,3,1,1,4,0,9,2024-04-05T15:31:42.170Z
2024-04-05,11:30 AM,3,1,7,6,0,17,2024-04-05T16:37:50.131Z
2024-04-05,1:30 PM,5,1,3,1,0,10,2024-04-05T18:30:22.480Z
2024-04-05,3:30 PM,1,0,4,2,1,8,2024-04-05T20:38:17.036Z
2024-04-05,4:30 PM,1,1,3,0,0,5,2024-04-05T21:43:50.126Z
2024-04-05,5:30 PM,5,1,3,0,1,10,2024-04-05T22:37:41.267Z
2024-04-05,6:30 PM,6,1,0,0,0,7,2024-04-05T23:33:32.680Z
2024-04-06,10:30 AM,1,0,1,0,1,3,2024-04-06T15:43:40.339Z
2024-04-06,11:30 AM,4,1,3,0,1,9,2024-04-06T17:20:46.614Z
2024-04-06,12:30 PM,3,0,9,4,2,18,2024-04-06T17:57:06.760Z
2024-04-06,1:30 PM,4,0,9,2,0,15,2024-04-06T18:45:47.332Z
2024-04-06,2:30 PM,5,0,4,3,0,12,2024-04-06T19:36:34.229Z
2024-04-06,3:30 PM,5,2,3,2,0,12,2024-04-06T20:37:27.524Z
2024-04-06,4:30 PM,2,0,3,1,0,6,2024-04-06T21:32:50.186Z
2024-04-08,7:30 AM,1,0,3,0,0,4,2024-04-08T12:42:35.791Z
2024-04-08,8:30 AM,2,0,5,0,0,7,2024-04-08T13:25:45.450Z
2024-04-08,9:30 AM,3,2,4,0,0,9,2024-04-08T15:35:00.173Z
2024-04-08,10:30 AM,4,4,12,5,0,25,2024-04-08T15:37:20.830Z
2024-04-08,1:30 PM,3,1,6,0,8,18,2024-04-08T18:32:47.274Z
2024-04-08,2:30 PM,6,0,12,1,5,24,2024-04-08T19:39:55.017Z
2024-04-08,4:30 PM,1,2,12,2,0,17,2024-04-08T21:36:33.530Z
2024-04-08,5:30 PM,8,5,10,3,0,26,2024-04-08T22:42:00.934Z
2024-04-08,6:30 PM,9,7,4,0,0,20,2024-04-08T23:34:10.889Z
2024-04-08,7:30 PM,6,1,4,1,0,12,2024-04-09T00:47:55.971Z
2024-04-08,8:30 PM,5,0,4,0,0,9,2024-04-09T01:35:42.071Z
2024-04-09,7:30 AM,1,0,0,0,0,1,2024-04-09T12:38:36.446Z
2024-04-09,8:30 AM,4,1,2,0,0,7,2024-04-09T14:05:43.757Z
2024-04-09,9:30 AM,2,0,7,2,0,11,2024-04-09T14:35:17.254Z
2024-04-09,10:30 AM,7,2,6,2,3,20,2024-04-09T15:32:37.521Z
2024-04-09,11:30 AM,5,3,9,1,1,19,2024-04-09T16:35:17.653Z
2024-04-09,12:30 PM,13,4,17,6,1,41,2024-04-09T17:31:11.559Z
2024-04-09,1:30 PM,5,3,16,3,2,29,2024-04-09T18:33:53.639Z
2024-04-09,2:30 PM,6,3,15,2,1,27,2024-04-09T19:32:53.832Z
2024-04-09,3:30 PM,7,3,9,3,0,22,2024-04-09T20:44:52.688Z
2024-04-09,4:30 PM,7,3,7,4,0,21,2024-04-09T21:36:25.664Z
2024-04-09,5:30 PM,6,4,4,2,0,16,2024-04-09T22:38:21.934Z
2024-04-09,6:30 PM,5,3,2,1,0,11,2024-04-09T23:35:36.141Z
2024-04-09,7:30 PM,3,2,1,2,1,9,2024-04-10T00:37:31.871Z
2024-04-10,7:30 AM,2,0,1,0,0,3,2024-04-10T13:27:08.187Z
2024-04-10,8:30 AM,2,1,2,0,0,5,2024-04-10T13:27:28.917Z
2024-04-10,9:30 AM,8,0,4,0,0,12,2024-04-10T14:36:30.343Z
2024-04-10,10:30 AM,7,4,7,3,0,21,2024-04-10T15:35:06.323Z
2024-04-10,11:30 AM,20,5,5,11,1,42,2024-04-10T16:43:17.024Z
2024-04-10,12:30 PM,13,6,15,5,2,41,2024-04-10T17:36:23.029Z
2024-04-10,2:30 PM,6,5,7,4,2,24,2024-04-10T19:37:46.002Z
2024-04-10,3:30 PM,16,2,5,7,1,31,2024-04-10T20:39:00.057Z
2024-04-10,4:30 PM,7,4,5,2,0,18,2024-04-10T21:34:30.467Z
2024-04-10,7:30 PM,2,1,0,1,1,5,2024-04-11T00:38:01.951Z
2024-04-11,8:30 AM,1,0,0,1,0,2,2024-04-11T13:09:30.615Z
2024-04-11,7:30 AM,0,0,0,0,0,0,2024-04-11T13:34:19.130Z
2024-04-11,9:30 AM,2,1,2,1,0,6,2024-04-11T14:36:13.334Z
2024-04-11,10:30 AM,2,7,8,4,0,21,2024-04-11T15:35:20.703Z
2024-04-11,11:30 AM,6,3,11,0,0,20,2024-04-11T16:37:53.914Z
2024-04-11,12:30 PM,11,8,12,7,4,42,2024-04-11T17:37:21.307Z
2024-04-11,1:30 PM,11,3,15,4,1,34,2024-04-11T18:38:56.960Z
2024-04-11,2:30 PM,5,3,7,2,1,18,2024-04-11T19:38:04.842Z
2024-04-11,3:30 PM,7,3,10,0,0,20,2024-04-11T20:40:30.511Z
2024-04-11,4:30 PM,8,2,9,0,0,19,2024-04-11T22:07:31.463Z
2024-04-11,5:30 PM,7,3,5,4,0,19,2024-04-11T22:38:04.037Z
2024-04-11,6:30 PM,5,4,4,0,0,13,2024-04-11T23:33:00.583Z
2024-04-11,7:30 PM,5,1,3,1,1,11,2024-04-12T00:42:42.018Z
2024-04-12,7:30 AM,2,0,0,0,0,2,2024-04-12T13:20:33.383Z
2024-04-12,8:30 AM,1,0,0,0,0,1,2024-04-12T13:26:27.301Z
2024-04-12,9:30 AM,2,1,2,0,0,5,2024-04-12T14:47:41.425Z
2024-04-12,10:30 AM,2,2,2,0,0,6,2024-04-12T15:31:31.199Z
2024-04-12,11:30 AM,5,1,3,2,1,12,2024-04-12T16:32:30.814Z
2024-04-12,3:30 PM,5,1,2,0,3,11,2024-04-12T20:32:54.136Z
2024-04-12,4:30 PM,5,1,3,0,2,11,2024-04-12T21:31:20.339Z
2024-04-12,5:30 PM,3,1,2,0,0,6,2024-04-12T22:34:50.082Z
2024-04-12,6:30 PM,2,1,2,0,0,5,2024-04-12T23:32:40.744Z
2024-04-12,1:30 PM,5,3,4,0,0,12,2024-06-12T18:42:03.283Z
2024-04-13,10:30 AM,2,1,1,0,0,4,2024-04-13T15:31:10.152Z
2024-04-13,11:30 AM,4,1,2,0,1,8,2024-04-13T16:36:31.276Z
2024-04-13,12:30 PM,3,2,3,1,7,16,2024-04-13T17:35:07.691Z
2024-04-13,1:30 PM,6,2,1,0,0,9,2024-04-13T18:47:12.015Z
2024-04-13,2:30 PM,6,2,1,2,1,12,2024-04-13T19:32:48.888Z
2024-04-13,3:30 PM,3,3,1,2,0,9,2024-04-13T20:37:06.171Z
2024-04-13,4:30 PM,1,0,0,0,0,1,2024-04-13T21:34:29.110Z
2024-04-15,7:30 AM,4,0,1,0,0,5,2024-04-15T12:36:01.714Z
2024-04-15,8:30 AM,2,0,5,0,0,7,2024-04-15T13:32:38.379Z
2024-04-15,9:30 AM,1,2,8,2,0,13,2024-04-15T14:36:55.161Z
2024-04-15,10:30 AM,6,4,13,6,0,29,2024-04-15T15:37:00.177Z
2024-04-15,11:30 AM,16,2,21,6,2,47,2024-04-15T16:37:37.054Z
2024-04-15,12:30 PM,9,2,27,3,1,42,2024-04-15T18:04:42.471Z
2024-04-15,1:30 PM,19,3,20,9,1,52,2024-04-15T18:40:19.061Z
2024-04-15,2:30 PM,6,2,10,6,10,34,2024-04-15T19:39:11.233Z
2024-04-15,3:30 PM,11,2,10,4,4,31,2024-04-15T20:39:35.321Z
2024-04-15,4:30 PM,5,2,8,4,3,22,2024-04-15T21:40:15.447Z
2024-04-15,5:30 PM,8,4,7,7,0,26,2024-04-15T22:35:08.405Z
2024-04-15,6:30 PM,6,3,5,3,1,18,2024-04-15T23:39:56.651Z
2024-04-15,7:30 PM,9,4,3,1,0,17,2024-04-16T00:43:31.721Z
2024-04-16,7:30 AM,4,0,0,1,0,5,2024-04-16T12:54:04.814Z
2024-04-16,8:30 AM,2,2,1,0,0,5,2024-04-16T13:32:16.626Z
2024-04-16,9:30 AM,4,6,8,1,0,19,2024-04-16T14:30:53.610Z
2024-04-16,10:30 AM,11,2,8,1,0,22,2024-04-16T15:37:43.537Z
2024-04-16,12:30 PM,9,6,23,2,3,43,2024-04-16T17:31:06.459Z
2024-04-16,12:30 PM,10,6,25,3,2,46,2024-04-16T17:36:56.522Z
2024-04-16,1:30 PM,7,8,11,5,1,32,2024-04-16T18:32:33.424Z
2024-04-16,2:30 PM,12,4,4,6,2,28,2024-04-16T19:31:20.711Z
2024-04-16,3:30 PM,11,2,6,2,0,21,2024-04-16T20:55:23.846Z
2024-04-16,4:30 PM,8,5,6,1,0,20,2024-04-16T21:33:39.601Z
2024-04-16,5:30 PM,5,6,5,1,0,17,2024-04-16T22:37:31.771Z
2024-04-16,6:30 PM,6,4,3,0,0,13,2024-04-16T23:33:53.463Z
2024-04-16,7:30 PM,4,1,4,0,3,12,2024-04-17T00:39:32.509Z
2024-04-16,8:30 PM,3,1,5,3,0,12,2024-04-17T01:31:04.752Z
2024-04-17,7:30 AM,2,0,1,0,0,3,2024-04-17T12:44:33.280Z
2024-04-17,8:30 AM,1,0,2,0,0,3,2024-04-17T13:30:14.764Z
2024-04-17,9:30 AM,3,4,6,4,0,17,2024-04-17T14:29:59.831Z
2024-04-17,10:30 AM,6,7,12,7,0,32,2024-04-17T15:31:39.124Z
2024-04-17,11:30 AM,6,7,15,6,0,34,2024-04-17T16:44:23.812Z
2024-04-17,12:30 PM,15,8,20,4,1,48,2024-04-17T17:40:12.689Z
2024-04-17,1:30 PM,12,5,14,2,1,34,2024-04-17T18:45:25.596Z
2024-04-17,3:30 PM,5,5,12,7,12,41,2024-04-17T20:37:23.996Z
2024-04-17,4:30 PM,6,4,10,2,0,22,2024-04-17T21:42:25.111Z
2024-04-17,5:30 PM,8,3,9,1,1,22,2024-04-17T22:38:33.989Z
2024-04-17,6:30 PM,5,2,5,0,1,13,2024-04-17T23:33:17.147Z
2024-04-17,7:30 PM,3,2,4,4,0,13,2024-04-18T00:37:12.497Z
2024-04-17,8:30 PM,3,3,2,4,0,12,2024-04-18T01:25:23.802Z
2024-04-17,7:30 AM,5,0,0,0,0,5,2024-09-17T12:45:00.516Z
2024-04-18,7:30 AM,3,1,0,1,0,5,2024-04-18T13:02:42.074Z
2024-04-18,8:30 AM,2,1,0,0,0,3,2024-04-18T13:37:13.707Z
2024-04-18,9:30 AM,1,3,3,2,0,9,2024-04-18T14:32:49.252Z
2024-04-18,10:30 AM,7,6,2,5,0,20,2024-04-18T15:37:07.894Z
2024-04-18,12:30 PM,11,3,13,0,3,30,2024-04-18T18:11:26.272Z
2024-04-18,1:30 PM,7,4,19,4,2,36,2024-04-18T18:34:46.677Z
2024-04-18,2:30 PM,8,3,9,5,3,28,2024-04-18T19:36:05.597Z
2024-04-18,3:30 PM,8,5,8,5,0,26,2024-04-18T20:38:25.063Z
2024-04-18,4:30 PM,8,5,9,2,0,24,2024-04-18T21:40:04.361Z
2024-04-18,5:30 PM,7,6,8,4,0,25,2024-04-18T22:34:20.249Z
2024-04-18,6:30 PM,2,2,5,0,0,9,2024-04-18T23:34:53.807Z
2024-04-18,7:30 PM,1,1,2,0,3,7,2024-04-19T00:50:05.468Z
2024-04-18,8:30 PM,1,0,2,0,2,5,2024-04-19T01:59:41.613Z
2024-04-19,7:30 AM,0,0,1,0,0,1,2024-04-19T12:50:13.230Z
2024-04-19,8:30 AM,3,1,1,0,0,5,2024-04-19T13:30:21.136Z
2024-04-19,9:30 AM,1,2,2,0,0,5,2024-04-19T14:28:35.432Z
2024-04-19,10:30 AM,2,2,2,2,0,8,2024-04-19T15:32:07.650Z
2024-04-19,11:30 AM,6,2,4,1,0,13,2024-04-19T16:54:33.991Z
2024-04-19,12:30 PM,4,1,5,1,1,12,2024-04-19T17:39:34.822Z
2024-04-19,2:30 PM,5,2,4,1,0,12,2024-04-19T19:41:58.860Z
2024-04-19,3:30 PM,5,2,6,1,0,14,2024-04-19T20:40:28.845Z
2024-04-19,4:30 PM,1,1,3,1,0,6,2024-04-19T21:37:40.376Z
2024-04-19,5:30 PM,1,1,3,0,0,5,2024-04-19T22:41:06.994Z
2024-04-19,6:30 PM,2,1,1,0,0,4,2024-04-19T23:30:09.024Z
2024-04-20,10:30 AM,1,2,3,1,0,7,2024-04-20T15:31:59.362Z
2024-04-20,11:30 AM,0,1,5,1,0,7,2024-04-20T16:36:30.449Z
2024-04-20,12:30 PM,2,2,2,2,0,8,2024-04-20T17:35:23.335Z
2024-04-20,1:30 PM,3,1,3,1,0,8,2024-04-20T18:49:57.046Z
2024-04-20,2:30 PM,4,1,3,0,1,9,2024-04-20T19:34:10.867Z
2024-04-20,3:30 PM,3,2,1,0,0,6,2024-04-20T20:35:02.525Z
2024-04-20,4:30 PM,2,1,1,0,0,4,2024-04-20T21:38:52.847Z
2024-04-20,5:30 PM,0,0,0,0,0,0,2024-04-20T22:27:00.652Z
2024-04-22,7:30 AM,1,1,1,0,0,3,2024-04-22T12:51:04.903Z
2024-04-22,8:30 AM,2,1,2,0,0,5,2024-04-22T13:32:26.211Z
2024-04-22,9:30 AM,1,3,3,0,0,7,2024-04-22T14:21:28.609Z
2024-04-22,10:30 AM,5,4,12,4,0,25,2024-04-22T15:32:34.961Z
2024-04-22,11:30 AM,8,1,6,7,0,22,2024-04-22T16:31:49.846Z
2024-04-22,1:30 PM,9,2,11,9,0,31,2024-04-22T18:36:00.106Z
2024-04-22,2:30 PM,5,2,6,7,5,25,2024-04-22T19:37:29.798Z
2024-04-22,3:30 PM,5,3,12,5,10,35,2024-04-22T20:42:42.676Z
2024-04-22,4:30 PM,5,5,8,4,11,33,2024-04-22T21:33:00.614Z
2024-04-22,5:30 PM,6,3,9,2,0,20,2024-04-22T22:36:09.674Z
2024-04-22,6:30 PM,1,2,2,2,0,7,2024-04-22T23:35:22.953Z
2024-04-22,7:30 PM,4,1,0,1,2,8,2024-04-23T00:35:10.399Z
2024-04-22,8:30 PM,2,0,0,0,0,2,2024-04-23T01:46:15.135Z
2024-04-23,7:30 AM,1,1,0,0,0,2,2024-04-23T12:34:27.882Z
2024-04-23,8:30 AM,1,1,1,0,0,3,2024-04-23T13:32:19.425Z
2024-04-23,9:30 AM,4,2,4,2,0,12,2024-04-23T14:33:05.723Z
2024-04-23,10:30 AM,14,2,10,2,0,28,2024-04-23T15:36:19.288Z
2024-04-23,11:30 AM,10,4,7,2,5,28,2024-04-23T16:29:52.240Z
2024-04-23,12:30 PM,9,4,14,9,3,39,2024-04-23T17:44:37.114Z
2024-04-23,1:30 PM,7,5,10,6,2,30,2024-04-23T18:45:44.081Z
2024-04-23,2:30 PM,7,3,5,5,3,23,2024-04-23T19:38:40.251Z
2024-04-23,3:30 PM,4,3,5,3,0,15,2024-04-23T20:42:26.242Z
2024-04-23,4:30 PM,9,2,8,5,0,24,2024-04-23T21:35:30.077Z
2024-04-23,5:30 PM,10,2,5,3,0,20,2024-04-23T22:34:51.971Z
2024-04-23,6:30 PM,4,1,3,2,0,10,2024-04-23T23:33:27.859Z
2024-04-23,7:30 PM,1,1,2,0,0,4,2024-04-24T00:44:32.212Z
2024-04-23,8:30 PM,0,1,1,0,0,2,2024-04-24T01:34:33.350Z
2024-04-24,7:30 AM,1,0,1,0,0,2,2024-04-24T12:42:15.252Z
2024-04-24,8:30 AM,0,2,4,0,0,6,2024-04-24T13:59:33.334Z
2024-04-24,9:30 AM,4,2,4,1,0,11,2024-04-24T14:37:58.580Z
2024-04-24,10:30 AM,8,10,8,5,0,31,2024-04-24T15:32:38.176Z
2024-04-24,11:30 AM,7,6,12,2,1,28,2024-04-24T16:41:11.955Z
2024-04-24,12:30 PM,15,6,21,5,2,49,2024-04-24T17:44:45.559Z
2024-04-24,1:30 PM,11,5,7,8,0,31,2024-04-24T18:35:56.835Z
2024-04-24,2:30 PM,7,4,12,5,0,28,2024-04-24T19:39:05.498Z
2024-04-24,3:30 PM,3,2,13,6,0,24,2024-04-24T21:34:48.196Z
2024-04-24,4:30 PM,5,3,6,6,3,23,2024-04-24T21:37:11.041Z
2024-04-24,5:30 PM,9,0,3,2,3,17,2024-04-24T23:29:03.885Z
2024-04-24,6:30 PM,5,1,4,1,0,11,2024-04-24T23:33:06.192Z
2024-04-24,7:30 PM,3,1,4,0,1,9,2024-04-25T01:01:00.845Z
2024-04-25,7:30 AM,2,0,0,0,1,3,2024-04-25T12:39:43.901Z
2024-04-25,8:30 AM,0,1,1,0,0,2,2024-04-25T13:33:23.594Z
2024-04-25,9:30 AM,2,2,4,0,1,9,2024-04-25T14:42:03.808Z
2024-04-25,10:30 AM,7,4,4,0,3,18,2024-04-25T15:30:03.349Z
2024-04-25,11:30 AM,6,1,7,1,0,15,2024-04-25T16:40:02.546Z
2024-04-25,12:30 PM,9,5,20,6,6,46,2024-04-25T17:34:18.692Z
2024-04-25,1:30 PM,3,7,11,3,2,26,2024-04-25T18:32:27.006Z
2024-04-25,2:30 PM,7,3,8,2,0,20,2024-04-25T19:38:34.079Z
2024-04-25,3:30 PM,6,0,6,4,0,16,2024-04-25T20:38:12.541Z
2024-04-25,4:30 PM,9,3,4,3,1,20,2024-04-25T21:32:14.941Z
2024-04-25,5:30 PM,3,2,6,7,0,18,2024-04-25T22:35:04.578Z
2024-04-25,6:30 PM,7,2,5,0,1,15,2024-04-25T23:35:45.946Z
2024-04-25,7:30 PM,1,1,2,0,11,15,2024-04-26T00:46:18.027Z
2024-04-25,8:30 PM,1,0,0,0,9,10,2024-04-26T01:35:58.453Z
2024-04-26,7:30 AM,1,0,0,0,0,1,2024-04-26T12:56:27.539Z
2024-04-26,8:30 AM,1,0,0,1,1,3,2024-04-26T13:32:08.020Z
2024-04-26,12:30 PM,6,2,3,1,0,12,2024-04-26T17:50:47.342Z
2024-04-26,1:30 PM,5,2,4,0,0,11,2024-04-26T18:38:11.640Z
2024-04-26,2:30 PM,4,3,4,0,0,11,2024-04-26T19:36:21.762Z
2024-04-26,3:30 PM,4,2,4,0,0,10,2024-04-26T20:35:49.947Z
2024-04-26,4:30 PM,10,2,3,0,1,16,2024-04-26T21:42:12.591Z
2024-04-26,5:30 PM,3,2,2,1,0,8,2024-04-26T22:41:33.800Z
2024-04-26,6:30 PM,6,2,4,1,0,13,2024-04-26T23:34:30.020Z
2024-04-27,10:30 AM,1,0,2,1,4,8,2024-04-27T15:35:42.826Z
2024-04-27,11:30 AM,3,1,1,2,3,10,2024-04-27T16:39:38.850Z
2024-04-27,12:30 PM,3,2,2,2,4,13,2024-04-27T17:40:56.233Z
2024-04-27,1:30 PM,4,1,4,2,0,11,2024-04-27T18:45:36.940Z
2024-04-27,2:30 PM,5,0,3,2,0,10,2024-04-27T19:38:00.936Z
2024-04-27,3:30 PM,6,0,2,2,0,10,2024-04-27T20:32:15.231Z
2024-04-27,4:30 PM,6,0,0,2,0,8,2024-04-27T21:39:03.492Z
2024-04-27,5:30 PM,5,0,0,0,0,5,2024-04-27T22:26:03.747Z
2024-04-29,8:30 AM,1,1,2,0,0,4,2024-04-29T13:34:39.619Z
2024-04-29,9:30 AM,2,6,5,0,0,13,2024-04-29T14:27:40.306Z
2024-04-29,7:30 AM,0,1,1,0,0,2,2024-04-29T14:28:18.959Z
2024-04-29,10:30 AM,5,9,10,1,0,25,2024-04-29T15:29:33.411Z
2024-04-29,11:30 AM,12,8,17,2,1,40,2024-04-29T16:35:05.798Z
2024-04-29,12:30 PM,13,7,18,8,2,48,2024-04-29T17:46:59.974Z
2024-04-29,1:30 PM,9,4,16,2,3,34,2024-04-29T18:35:41.432Z
2024-04-29,2:30 PM,9,8,7,4,6,34,2024-04-29T19:30:48.525Z
2024-04-29,3:30 PM,6,5,10,6,1,28,2024-04-29T20:48:22.784Z
2024-04-29,4:30 PM,5,4,6,6,0,21,2024-04-29T21:34:06.301Z
2024-04-29,5:30 PM,8,3,9,4,0,24,2024-04-29T22:39:44.240Z
2024-04-29,6:30 PM,5,1,6,0,0,12,2024-04-29T23:43:13.983Z
2024-04-29,7:30 PM,4,3,3,1,0,11,2024-04-30T00:35:06.212Z
2024-04-29,8:30 PM,3,1,2,1,1,8,2024-04-30T01:26:07.168Z
2024-04-30,7:30 AM,3,0,0,0,0,3,2024-04-30T12:44:09.445Z
2024-04-30,8:30 AM,1,1,0,0,0,2,2024-04-30T13:45:02.332Z
2024-04-30,9:30 AM,2,2,2,1,0,7,2024-04-30T14:33:31.259Z
2024-04-30,10:30 AM,4,3,4,3,0,14,2024-04-30T15:32:59.554Z
2024-04-30,11:30 AM,7,3,7,3,1,21,2024-04-30T16:38:05.156Z
2024-04-30,12:30 PM,8,3,18,2,3,34,2024-04-30T17:39:23.933Z
2024-04-30,1:30 PM,9,3,16,5,0,33,2024-04-30T18:35:34.758Z
2024-04-30,2:30 PM,10,7,7,6,1,31,2024-04-30T19:36:25.294Z
2024-04-30,3:30 PM,8,2,8,2,1,21,2024-04-30T20:37:50.715Z
2024-04-30,4:30 PM,7,3,4,4,2,20,2024-04-30T22:09:58.053Z
2024-04-30,5:30 PM,7,4,2,3,3,19,2024-04-30T22:34:42.640Z
2024-04-30,6:30 PM,3,1,4,2,0,10,2024-04-30T23:39:32.398Z
2024-04-30,7:30 PM,2,1,4,1,4,12,2024-05-01T00:58:25.939Z
2024-05-01,7:30 AM,0,0,1,0,0,1,2024-05-01T12:32:30.273Z
2024-05-01,8:30 AM,4,0,1,0,0,5,2024-05-01T13:33:31.345Z
2024-05-01,9:30 AM,7,1,6,3,0,17,2024-05-01T14:32:17.871Z
2024-05-01,10:30 AM,4,4,8,4,0,20,2024-05-01T15:32:18.646Z
2024-05-01,11:30 AM,17,9,21,5,2,54,2024-05-01T16:49:47.000Z
2024-05-01,12:30 PM,13,6,22,1,1,43,2024-05-01T19:00:46.887Z
2024-05-01,2:30 PM,10,4,11,1,7,33,2024-05-01T19:35:52.108Z
2024-05-01,3:30 PM,13,3,9,1,8,34,2024-05-01T20:34:40.952Z
2024-05-01,4:30 PM,8,4,8,4,5,29,2024-05-01T21:27:12.819Z
2024-05-01,5:30 PM,6,3,7,2,0,18,2024-05-01T22:33:22.709Z
2024-05-01,6:30 PM,1,2,4,6,0,13,2024-05-01T23:36:53.979Z
2024-05-01,7:30 PM,0,2,2,5,0,9,2024-05-02T00:37:25.340Z
2024-05-01,8:30 PM,1,1,0,1,0,3,2024-05-02T01:32:22.438Z
2024-05-02,7:30 AM,1,1,2,0,0,4,2024-05-02T12:53:12.886Z
2024-05-02,8:30 AM,1,1,2,0,0,4,2024-05-02T13:34:42.489Z
2024-05-02,9:30 AM,2,1,3,3,0,9,2024-05-02T14:28:32.572Z
2024-05-02,10:30 AM,7,5,9,2,2,25,2024-05-02T15:31:25.058Z
2024-05-02,11:30 AM,6,6,13,6,0,31,2024-05-02T16:43:12.600Z
2024-05-02,12:30 PM,5,3,19,4,4,35,2024-05-02T17:35:39.459Z
2024-05-02,1:30 PM,10,2,11,5,1,29,2024-05-02T18:42:53.636Z
2024-05-02,2:30 PM,9,3,6,5,1,24,2024-05-02T19:39:52.746Z
2024-05-02,3:30 PM,7,2,5,9,1,24,2024-05-02T20:36:41.218Z
2024-05-02,4:30 PM,3,3,9,5,0,20,2024-05-02T21:35:44.498Z
2024-05-02,5:30 PM,8,5,9,2,1,25,2024-05-02T22:43:26.470Z
2024-05-02,6:30 PM,5,3,8,1,1,18,2024-05-02T23:30:50.883Z
2024-05-02,7:30 PM,4,1,3,1,5,14,2024-05-03T01:35:45.127Z
2024-05-02,8:30 PM,3,0,2,0,10,15,2024-05-03T01:36:17.686Z
2024-05-03,7:30 AM,0,1,0,0,0,1,2024-05-03T12:31:27.119Z
2024-05-03,8:30 AM,1,1,0,0,0,2,2024-05-03T13:40:13.163Z
2024-05-03,9:30 AM,1,1,0,0,0,2,2024-05-03T14:27:23.443Z
2024-05-03,10:30 AM,3,0,1,0,0,4,2024-05-03T15:47:50.232Z
2024-05-03,11:30 AM,4,1,1,3,6,15,2024-05-03T16:45:16.076Z
2024-05-03,12:30 PM,6,2,1,3,8,20,2024-05-03T17:41:21.385Z
2024-05-03,1:30 PM,9,2,2,5,6,24,2024-05-03T18:44:27.883Z
2024-05-03,2:30 PM,6,2,3,4,0,15,2024-05-03T19:29:28.266Z
2024-05-03,3:30 PM,7,3,4,2,1,17,2024-05-03T20:39:17.646Z
2024-05-03,4:30 PM,6,0,4,0,1,11,2024-05-03T21:35:38.969Z
2024-05-03,5:30 PM,3,1,3,1,0,8,2024-05-03T22:45:49.276Z
2024-05-03,6:30 PM,4,1,2,0,0,7,2024-05-03T23:33:47.157Z
2024-05-04,10:30 AM,5,2,4,0,7,18,2024-05-04T15:38:22.286Z
2024-05-04,11:30 AM,4,1,4,2,7,18,2024-05-04T16:47:00.575Z
2024-05-04,12:30 PM,4,0,2,4,3,13,2024-05-04T17:37:14.106Z
2024-05-04,1:30 PM,6,0,4,0,0,10,2024-05-04T18:47:22.623Z
2024-05-04,2:30 PM,5,2,5,0,0,12,2024-05-04T19:35:11.586Z
2024-05-04,3:30 PM,7,1,6,0,0,14,2024-05-04T20:31:23.957Z
2024-05-04,4:30 PM,3,1,5,1,0,10,2024-05-04T21:34:44.314Z
2024-05-04,5:30 PM,0,1,1,0,0,2,2024-05-04T22:22:14.426Z
2024-05-06,7:30 AM,2,1,0,0,0,3,2024-05-06T12:56:18.261Z
2024-05-06,8:30 AM,1,2,1,0,0,4,2024-05-06T13:33:28.205Z
2024-05-06,9:30 AM,5,6,6,0,0,17,2024-05-06T14:29:57.233Z
2024-05-06,10:30 AM,5,4,8,0,0,17,2024-05-06T15:32:17.926Z
2024-05-06,11:30 AM,10,2,10,2,6,30,2024-05-06T16:36:55.731Z
2024-05-06,12:30 PM,11,4,15,3,6,39,2024-05-06T17:34:40.364Z
2024-05-06,1:30 PM,7,1,15,1,6,30,2024-05-06T18:36:41.218Z
2024-05-06,2:30 PM,7,3,4,3,8,25,2024-05-06T19:39:04.330Z
2024-05-06,3:30 PM,7,4,15,4,4,34,2024-05-06T20:32:36.530Z
2024-05-06,4:30 PM,7,2,9,3,8,29,2024-05-06T21:39:39.179Z
2024-05-06,5:30 PM,10,2,7,2,1,22,2024-05-06T22:38:53.608Z
2024-05-06,6:30 PM,6,2,2,0,1,11,2024-05-06T23:33:25.354Z
2024-05-06,7:30 PM,3,1,5,2,0,11,2024-05-07T00:33:07.959Z
2024-05-06,8:30 PM,1,1,0,0,0,2,2024-05-07T01:31:01.589Z
2024-05-07,7:30 AM,1,0,0,0,0,1,2024-05-07T12:58:16.628Z
2024-05-07,8:30 AM,0,0,0,0,0,0,2024-05-07T13:27:07.353Z
2024-05-07,9:30 AM,1,1,3,1,0,6,2024-05-07T14:29:34.168Z
2024-05-07,10:30 AM,0,0,4,0,0,4,2024-05-07T15:34:39.040Z
2024-05-07,11:30 AM,3,5,15,3,4,30,2024-05-07T16:33:48.842Z
2024-05-07,12:30 PM,9,6,15,9,3,42,2024-05-07T17:49:38.468Z
2024-05-07,1:30 PM,9,4,13,4,2,32,2024-05-07T18:51:15.641Z
2024-05-07,2:30 PM,10,2,6,2,1,21,2024-05-07T19:52:22.418Z
2024-05-07,4:30 PM,4,2,8,1,3,18,2024-05-07T21:37:13.316Z
2024-05-07,5:30 PM,5,2,6,2,0,15,2024-05-07T22:33:26.387Z
2024-05-07,6:30 PM,4,2,6,0,1,13,2024-05-07T23:41:12.667Z
2024-05-07,7:30 PM,4,2,3,0,0,9,2024-05-08T00:32:40.762Z
2024-05-07,8:30 PM,2,1,4,0,0,7,2024-05-08T01:29:38.770Z
2024-05-08,7:30 AM,0,0,1,0,0,1,2024-05-08T13:46:12.216Z
2024-05-08,8:30 AM,2,3,5,0,2,12,2024-05-08T13:46:40.976Z
2024-05-08,9:30 AM,3,3,5,1,2,14,2024-05-08T14:34:17.930Z
2024-05-08,10:30 AM,8,5,16,2,1,32,2024-05-08T15:34:10.134Z
2024-05-08,11:30 AM,7,3,12,4,1,27,2024-05-08T16:32:41.069Z
2024-05-08,1:30 PM,4,3,6,1,5,19,2024-05-08T18:31:09.954Z
2024-05-08,2:30 PM,4,9,2,1,5,21,2024-05-08T19:55:56.314Z
2024-05-08,3:30 PM,6,1,9,5,3,24,2024-05-08T20:33:48.119Z
2024-05-08,4:30 PM,4,3,9,7,0,23,2024-05-08T21:45:42.007Z
2024-05-08,5:30 PM,9,2,6,3,0,20,2024-05-08T22:43:42.162Z
2024-05-08,6:30 PM,4,1,3,2,0,10,2024-05-08T23:47:34.086Z
2024-05-08,7:30 PM,3,1,2,0,0,6,2024-05-09T00:38:58.716Z
2024-05-08,8:30 PM,5,0,1,0,0,6,2024-05-09T01:33:29.089Z
2024-05-09,7:30 AM,3,0,0,0,0,3,2024-05-09T12:39:40.721Z
2024-05-09,10:30 AM,11,3,11,4,1,30,2024-05-09T15:32:54.184Z
2024-05-09,11:30 AM,7,1,8,2,0,18,2024-05-09T16:43:45.894Z
2024-05-09,12:30 PM,11,2,10,2,3,28,2024-05-09T17:37:02.964Z
2024-05-09,1:30 PM,2,3,7,1,1,14,2024-05-09T18:32:32.638Z
2024-05-09,2:30 PM,0,5,10,1,0,16,2024-05-09T19:39:23.010Z
2024-05-09,3:30 PM,3,3,10,0,0,16,2024-05-09T20:39:24.446Z
2024-05-09,4:30 PM,3,2,6,2,0,13,2024-05-09T21:33:48.670Z
2024-05-09,6:30 PM,2,1,2,0,0,5,2024-05-09T23:42:53.818Z
2024-05-09,7:30 PM,1,1,0,0,9,11,2024-05-10T00:38:22.704Z
2024-05-09,8:30 PM,2,0,0,1,7,10,2024-05-10T01:35:27.858Z
2024-05-10,7:30 AM,1,0,0,0,0,1,2024-05-10T12:56:38.586Z
2024-05-10,8:30 AM,4,0,3,0,0,7,2024-05-10T14:03:00.727Z
2024-05-10,11:30 AM,3,2,3,0,0,8,2024-05-10T16:41:46.919Z
2024-05-10,1:30 PM,3,0,6,0,0,9,2024-05-10T18:34:19.317Z
2024-05-10,2:30 PM,2,2,3,0,0,7,2024-05-10T19:32:12.993Z
2024-05-10,4:30 PM,1,1,1,0,0,3,2024-05-10T21:42:30.167Z
2024-05-10,5:30 PM,0,0,1,0,0,1,2024-05-10T22:37:37.419Z
2024-05-10,6:30 PM,0,0,0,0,0,0,2024-05-10T23:42:06.496Z
2024-05-11,10:30 AM,2,0,2,0,0,4,2024-05-11T15:37:30.811Z
2024-05-11,11:30 AM,0,0,2,0,0,2,2024-05-11T16:57:30.268Z
2024-05-11,11:30 PM,2,0,2,0,0,4,2024-05-11T17:01:27.412Z
2024-05-11,12:30 PM,6,0,3,0,0,9,2024-05-11T17:21:31.298Z
2024-05-11,1:30 PM,6,0,2,0,1,9,2024-05-11T18:40:23.430Z
2024-05-11,2:30 PM,1,0,2,0,0,3,2024-05-11T19:33:52.268Z
2024-05-11,3:30 PM,2,0,2,0,0,4,2024-05-11T20:33:24.460Z
2024-05-11,4:30 PM,2,0,2,0,0,4,2024-05-11T21:36:06.654Z
2024-05-11,5:30 PM,2,0,0,0,0,2,2024-05-11T22:20:21.920Z
2024-05-13,8:30 AM,1,0,0,0,0,1,2024-05-13T13:01:39.487Z
2024-05-13,8:30 AM,1,0,0,0,0,1,2024-05-13T13:38:47.756Z
2024-05-13,9:30 AM,1,1,0,0,0,2,2024-05-13T14:30:57.440Z
2024-05-13,10:30 AM,1,2,0,0,0,3,2024-05-13T15:29:45.010Z
2024-05-13,11:30 AM,3,0,2,0,0,5,2024-05-13T16:33:10.731Z
2024-05-13,12:30 PM,1,0,4,0,0,5,2024-05-13T17:29:47.483Z
2024-05-13,1:30 PM,2,0,2,0,1,5,2024-05-13T18:31:23.700Z
2024-05-13,2:30 PM,1,0,1,1,0,3,2024-05-13T19:51:57.925Z
2024-05-13,3:30 PM,1,1,3,0,1,6,2024-05-13T20:34:16.010Z
2024-05-13,4:30 PM,0,0,0,0,0,0,2024-05-13T21:37:46.681Z
2024-05-13,5:30 PM,0,0,0,0,0,0,2024-05-13T22:42:30.192Z
2024-05-14,7:30 AM,0,0,1,0,0,1,2024-05-14T12:56:06.273Z
2024-05-14,8:30 AM,1,0,0,0,0,1,2024-05-14T13:31:56.294Z
2024-05-14,9:30 AM,0,0,0,0,0,0,2024-05-14T14:39:41.412Z
2024-05-14,10:30 AM,1,2,0,0,0,3,2024-05-14T15:31:41.642Z
2024-05-14,11:30 AM,0,0,2,0,0,2,2024-05-14T16:33:47.038Z
2024-05-14,12:30 PM,1,1,3,0,1,6,2024-05-14T17:32:10.710Z
2024-05-14,1:30 PM,0,0,4,0,0,4,2024-05-14T18:39:08.770Z
2024-05-14,2:30 PM,0,0,3,0,0,3,2024-05-14T19:40:13.728Z
2024-05-14,4:30 PM,0,0,1,1,0,2,2024-05-14T21:53:47.901Z
2024-05-15,7:30 AM,0,0,0,0,0,0,2024-05-15T12:39:59.537Z
2024-05-15,8:30 AM,0,1,0,0,0,1,2024-05-15T13:29:45.236Z
2024-05-15,9:30 AM,0,1,0,1,0,2,2024-05-15T14:32:28.447Z
2024-05-15,10:30 AM,1,2,0,1,0,4,2024-05-15T15:27:21.919Z
2024-05-15,11:30 AM,1,0,0,1,0,2,2024-05-15T16:36:06.226Z
2024-05-15,12:30 PM,1,1,1,0,0,3,2024-05-15T17:41:42.029Z
2024-05-15,1:30 PM,0,1,1,0,0,2,2024-05-15T18:34:04.007Z
2024-05-15,2:30 PM,0,0,0,0,0,0,2024-05-15T19:27:09.645Z
2024-05-15,3:30 PM,4,0,0,0,1,5,2024-05-15T20:40:37.226Z
2024-05-15,4:30 PM,2,0,0,0,0,2,2024-05-15T21:42:42.024Z
2024-05-16,7:30 AM,0,0,0,0,0,0,2024-05-16T12:56:59.310Z
2024-05-16,8:30 AM,0,0,0,0,0,0,2024-05-16T13:51:07.295Z
2024-05-16,9:30 AM,0,0,0,1,0,1,2024-05-16T14:54:09.077Z
2024-05-16,10:30 AM,0,0,1,0,0,1,2024-05-16T15:30:36.928Z
2024-05-16,11:30 AM,1,1,1,0,0,3,2024-05-16T16:45:20.300Z
2024-05-16,12:30 PM,0,1,1,0,0,2,2024-05-16T17:26:53.567Z
2024-05-16,2:30 PM,0,1,1,0,1,3,2024-05-16T19:38:10.334Z
2024-05-16,3:30 PM,1,1,0,0,0,2,2024-05-16T20:34:09.584Z
2024-05-16,4:30 PM,2,0,1,0,0,3,2024-05-16T21:43:48.561Z
2024-05-17,8:30 AM,0,1,0,1,0,2,2024-05-17T13:02:31.514Z
2024-05-17,8:30 AM,0,1,0,1,0,2,2024-05-17T13:30:36.101Z
2024-05-17,9:30 AM,0,2,1,1,0,4,2024-05-17T14:31:39.128Z
2024-05-17,10:30 AM,1,3,3,2,0,9,2024-05-17T15:32:10.636Z
2024-05-17,11:30 AM,1,1,1,0,0,3,2024-05-17T16:47:41.874Z
2024-05-17,12:30 PM,0,0,2,0,0,2,2024-05-17T17:37:01.200Z
2024-05-17,1:30 PM,1,0,1,0,2,4,2024-05-17T18:35:45.256Z
2024-05-17,2:30 PM,2,1,0,0,0,3,2024-05-17T19:33:33.798Z
2024-05-17,3:30 PM,2,0,1,0,0,3,2024-05-17T20:31:27.846Z
2024-05-17,4:30 PM,2,0,0,0,1,3,2024-05-17T21:37:29.706Z
2024-05-17,5:30 PM,2,0,0,0,0,2,2024-05-17T22:41:47.869Z
2024-05-17,7:30 AM,0,0,0,0,0,0,2024-05-21T12:47:30.200Z
2024-05-17,8:30 AM,0,0,1,0,0,1,2024-05-21T13:31:15.553Z
2024-05-17,9:30 AM,3,0,0,1,0,4,2024-05-21T14:28:06.665Z
2024-05-17,10:30 AM,1,0,0,1,0,2,2024-05-21T15:37:28.407Z
2024-05-20,7:30 AM,1,0,0,1,0,2,2024-05-20T12:53:46.070Z
2024-05-20,8:30 AM,1,0,0,1,0,2,2024-05-20T13:42:26.971Z
2024-05-20,9:30 AM,1,0,0,2,0,3,2024-05-20T14:32:07.767Z
2024-05-20,10:30 AM,1,0,0,2,0,3,2024-05-20T15:37:11.164Z
2024-05-20,11:30 AM,2,0,1,0,0,3,2024-05-20T16:33:02.356Z
2024-05-20,12:30 PM,1,1,1,0,0,3,2024-05-20T17:28:16.457Z
2024-05-20,1:30 PM,0,1,4,0,0,5,2024-05-20T18:41:45.430Z
2024-05-20,2:30 PM,0,0,3,0,0,3,2024-05-20T19:37:09.918Z
2024-05-20,4:30 PM,0,1,3,0,0,4,2024-05-20T21:44:43.291Z
2024-05-20,5:30 PM,3,0,0,0,0,3,2024-05-20T22:27:47.277Z
2024-05-20,5:30 PM,2,0,0,0,0,2,2024-05-20T22:43:43.587Z
2024-05-21,11:30 AM,1,0,1,0,0,2,2024-05-21T16:38:19.506Z
2024-05-21,12:30 PM,2,0,1,0,0,3,2024-05-21T17:40:42.741Z
2024-05-21,1:30 PM,3,0,3,0,0,6,2024-05-21T18:41:12.653Z
2024-05-21,2:30 PM,3,0,4,0,0,7,2024-05-21T19:38:03.205Z
2024-05-21,3:30 PM,4,1,4,0,0,9,2024-05-21T20:34:19.039Z
2024-05-21,4:30 PM,2,0,4,0,0,6,2024-05-21T21:33:19.092Z
2024-05-22,7:30 AM,0,0,0,0,0,0,2024-05-22T12:37:12.089Z
2024-05-22,8:30 AM,0,0,0,0,0,0,2024-05-22T13:29:31.716Z
2024-05-22,9:30 AM,0,0,2,2,0,4,2024-05-22T14:32:56.261Z
2024-05-22,10:30 AM,0,0,1,1,0,2,2024-05-22T15:28:30.951Z
2024-05-22,11:30 AM,0,0,3,0,0,3,2024-05-22T16:34:34.509Z
2024-05-22,12:30 PM,2,0,1,0,0,3,2024-05-22T17:33:42.951Z
2024-05-22,1:30 PM,0,1,2,0,0,3,2024-05-22T18:34:20.993Z
2024-05-22,2:30 PM,0,2,3,0,0,5,2024-05-22T19:37:40.899Z
2024-05-22,3:30 PM,1,3,3,0,3,10,2024-05-22T20:36:07.163Z
2024-05-22,4:30 PM,1,1,2,0,8,12,2024-05-22T21:43:38.760Z
2024-05-22,5:30 PM,0,1,2,0,0,3,2024-05-22T22:36:00.932Z
2024-05-23,8:30 AM,0,0,0,1,0,1,2024-05-23T13:49:52.281Z
2024-05-23,9:30 AM,0,0,0,1,0,1,2024-05-23T14:29:05.231Z
2024-05-23,7:30 AM,0,0,0,0,0,0,2024-05-23T14:29:20.326Z
2024-05-23,10:30 AM,0,0,1,0,0,1,2024-05-23T15:31:40.724Z
2024-05-23,11:30 AM,2,1,1,0,0,4,2024-05-23T16:37:19.385Z
2024-05-23,12:30 PM,3,1,1,0,0,5,2024-05-23T17:36:04.932Z
2024-05-23,1:30 PM,2,0,1,0,0,3,2024-05-23T18:36:35.730Z
2024-05-23,2:30 PM,2,0,2,0,0,4,2024-05-23T19:33:32.687Z
2024-05-23,3:30 PM,1,0,2,0,1,4,2024-05-23T20:39:00.431Z
2024-05-23,4:30 PM,4,0,2,0,0,6,2024-05-23T21:34:53.965Z
2024-05-23,5:30 PM,3,0,1,0,0,4,2024-05-23T22:35:38.892Z
2024-05-24,8:30 AM,0,1,0,0,0,1,2024-05-24T13:02:22.733Z
2024-05-24,7:30 AM,0,1,0,0,0,1,2024-05-24T13:31:27.086Z
2024-05-24,9:30 AM,0,1,1,0,0,2,2024-05-24T14:35:37.618Z
2024-05-24,10:30 AM,0,1,0,0,0,1,2024-05-24T15:33:44.507Z
2024-05-24,11:30 AM,1,0,0,0,0,1,2024-05-24T16:34:16.768Z
2024-05-24,12:30 PM,4,0,1,0,0,5,2024-05-24T17:32:34.776Z
2024-05-24,1:30 PM,3,0,1,0,0,4,2024-05-24T18:34:55.007Z
2024-05-24,2:30 PM,3,0,0,0,0,3,2024-05-24T19:35:50.630Z
2024-05-24,3:30 PM,1,1,1,0,0,3,2024-05-24T20:35:16.535Z
2024-05-24,4:30 PM,2,0,1,0,0,3,2024-05-24T21:33:19.012Z
2024-05-24,5:30 PM,2,0,1,0,0,3,2024-05-24T22:31:44.165Z
2024-05-28,7:30 AM,0,0,0,0,0,0,2024-05-28T13:03:04.790Z
2024-05-28,8:30 AM,0,0,0,0,0,0,2024-05-28T13:24:00.194Z
2024-05-28,9:30 AM,0,1,1,2,0,4,2024-05-28T14:32:37.936Z
2024-05-28,10:30 AM,0,1,1,2,1,5,2024-05-28T15:32:37.179Z
2024-05-28,11:30 AM,0,1,0,2,0,3,2024-05-28T16:33:25.608Z
2024-05-28,12:30 PM,1,2,0,2,0,5,2024-05-28T17:29:45.104Z
2024-05-28,1:30 PM,3,0,3,0,0,6,2024-05-28T18:34:16.140Z
2024-05-28,2:30 PM,3,0,1,0,0,4,2024-05-28T19:33:30.501Z
2024-05-28,3:30 PM,1,0,1,0,0,2,2024-05-28T20:51:00.190Z
2024-05-28,4:30 PM,1,0,1,0,0,2,2024-05-28T21:55:30.554Z
2024-05-29,7:30 AM,0,0,0,0,0,0,2024-05-29T12:31:36.436Z
2024-05-29,8:30 AM,0,0,0,0,0,0,2024-05-29T13:31:05.849Z
2024-05-29,9:30 AM,1,0,0,0,0,1,2024-05-29T14:30:26.474Z
2024-05-29,10:30 AM,0,0,1,0,0,1,2024-05-29T15:43:26.084Z
2024-05-29,2:30 PM,0,1,2,0,0,3,2024-05-29T19:43:38.478Z
2024-05-29,3:30 PM,0,0,1,0,0,1,2024-05-29T21:02:51.539Z
2024-05-29,4:30 PM,1,1,1,0,0,3,2024-05-29T21:40:00.759Z
2024-05-30,7:30 AM,0,0,0,1,0,1,2024-05-30T12:40:28.769Z
2024-05-30,8:30 AM,0,0,0,1,0,1,2024-05-30T13:31:41.246Z
2024-05-30,9:30 AM,0,1,0,1,0,2,2024-05-30T14:33:05.004Z
2024-05-30,10:30 AM,0,1,0,1,0,2,2024-05-30T15:34:14.273Z
2024-05-30,11:30 AM,0,0,1,0,0,1,2024-05-30T16:34:28.668Z
2024-05-30,12:30 PM,0,0,1,0,0,1,2024-05-30T17:35:59.121Z
2024-05-30,1:30 PM,0,0,1,2,0,3,2024-05-30T18:35:43.934Z
2024-05-30,2:30 PM,2,0,1,2,0,5,2024-05-30T19:33:13.966Z
2024-05-30,3:30 PM,1,1,2,1,0,5,2024-05-30T20:35:16.773Z
2024-05-30,4:30 PM,0,0,1,0,0,1,2024-05-30T21:37:31.866Z
2024-05-31,7:30 AM,1,0,0,1,0,2,2024-05-31T12:56:22.515Z
2024-05-31,8:30 AM,0,1,0,1,0,2,2024-05-31T13:41:57.800Z
2024-05-31,9:30 AM,1,0,1,2,0,4,2024-05-31T14:37:43.107Z
2024-05-31,10:30 AM,0,1,1,1,0,3,2024-05-31T15:31:42.251Z
2024-05-31,11:30 AM,1,2,5,2,0,10,2024-05-31T16:33:23.277Z
2024-05-31,12:30 PM,4,2,5,0,0,11,2024-05-31T17:36:37.170Z
2024-05-31,1:30 PM,2,2,3,1,0,8,2024-05-31T18:36:28.293Z
2024-05-31,2:30 PM,1,2,3,0,0,6,2024-05-31T19:37:09.242Z
2024-05-31,3:30 PM,1,1,1,0,0,3,2024-05-31T20:37:14.113Z
2024-05-31,4:30 PM,2,0,1,0,0,3,2024-05-31T21:33:30.452Z
2024-06-03,7:30 AM,2,0,0,0,0,2,2024-06-03T12:55:10.186Z
2024-06-03,8:30 AM,2,2,0,0,0,4,2024-06-03T13:29:26.619Z
2024-06-03,9:30 AM,0,2,0,2,0,4,2024-06-03T14:32:59.858Z
2024-06-03,10:30 AM,3,2,0,2,0,7,2024-06-03T15:33:22.476Z
2024-06-03,11:30 AM,1,0,0,2,2,5,2024-06-03T16:37:17.717Z
2024-06-03,12:30 PM,2,0,0,1,0,3,2024-06-03T17:44:37.096Z
2024-06-03,1:30 PM,2,0,2,1,0,5,2024-06-03T18:31:51.029Z
2024-06-03,2:30 PM,0,0,2,0,1,3,2024-06-03T19:36:33.460Z
2024-06-03,3:30 PM,0,0,1,1,0,2,2024-06-03T20:32:11.805Z
2024-06-03,4:30 PM,2,3,0,0,0,5,2024-06-03T21:47:32.121Z
2024-06-03,5:30 PM,3,0,2,0,1,6,2024-06-03T22:35:40.210Z
2024-06-04,7:30 AM,0,0,0,1,0,1,2024-06-04T12:56:50.459Z
2024-06-04,8:30 AM,0,0,0,1,0,1,2024-06-04T13:43:41.446Z
2024-06-04,10:30 AM,0,0,1,2,0,3,2024-06-04T15:39:26.617Z
2024-06-04,9:30 AM,0,0,0,1,0,1,2024-06-04T16:00:25.263Z
2024-06-04,11:30 AM,1,0,3,2,0,6,2024-06-04T16:37:34.588Z
2024-06-04,12:30 PM,3,0,6,0,0,9,2024-06-04T17:34:32.240Z
2024-06-04,2:30 PM,1,2,5,1,0,9,2024-06-04T19:44:39.628Z
2024-06-04,3:30 PM,0,1,1,1,0,3,2024-06-04T20:29:25.498Z
2024-06-04,5:30 PM,1,0,0,1,1,3,2024-06-04T22:37:34.698Z
2024-06-05,7:30 AM,0,0,0,0,0,0,2024-06-05T13:00:43.147Z
2024-06-05,8:30 AM,0,0,0,1,0,1,2024-06-05T13:38:56.800Z
2024-06-05,9:30 AM,1,0,0,3,0,4,2024-06-05T14:41:03.896Z
2024-06-05,10:30 AM,0,0,0,4,0,4,2024-06-05T15:41:37.761Z
2024-06-05,11:30 AM,3,1,3,4,0,11,2024-06-05T16:36:27.817Z
2024-06-05,12:30 PM,0,1,5,2,0,8,2024-06-05T17:46:45.923Z
2024-06-05,1:30 PM,2,1,4,1,0,8,2024-06-05T18:39:15.952Z
2024-06-05,2:30 PM,5,2,5,1,0,13,2024-06-05T19:38:20.402Z
2024-06-05,3:30 PM,4,1,4,1,0,10,2024-06-05T20:36:20.002Z
2024-06-05,4:30 PM,3,0,1,0,3,7,2024-06-05T21:37:18.920Z
2024-06-05,5:30 PM,3,0,1,0,3,7,2024-06-05T22:35:09.462Z
2024-06-06,7:30 AM,0,0,0,0,0,0,2024-06-06T12:45:28.976Z
2024-06-06,8:30 AM,1,0,0,1,0,2,2024-06-06T13:43:43.490Z
2024-06-06,9:30 AM,0,0,0,2,0,2,2024-06-06T14:32:16.602Z
2024-06-06,10:30 AM,0,0,0,2,0,2,2024-06-06T15:35:33.675Z
2024-06-06,11:30 AM,0,0,0,2,0,2,2024-06-06T16:32:34.792Z
2024-06-06,12:30 PM,1,0,2,2,0,5,2024-06-06T17:32:02.507Z
2024-06-06,1:30 PM,1,0,5,2,0,8,2024-06-06T18:34:59.755Z
2024-06-06,2:30 PM,2,0,3,0,0,5,2024-06-06T19:33:01.551Z
2024-06-06,4:30 PM,4,0,2,0,0,6,2024-06-06T21:42:54.910Z
2024-06-06,5:30 PM,2,0,1,0,0,3,2024-06-06T22:36:30.746Z
2024-06-07,7:30 AM,1,0,0,1,0,2,2024-06-07T12:37:41.282Z
2024-06-07,8:30 AM,2,0,0,2,0,4,2024-06-07T13:36:09.721Z
2024-06-07,9:30 AM,1,0,0,1,0,2,2024-06-07T14:30:57.636Z
2024-06-07,10:30 AM,1,0,3,2,0,6,2024-06-07T15:31:15.822Z
2024-06-07,11:30 AM,2,0,1,3,0,6,2024-06-07T16:30:14.172Z
2024-06-07,12:30 PM,1,0,2,2,1,6,2024-06-07T17:35:43.509Z
2024-06-07,1:30 PM,1,0,2,1,0,4,2024-06-07T18:36:44.227Z
2024-06-07,2:30 PM,2,1,3,0,0,6,2024-06-07T19:54:37.878Z
2024-06-07,3:30 PM,2,0,3,0,0,5,2024-06-07T20:41:16.532Z
2024-06-07,4:30 PM,2,0,2,0,0,4,2024-06-07T21:38:11.703Z
2024-06-07,5:30 PM,1,0,0,0,0,1,2024-06-07T22:44:12.868Z
2024-06-10,7:30 AM,1,0,0,0,0,1,2024-06-10T12:36:55.850Z
2024-06-10,8:30 AM,3,1,1,0,1,6,2024-06-10T13:31:24.271Z
2024-06-10,9:30 AM,4,2,1,2,0,9,2024-06-10T14:32:05.175Z
2024-06-10,10:30 AM,5,3,5,4,0,17,2024-06-10T15:40:13.298Z
2024-06-10,11:30 AM,7,1,3,3,3,17,2024-06-10T16:34:01.551Z
2024-06-10,12:30 PM,11,1,7,3,2,24,2024-06-10T17:35:51.189Z
2024-06-10,1:30 PM,5,2,5,0,1,13,2024-06-10T18:41:39.171Z
2024-06-10,2:30 PM,5,0,5,2,2,14,2024-06-10T19:33:19.189Z
2024-06-10,4:30 PM,7,2,3,2,2,16,2024-06-10T21:29:49.655Z
2024-06-10,5:30 PM,3,3,1,0,0,7,2024-06-10T22:29:45.689Z
2024-06-10,6:30 PM,1,1,2,0,0,4,2024-06-10T23:31:20.156Z
2024-06-10,7:30 PM,2,1,2,0,0,5,2024-06-11T00:31:17.054Z
2024-06-10,8:30 PM,0,0,1,0,0,1,2024-06-11T01:37:22.748Z
2024-06-11,7:30 AM,0,0,0,0,0,0,2024-06-11T12:43:07.966Z
2024-06-11,8:30 AM,1,1,0,1,1,4,2024-06-11T13:32:39.854Z
2024-06-11,9:30 AM,6,2,0,2,0,10,2024-06-11T14:27:23.693Z
2024-06-11,10:30 AM,2,1,2,2,0,7,2024-06-11T15:29:10.358Z
2024-06-11,11:30 AM,7,1,1,2,0,11,2024-06-11T16:32:49.311Z
2024-06-11,12:30 PM,9,4,3,5,2,23,2024-06-11T17:32:33.110Z
2024-06-11,1:30 PM,5,4,3,2,1,15,2024-06-11T18:41:26.001Z
2024-06-11,2:30 PM,4,2,2,0,0,8,2024-06-11T19:37:49.708Z
2024-06-11,3:30 PM,2,1,4,0,1,8,2024-06-11T20:32:37.402Z
2024-06-11,4:30 PM,3,2,5,1,1,12,2024-06-11T21:32:54.871Z
2024-06-11,5:30 PM,2,1,2,1,1,7,2024-06-11T23:00:42.283Z
2024-06-11,6:30 PM,1,1,2,0,0,4,2024-06-12T00:27:24.900Z
2024-06-11,7:30 PM,0,1,0,0,0,1,2024-06-12T00:34:41.640Z
2024-06-12,7:30 AM,0,0,0,0,0,0,2024-06-12T12:34:58.475Z
2024-06-12,10:30 AM,1,1,1,0,0,3,2024-06-12T15:13:57.218Z
2024-06-12,9:30 AM,2,1,0,0,0,3,2024-06-12T15:14:24.970Z
2024-06-12,11:30 AM,4,3,5,0,1,13,2024-06-12T17:12:23.052Z
2024-06-12,12:30 PM,13,3,3,0,3,22,2024-06-12T17:42:36.661Z
2024-06-12,2:30 PM,4,2,4,0,2,12,2024-06-12T19:43:45.447Z
2024-06-12,3:30 PM,4,4,2,20,1,31,2024-06-12T20:43:04.552Z
2024-06-12,4:30 PM,3,4,2,0,1,10,2024-06-12T21:28:23.736Z
2024-06-12,5:30 PM,3,1,3,0,1,8,2024-06-12T22:33:53.343Z
2024-06-12,6:30 PM,2,1,2,0,0,5,2024-06-12T23:30:56.858Z
2024-06-12,7:30 PM,2,0,2,0,0,4,2024-06-13T00:34:45.819Z
2024-06-12,8:30 PM,0,2,0,0,0,2,2024-06-13T01:26:56.817Z
2024-06-13,7:30 AM,0,0,0,0,0,0,2024-06-13T13:13:44.598Z
2024-06-13,8:30 AM,0,0,0,2,0,2,2024-06-13T13:34:08.281Z
2024-06-13,9:30 AM,0,0,1,2,0,3,2024-06-13T14:38:02.812Z
2024-06-13,10:30 AM,12,1,4,0,1,18,2024-06-13T15:35:28.692Z
2024-06-13,11:30 AM,5,4,3,0,0,12,2024-06-13T16:35:18.348Z
2024-06-13,12:30 PM,5,1,6,1,0,13,2024-06-13T17:52:24.507Z
2024-06-13,1:30 PM,0,1,3,1,0,5,2024-06-13T18:35:56.071Z
2024-06-13,2:30 PM,0,1,4,1,0,6,2024-06-13T19:34:53.418Z
2024-06-13,3:30 PM,4,0,3,1,1,9,2024-06-13T20:51:48.044Z
2024-06-13,4:30 PM,2,1,2,3,1,9,2024-06-13T21:34:33.097Z
2024-06-13,5:30 PM,0,0,1,0,0,1,2024-06-13T22:45:53.460Z
2024-06-13,6:30 PM,0,0,0,0,1,1,2024-06-14T00:30:37.879Z
2024-06-13,7:30 PM,0,0,1,0,1,2,2024-06-14T00:31:03.137Z
2024-06-13,8:30 PM,1,0,0,0,1,2,2024-06-14T01:29:44.347Z
2024-06-14,7:30 AM,2,0,0,0,0,2,2024-06-14T12:41:28.313Z
2024-06-14,8:30 AM,3,0,1,0,0,4,2024-06-14T13:33:11.065Z
2024-06-14,9:30 AM,1,0,2,2,0,5,2024-06-14T14:42:32.888Z
2024-06-14,10:30 AM,1,0,4,2,0,7,2024-06-14T15:28:16.568Z
2024-06-14,11:30 AM,4,0,5,1,0,10,2024-06-14T16:38:22.052Z
2024-06-14,12:30 PM,3,0,4,1,0,8,2024-06-14T17:32:13.703Z
2024-06-14,1:30 PM,4,0,3,1,1,9,2024-06-14T18:49:01.780Z
2024-06-14,2:30 PM,0,0,4,0,0,4,2024-06-14T19:40:00.891Z
2024-06-14,3:30 PM,2,0,3,0,0,5,2024-06-14T20:35:27.709Z
2024-06-14,3:30 PM,2,0,3,0,0,5,2024-06-14T20:35:40.146Z
2024-06-17,7:30 AM,2,0,0,0,0,2,2024-06-17T12:59:04.125Z
2024-06-17,8:30 AM,1,0,0,0,0,1,2024-06-17T13:34:07.808Z
2024-06-17,9:30 AM,4,1,2,0,0,7,2024-06-17T14:30:26.445Z
2024-06-17,10:30 AM,3,0,2,0,0,5,2024-06-17T15:32:28.861Z
2024-06-17,11:30 AM,4,2,5,0,0,11,2024-06-17T16:40:31.308Z
2024-06-17,12:30 PM,12,4,8,1,1,26,2024-06-17T17:33:45.599Z
2024-06-17,1:30 PM,7,3,5,2,1,18,2024-06-17T18:34:26.819Z
2024-06-17,2:30 PM,4,2,3,2,1,12,2024-06-17T19:39:20.512Z
2024-06-17,3:30 PM,9,4,6,1,3,23,2024-06-17T20:41:07.131Z
2024-06-17,4:30 PM,4,2,4,2,1,13,2024-06-17T21:46:21.951Z
2024-06-17,5:30 PM,3,1,0,1,0,5,2024-06-17T22:36:51.007Z
2024-06-17,6:30 PM,2,0,2,1,0,5,2024-06-17T23:55:14.425Z
2024-06-17,7:30 PM,3,0,3,0,0,6,2024-06-18T00:38:12.098Z
2024-06-18,7:30 AM,1,0,0,0,0,1,2024-06-18T13:17:51.705Z
2024-06-18,8:30 AM,1,0,1,0,0,2,2024-06-18T13:35:00.816Z
2024-06-18,9:30 AM,1,1,1,0,0,3,2024-06-18T14:33:28.199Z
2024-06-18,10:30 AM,1,0,2,0,0,3,2024-06-18T15:29:09.647Z
2024-06-18,11:30 AM,7,2,4,2,2,17,2024-06-18T16:29:57.997Z
2024-06-18,12:30 PM,6,4,3,0,1,14,2024-06-18T17:37:37.027Z
2024-06-18,1:30 PM,7,2,6,1,0,16,2024-06-18T18:34:41.801Z
2024-06-18,2:30 PM,4,1,5,1,2,13,2024-06-18T19:36:08.955Z
2024-06-18,4:30 PM,4,1,4,1,0,10,2024-06-18T21:33:14.151Z
2024-06-18,5:30 PM,3,1,2,0,1,7,2024-06-18T22:58:52.033Z
2024-06-18,6:30 PM,1,0,2,0,2,5,2024-06-18T23:43:28.232Z
2024-06-18,7:30 PM,2,0,1,0,0,3,2024-06-19T00:36:41.944Z
2024-06-18,8:30 PM,0,0,2,0,0,2,2024-06-19T01:30:16.844Z
2024-06-20,8:30 AM,2,0,1,0,0,3,2024-06-20T13:31:58.805Z
2024-06-20,7:30 AM,0,0,0,0,0,0,2024-06-20T13:39:29.351Z
2024-06-20,9:30 AM,2,1,1,0,1,5,2024-06-20T14:38:52.648Z
2024-06-20,10:30 AM,3,1,2,0,0,6,2024-06-20T15:32:28.723Z
2024-06-20,11:30 AM,5,2,4,0,3,14,2024-06-20T16:38:04.052Z
2024-06-20,12:30 PM,6,2,5,0,1,14,2024-06-20T17:35:31.660Z
2024-06-20,1:30 PM,4,1,4,1,0,10,2024-06-20T18:36:47.833Z
2024-06-20,2:30 PM,4,1,3,1,0,9,2024-06-20T19:43:28.316Z
2024-06-20,4:30 PM,3,0,3,1,3,10,2024-06-20T21:30:57.732Z
2024-06-20,5:30 PM,1,0,3,0,4,8,2024-06-20T22:32:13.822Z
2024-06-20,6:30 PM,2,0,3,0,6,11,2024-06-20T23:37:18.439Z
2024-06-20,7:30 PM,2,0,2,0,4,8,2024-06-21T00:32:42.611Z
2024-06-20,8:30 PM,0,0,0,0,0,0,2024-06-21T01:51:30.915Z
2024-06-21,7:30 AM,1,0,0,0,0,1,2024-06-21T12:39:45.254Z
2024-06-21,8:30 AM,1,1,0,0,0,2,2024-06-21T13:34:47.523Z
2024-06-21,9:30 AM,2,2,0,0,0,4,2024-06-21T14:27:37.253Z
2024-06-21,10:30 AM,5,2,1,0,0,8,2024-06-21T15:56:25.399Z
2024-06-21,11:30 AM,4,2,2,0,0,8,2024-06-21T16:40:32.327Z
2024-06-21,12:30 PM,4,1,2,0,0,7,2024-06-21T17:45:47.690Z
2024-06-21,1:30 PM,2,1,2,0,0,5,2024-06-21T18:38:13.231Z
2024-06-21,2:30 PM,2,1,1,0,0,4,2024-06-21T19:55:16.564Z
2024-06-21,3:30 PM,3,1,0,0,0,4,2024-06-21T20:35:05.330Z
2024-06-21,4:30 PM,2,0,0,2,0,4,2024-06-21T21:26:59.842Z
2024-06-24,7:30 AM,1,0,0,0,0,1,2024-06-24T12:38:53.933Z
2024-06-24,8:30 AM,4,0,1,0,0,5,2024-06-24T13:27:11.593Z
2024-06-24,9:30 AM,3,1,1,1,0,6,2024-06-24T14:30:04.722Z
2024-06-24,10:30 AM,1,1,3,1,0,6,2024-06-24T15:23:55.902Z
2024-06-24,11:30 AM,3,2,2,0,0,7,2024-06-24T16:31:47.277Z
2024-06-24,12:30 PM,12,3,4,0,1,20,2024-06-24T17:30:09.202Z
2024-06-24,1:30 PM,7,2,5,0,2,16,2024-06-24T18:39:27.797Z
2024-06-24,2:30 PM,0,3,8,1,0,12,2024-06-24T19:45:52.992Z
2024-06-24,3:30 PM,7,3,11,6,0,27,2024-06-24T20:32:11.910Z
2024-06-24,4:30 PM,6,1,7,2,1,17,2024-06-24T21:35:11.120Z
2024-06-24,5:30 PM,5,4,2,0,0,11,2024-06-24T22:44:27.761Z
2024-06-24,6:30 PM,3,1,1,0,2,7,2024-06-24T23:32:52.564Z
2024-06-24,7:30 PM,4,0,1,0,2,7,2024-06-25T01:00:29.652Z
2024-06-24,8:30 PM,5,0,1,2,2,10,2024-06-25T01:32:31.298Z
2024-06-25,7:30 AM,2,0,0,0,0,2,2024-06-25T12:53:25.308Z
2024-06-25,8:30 AM,1,0,0,1,0,2,2024-06-25T13:38:43.983Z
2024-06-25,9:30 AM,2,1,0,2,0,5,2024-06-25T14:44:01.525Z
2024-06-25,10:30 AM,2,1,1,1,0,5,2024-06-25T15:53:30.440Z
2024-06-25,11:30 AM,6,1,0,1,0,8,2024-06-25T16:34:11.015Z
2024-06-25,12:30 PM,7,2,1,1,0,11,2024-06-25T17:37:35.137Z
2024-06-25,1:30 PM,4,1,2,1,0,8,2024-06-25T18:44:07.940Z
2024-06-25,2:30 PM,3,1,5,1,0,10,2024-06-25T19:48:30.568Z
2024-06-25,3:30 PM,6,0,2,1,0,9,2024-06-25T20:34:40.634Z
2024-06-25,4:30 PM,5,2,3,0,0,10,2024-06-25T21:58:35.372Z
2024-06-25,5:30 PM,5,1,2,0,1,9,2024-06-25T22:32:57.145Z
2024-06-25,6:30 PM,4,1,1,0,3,9,2024-06-25T23:38:08.027Z
2024-06-25,7:30 PM,1,1,1,0,0,3,2024-06-26T00:37:09.400Z
2024-06-25,8:30 PM,1,0,0,0,0,1,2024-06-26T01:34:12.202Z
2024-06-26,7:30 AM,1,0,1,0,0,2,2024-06-26T12:56:17.480Z
2024-06-26,8:30 AM,1,0,2,0,0,3,2024-06-26T13:32:56.510Z
2024-06-26,9:30 AM,5,0,1,0,4,10,2024-06-26T14:33:45.389Z
2024-06-26,10:30 AM,2,0,4,0,1,7,2024-06-26T15:34:28.781Z
2024-06-26,11:30 AM,5,1,2,0,0,8,2024-06-26T16:34:01.440Z
2024-06-26,12:30 PM,14,2,4,2,5,27,2024-06-26T17:32:30.432Z
2024-06-26,1:30 PM,4,1,7,2,1,15,2024-06-26T18:32:31.113Z
2024-06-26,2:30 PM,6,1,6,2,1,16,2024-06-26T19:41:51.331Z
2024-06-26,3:30 PM,3,2,5,2,0,12,2024-06-26T20:35:00.855Z
2024-06-26,4:30 PM,2,2,6,0,2,12,2024-06-26T21:30:44.631Z
2024-06-26,5:30 PM,2,2,2,1,3,10,2024-06-26T22:39:33.590Z
2024-06-26,6:30 PM,2,2,1,1,1,7,2024-06-26T23:35:26.530Z
2024-06-26,7:30 PM,1,1,1,0,1,4,2024-06-27T00:54:54.528Z
2024-06-26,8:30 PM,0,0,1,0,2,3,2024-06-27T01:40:09.357Z
2024-06-27,7:30 AM,1,0,0,0,0,1,2024-06-27T12:34:16.241Z
2024-06-27,8:30 AM,1,0,0,0,0,1,2024-06-27T13:32:43.116Z
2024-06-27,9:30 AM,5,0,1,0,0,6,2024-06-27T14:31:59.201Z
2024-06-27,10:30 AM,3,0,1,0,0,4,2024-06-27T15:29:57.741Z
2024-06-27,11:30 AM,5,0,4,0,0,9,2024-06-27T16:35:33.400Z
2024-06-27,12:30 PM,5,0,4,0,3,12,2024-06-27T17:35:22.182Z
2024-06-27,1:30 PM,1,2,3,0,0,6,2024-06-27T18:36:59.028Z
2024-06-27,2:30 PM,2,2,9,0,1,14,2024-06-27T19:33:26.998Z
2024-06-27,3:30 PM,4,1,3,3,0,11,2024-06-27T20:31:06.830Z
2024-06-27,4:30 PM,2,1,5,1,1,10,2024-06-27T21:35:03.255Z
2024-06-27,5:30 PM,6,1,1,0,0,8,2024-06-27T22:32:21.901Z
2024-06-27,7:30 PM,3,2,1,0,0,6,2024-06-28T00:31:25.578Z
2024-06-28,7:30 AM,0,0,0,0,0,0,2024-06-28T12:31:27.304Z
2024-06-28,8:30 AM,2,0,0,0,0,2,2024-06-28T13:37:46.685Z
2024-06-28,9:30 AM,3,0,0,1,0,4,2024-06-28T14:40:49.879Z
2024-06-28,10:30 AM,2,0,3,1,0,6,2024-06-28T15:27:41.553Z
2024-06-28,11:30 AM,2,0,1,0,0,3,2024-06-28T16:34:40.987Z
2024-06-28,12:30 PM,2,2,1,1,0,6,2024-06-28T17:39:44.999Z
2024-06-28,1:30 PM,5,1,3,1,1,11,2024-06-28T18:57:16.628Z
2024-06-28,2:30 PM,5,1,4,1,0,11,2024-06-28T19:31:27.157Z
2024-06-28,3:30 PM,6,1,3,1,1,12,2024-06-28T20:38:43.502Z
2024-06-28,4:30 PM,4,1,2,1,0,8,2024-06-28T21:27:01.157Z
2024-07-01,7:30 AM,1,0,0,0,0,1,2024-07-01T12:42:45.246Z
2024-07-01,8:30 AM,4,0,1,0,0,5,2024-07-01T13:28:25.520Z
2024-07-01,9:30 AM,4,0,1,0,1,6,2024-07-01T14:29:22.660Z
2024-07-01,10:30 AM,4,0,0,0,0,4,2024-07-01T15:33:30.838Z
2024-07-01,11:30 AM,4,0,4,3,0,11,2024-07-01T16:31:29.471Z
2024-07-01,12:30 PM,7,0,10,4,2,23,2024-07-01T17:41:06.200Z
2024-07-01,1:30 PM,4,1,9,1,1,16,2024-07-01T18:34:32.904Z
2024-07-01,2:30 PM,6,1,6,1,0,14,2024-07-01T19:35:57.964Z
2024-07-01,4:30 PM,6,2,4,1,2,15,2024-07-01T21:36:30.813Z
2024-07-01,5:30 PM,2,2,3,1,2,10,2024-07-01T22:36:03.706Z
2024-07-01,6:30 PM,3,1,1,1,2,8,2024-07-01T23:27:29.551Z
2024-07-01,7:30 PM,3,1,1,1,0,6,2024-07-02T00:27:58.567Z
2024-07-02,7:30 AM,0,0,0,1,0,1,2024-07-02T12:46:11.326Z
2024-07-02,8:30 AM,0,1,0,2,0,3,2024-07-02T13:33:16.778Z
2024-07-02,9:30 AM,0,1,2,2,0,5,2024-07-02T14:28:11.632Z
2024-07-02,10:30 AM,2,1,2,2,0,7,2024-07-02T15:33:27.109Z
2024-07-02,11:30 AM,7,4,4,1,0,16,2024-07-02T16:37:44.903Z
2024-07-02,12:30 PM,6,1,5,1,1,14,2024-07-02T17:35:37.400Z
2024-07-02,1:30 PM,2,1,5,1,0,9,2024-07-02T18:41:00.132Z
2024-07-02,2:30 PM,2,1,3,0,0,6,2024-07-02T19:36:21.429Z
2024-07-02,3:30 PM,1,1,3,0,0,5,2024-07-02T20:40:06.466Z
2024-07-02,4:30 PM,5,1,3,0,0,9,2024-07-02T21:43:34.160Z
2024-07-02,6:30 PM,4,1,1,0,0,6,2024-07-02T23:40:36.651Z
2024-07-02,7:30 PM,4,1,0,0,2,7,2024-07-03T00:38:28.692Z
2024-07-02,8:30 PM,3,2,0,0,2,7,2024-07-03T01:30:06.244Z
2024-07-03,7:30 AM,1,0,0,0,0,1,2024-07-03T13:18:33.526Z
2024-07-03,8:30 AM,2,0,0,1,0,3,2024-07-03T13:35:25.434Z
2024-07-03,9:30 AM,2,1,2,3,0,8,2024-07-03T14:27:42.579Z
2024-07-03,10:30 AM,1,2,3,3,1,10,2024-07-03T15:29:17.332Z
2024-07-03,11:30 AM,5,2,0,3,0,10,2024-07-03T16:32:13.648Z
2024-07-03,12:30 PM,10,2,2,2,3,19,2024-07-03T17:36:20.513Z
2024-07-03,2:30 PM,2,2,4,0,0,8,2024-07-03T19:40:22.793Z
2024-07-03,4:30 PM,3,2,4,1,3,13,2024-07-03T21:34:14.340Z
2024-07-03,5:30 PM,2,1,3,1,2,9,2024-07-03T22:39:57.009Z
2024-07-03,6:30 PM,2,1,1,1,2,7,2024-07-03T23:51:14.176Z
2024-07-03,7:30 PM,3,0,1,0,0,4,2024-07-04T00:56:02.264Z
2024-07-05,7:30 AM,1,0,0,0,0,1,2024-07-05T12:56:46.865Z
2024-07-05,8:30 AM,1,0,0,0,0,1,2024-07-05T13:30:42.725Z
2024-07-05,9:30 AM,2,0,0,0,0,2,2024-07-05T14:34:23.266Z
2024-07-05,10:30 AM,4,0,2,1,0,7,2024-07-05T15:28:13.891Z
2024-07-05,11:30 AM,4,0,2,1,0,7,2024-07-05T16:36:50.020Z
2024-07-05,12:30 PM,5,1,0,1,0,7,2024-07-05T17:43:19.136Z
2024-07-05,1:30 PM,5,1,1,1,0,8,2024-07-05T18:36:05.048Z
2024-07-05,3:30 PM,3,0,1,1,0,5,2024-07-05T20:33:58.800Z
2024-07-08,7:30 AM,1,0,0,0,0,1,2024-07-08T13:01:35.188Z
2024-07-08,8:30 AM,4,0,2,0,0,6,2024-07-08T13:30:54.902Z
2024-07-08,9:30 AM,4,0,1,1,0,6,2024-07-08T14:32:25.919Z
2024-07-08,10:30 AM,6,0,4,1,0,11,2024-07-08T15:31:18.423Z
2024-07-08,11:30 AM,7,2,5,1,2,17,2024-07-08T16:31:27.699Z
2024-07-08,12:30 PM,16,3,7,1,2,29,2024-07-08T17:38:39.392Z
2024-07-08,1:30 PM,8,3,5,3,2,21,2024-07-08T18:43:21.716Z
2024-07-08,2:30 PM,8,1,3,1,4,17,2024-07-08T19:34:52.207Z
2024-07-08,4:30 PM,2,2,2,2,4,12,2024-07-08T21:32:12.966Z
2024-07-08,5:30 PM,0,0,4,0,2,6,2024-07-08T22:43:04.406Z
2024-07-08,6:30 PM,1,0,2,0,9,12,2024-07-08T23:44:38.207Z
2024-07-08,7:30 PM,2,0,1,0,7,10,2024-07-09T00:32:41.015Z
2024-07-09,7:30 AM,2,0,0,0,0,2,2024-07-09T13:01:16.552Z
2024-07-09,8:30 AM,2,0,0,2,0,4,2024-07-09T13:38:46.359Z
2024-07-09,9:30 AM,3,0,0,2,0,5,2024-07-09T14:31:25.987Z
2024-07-09,10:30 AM,4,0,2,2,0,8,2024-07-09T15:41:39.167Z
2024-07-09,11:30 AM,2,1,2,2,0,7,2024-07-09T16:40:24.568Z
2024-07-09,12:30 PM,6,5,1,1,1,14,2024-07-09T17:34:02.120Z
2024-07-09,1:30 PM,3,1,3,1,0,8,2024-07-09T18:40:04.399Z
2024-07-09,2:30 PM,7,0,3,1,1,12,2024-07-09T19:38:18.758Z
2024-07-09,3:30 PM,5,3,1,0,0,9,2024-07-09T20:34:48.369Z
2024-07-09,4:30 PM,3,2,0,0,3,8,2024-07-09T21:36:32.142Z
2024-07-09,5:30 PM,2,2,0,0,1,5,2024-07-09T22:37:03.345Z
2024-07-09,6:30 PM,1,0,3,0,1,5,2024-07-09T23:38:37.210Z
2024-07-09,7:30 PM,0,1,1,1,0,3,2024-07-10T00:53:10.381Z
2024-07-09,8:30 PM,0,0,0,0,1,1,2024-07-10T01:36:12.066Z
2024-07-10,7:30 AM,1,0,0,0,0,1,2024-07-10T13:07:13.638Z
2024-07-10,8:30 AM,3,0,1,1,0,5,2024-07-10T13:55:23.610Z
2024-07-10,9:30 AM,5,0,2,3,4,14,2024-07-10T14:30:50.192Z
2024-07-10,10:30 AM,2,0,5,3,0,10,2024-07-10T15:29:42.580Z
2024-07-10,11:30 AM,3,3,6,5,0,17,2024-07-10T16:38:15.225Z
2024-07-10,12:30 PM,6,3,3,3,2,17,2024-07-10T17:36:49.748Z
2024-07-10,1:30 PM,6,2,2,1,0,11,2024-07-10T18:38:56.471Z
2024-07-10,2:30 PM,3,1,5,0,0,9,2024-07-10T19:32:43.469Z
2024-07-10,3:30 PM,7,0,5,0,0,12,2024-07-10T20:34:23.840Z
2024-07-10,4:30 PM,4,0,2,4,5,15,2024-07-10T21:32:54.360Z
2024-07-10,6:30 PM,3,0,3,0,0,6,2024-07-10T23:42:41.373Z
2024-07-10,7:30 PM,9,1,2,0,0,12,2024-07-11T00:33:11.664Z
2024-07-10,8:30 PM,3,3,0,0,1,7,2024-07-11T01:33:15.631Z
2024-07-11,7:30 AM,0,0,0,0,0,0,2024-07-11T12:45:08.451Z
2024-07-11,8:30 AM,5,0,0,0,1,6,2024-07-11T13:53:14.007Z
2024-07-11,9:30 AM,4,0,1,0,0,5,2024-07-11T14:30:41.367Z
2024-07-11,10:30 AM,4,0,3,1,0,8,2024-07-11T15:36:36.403Z
2024-07-11,11:30 AM,7,2,2,1,0,12,2024-07-11T16:33:17.201Z
2024-07-11,12:30 PM,7,3,8,1,0,19,2024-07-11T17:36:05.559Z
2024-07-11,1:30 PM,5,1,7,1,0,14,2024-07-11T18:37:07.631Z
2024-07-11,2:30 PM,4,1,2,1,1,9,2024-07-11T19:33:52.966Z
2024-07-11,3:30 PM,5,1,0,0,3,9,2024-07-11T20:31:45.620Z
2024-07-11,4:30 PM,4,1,0,1,3,9,2024-07-11T21:33:20.495Z
2024-07-11,5:30 PM,1,1,1,0,0,3,2024-07-11T22:45:19.501Z
2024-07-11,6:30 PM,2,1,1,0,0,4,2024-07-11T23:39:48.733Z
2024-07-11,7:30 PM,2,0,1,0,0,3,2024-07-12T00:41:13.128Z
2024-07-11,8:30 PM,1,0,0,0,0,1,2024-07-12T01:42:34.938Z
2024-07-12,7:30 AM,1,0,0,0,0,1,2024-07-12T13:05:38.972Z
2024-07-12,8:30 AM,3,0,0,0,0,3,2024-07-12T13:39:33.723Z
2024-07-12,9:30 AM,1,0,1,1,0,3,2024-07-12T14:38:52.981Z
2024-07-12,10:30 AM,1,1,3,1,0,6,2024-07-12T15:54:26.855Z
2024-07-12,11:30 AM,3,0,2,2,0,7,2024-07-12T16:33:32.455Z
2024-07-12,12:30 PM,3,0,3,0,0,6,2024-07-12T17:33:25.207Z
2024-07-12,1:30 PM,1,0,1,0,0,2,2024-07-12T18:35:18.065Z
2024-07-12,2:30 PM,1,0,2,0,0,3,2024-07-12T19:33:24.675Z
2024-07-12,3:30 PM,1,0,2,3,0,6,2024-07-12T20:46:50.170Z
2024-07-15,7:30 AM,4,0,0,0,0,4,2024-07-15T12:43:43.128Z
2024-07-15,8:30 AM,3,0,0,0,0,3,2024-07-15T13:31:58.699Z
2024-07-15,9:30 AM,4,1,2,0,1,8,2024-07-15T14:41:46.852Z
2024-07-15,10:30 AM,2,2,3,0,0,7,2024-07-15T15:30:44.984Z
2024-07-15,11:30 AM,2,1,7,1,0,11,2024-07-15T16:35:57.902Z
2024-07-15,12:30 PM,16,2,6,1,0,25,2024-07-15T17:43:20.999Z
2024-07-15,1:30 PM,5,2,7,1,0,15,2024-07-15T18:36:14.669Z
2024-07-15,2:30 PM,4,2,7,1,0,14,2024-07-15T19:44:05.090Z
2024-07-15,3:30 PM,7,0,4,2,9,22,2024-07-15T20:31:46.791Z
2024-07-15,4:30 PM,6,0,3,1,5,15,2024-07-15T21:54:11.196Z
2024-07-15,5:30 PM,3,0,2,0,0,5,2024-07-15T22:36:28.700Z
2024-07-15,6:30 PM,0,0,1,0,0,1,2024-07-15T23:28:05.007Z
2024-07-15,7:30 PM,5,0,1,1,0,7,2024-07-16T00:33:02.971Z
2024-07-15,8:30 PM,3,0,0,1,0,4,2024-07-16T01:33:38.174Z
2024-07-16,7:30 AM,0,0,0,0,0,0,2024-07-16T12:32:34.378Z
2024-07-16,8:30 AM,1,0,0,0,0,1,2024-07-16T13:59:02.332Z
2024-07-16,9:30 AM,3,2,1,2,0,8,2024-07-16T14:30:46.822Z
2024-07-16,10:30 AM,2,2,3,3,0,10,2024-07-16T15:31:32.239Z
2024-07-16,11:30 AM,2,1,4,1,0,8,2024-07-16T16:36:12.817Z
2024-07-16,12:30 PM,5,1,7,2,1,16,2024-07-16T17:34:35.794Z
2024-07-16,1:30 PM,6,3,8,1,0,18,2024-07-16T18:35:44.133Z
2024-07-16,2:30 PM,5,3,5,1,0,14,2024-07-16T19:34:56.407Z
2024-07-16,3:30 PM,5,2,2,0,1,10,2024-07-16T20:35:27.196Z
2024-07-16,4:30 PM,3,1,2,5,3,14,2024-07-16T21:35:27.373Z
2024-07-16,5:30 PM,3,0,3,0,2,8,2024-07-16T22:32:04.241Z
2024-07-16,7:30 PM,3,0,2,0,1,6,2024-07-17T00:30:51.449Z
2024-07-16,8:30 PM,1,0,0,0,1,2,2024-07-17T01:31:27.510Z
2024-07-17,7:30 AM,1,0,0,0,0,1,2024-07-17T12:44:42.566Z
2024-07-17,8:30 AM,1,0,0,2,0,3,2024-07-17T13:51:42.461Z
2024-07-17,9:30 AM,4,0,0,2,0,6,2024-07-17T14:39:06.810Z
2024-07-17,10:30 AM,6,0,5,2,0,13,2024-07-17T15:36:04.996Z
2024-07-17,11:30 AM,7,0,7,2,0,16,2024-07-17T16:38:18.295Z
2024-07-17,12:30 PM,7,2,8,3,2,22,2024-07-17T17:43:48.423Z
2024-07-17,2:30 PM,6,0,7,0,0,13,2024-07-17T19:36:02.834Z
2024-07-17,3:30 PM,7,2,5,0,0,14,2024-07-17T20:35:16.365Z
2024-07-17,4:30 PM,2,0,1,1,0,4,2024-07-17T21:40:26.080Z
2024-07-17,5:30 PM,4,0,4,2,6,16,2024-07-17T22:52:19.715Z
2024-07-17,6:30 PM,3,0,4,0,9,16,2024-07-17T23:50:11.501Z
2024-07-17,7:30 PM,1,0,3,2,10,16,2024-07-18T00:36:00.114Z
2024-07-17,8:30 PM,1,0,0,0,5,6,2024-07-18T01:44:54.568Z
2024-07-18,7:30 AM,0,0,0,0,0,0,2024-07-18T13:06:08.025Z
2024-07-18,8:30 AM,2,0,0,3,0,5,2024-07-18T13:35:37.812Z
2024-07-18,9:30 AM,2,0,1,3,0,6,2024-07-18T14:39:40.267Z
2024-07-18,10:30 AM,7,0,2,3,0,12,2024-07-18T15:30:48.996Z
2024-07-18,11:30 AM,3,1,4,2,1,11,2024-07-18T16:33:47.790Z
2024-07-18,12:30 PM,4,2,5,0,2,13,2024-07-18T17:40:27.700Z
2024-07-18,1:30 PM,2,3,3,0,2,10,2024-07-18T18:35:59.115Z
2024-07-18,2:30 PM,2,2,3,0,0,7,2024-07-18T19:33:22.623Z
2024-07-18,3:30 PM,2,2,1,0,0,5,2024-07-18T20:33:57.406Z
2024-07-18,4:30 PM,2,1,0,0,2,5,2024-07-18T21:37:19.275Z
2024-07-18,5:30 PM,2,0,1,0,2,5,2024-07-18T22:47:42.638Z
2024-07-18,7:30 PM,0,0,0,0,2,2,2024-07-19T00:32:34.993Z
2024-07-18,8:30 PM,1,0,2,0,0,3,2024-07-19T01:33:28.843Z
2024-07-19,7:30 AM,1,0,0,0,0,1,2024-07-19T12:44:21.271Z
2024-07-19,9:30 AM,1,0,1,0,0,2,2024-07-19T14:33:46.593Z
2024-07-19,8:30 AM,1,0,1,0,0,2,2024-07-19T14:34:11.282Z
2024-07-19,10:30 AM,1,0,2,1,0,4,2024-07-19T15:38:03.753Z
2024-07-19,11:30 AM,1,0,2,0,0,3,2024-07-19T16:31:28.153Z
2024-07-19,12:30 PM,2,0,3,0,1,6,2024-07-19T17:45:42.369Z
2024-07-19,1:30 PM,1,0,2,2,0,5,2024-07-19T18:41:15.515Z
2024-07-19,2:30 PM,0,0,1,2,0,3,2024-07-19T19:34:38.326Z
2024-07-19,3:30 PM,2,0,1,0,0,3,2024-07-19T20:31:53.675Z
2024-07-19,4:30 PM,2,2,1,0,0,5,2024-07-19T21:31:06.860Z
2024-07-22,7:30 AM,1,0,0,0,0,1,2024-07-22T12:36:51.004Z
2024-07-22,7:30 AM,1,0,0,0,0,1,2024-07-22T12:42:02.439Z
2024-07-22,8:30 AM,2,1,1,0,0,4,2024-07-22T13:45:00.442Z
2024-07-22,9:30 AM,9,1,2,0,0,12,2024-07-22T14:44:57.555Z
2024-07-22,10:30 AM,4,2,3,1,0,10,2024-07-22T15:40:34.031Z
2024-07-22,11:30 AM,9,2,3,0,0,14,2024-07-22T16:37:42.806Z
2024-07-22,12:30 PM,12,2,7,4,1,26,2024-07-22T17:38:43.471Z
2024-07-22,1:30 PM,1,2,5,0,0,8,2024-07-22T18:42:49.211Z
2024-07-22,2:30 PM,3,1,4,0,1,9,2024-07-22T19:38:48.629Z
2024-07-22,3:30 PM,2,2,4,1,1,10,2024-07-22T20:50:47.918Z
2024-07-22,4:30 PM,3,3,3,2,0,11,2024-07-22T21:30:58.513Z
2024-07-22,5:30 PM,4,0,0,0,6,10,2024-07-22T22:40:22.224Z
2024-07-22,6:30 PM,1,0,1,0,8,10,2024-07-22T23:32:18.867Z
2024-07-22,7:30 PM,2,0,1,0,2,5,2024-07-23T00:48:07.051Z
2024-07-23,7:30 AM,0,0,0,0,0,0,2024-07-23T12:44:29.078Z
2024-07-23,8:30 AM,3,0,0,0,0,3,2024-07-23T13:31:45.725Z
2024-07-23,9:30 AM,1,0,2,1,0,4,2024-07-23T14:33:09.935Z
2024-07-23,10:30 AM,0,0,3,1,0,4,2024-07-23T15:32:14.711Z
2024-07-23,11:30 AM,1,1,7,0,0,9,2024-07-23T16:33:28.892Z
2024-07-23,12:30 PM,3,0,4,0,0,7,2024-07-23T17:40:20.942Z
2024-07-23,1:30 PM,0,2,7,1,0,10,2024-07-23T18:38:02.087Z
2024-07-23,2:30 PM,3,3,9,0,0,15,2024-07-23T19:29:00.599Z
2024-07-23,3:30 PM,0,1,3,0,0,4,2024-07-23T20:33:58.157Z
2024-07-23,4:30 PM,1,2,3,0,0,6,2024-07-23T21:36:59.713Z
2024-07-23,5:30 PM,2,2,2,0,10,16,2024-07-23T22:59:34.988Z
2024-07-23,6:30 PM,1,0,2,0,8,11,2024-07-23T23:27:55.974Z
2024-07-24,7:30 AM,0,0,0,0,0,0,2024-07-24T12:52:42.650Z
2024-07-24,10:30 AM,6,1,4,0,0,11,2024-07-24T15:31:00.793Z
2024-07-24,11:30 AM,6,0,7,0,0,13,2024-07-24T16:33:46.853Z
2024-07-24,12:30 PM,11,1,7,0,3,22,2024-07-24T17:50:52.996Z
2024-07-24,1:30 PM,6,1,7,0,2,16,2024-07-24T18:35:20.453Z
2024-07-24,3:30 PM,8,2,4,0,3,17,2024-07-24T20:46:39.174Z
2024-07-24,4:30 PM,1,4,4,5,1,15,2024-07-24T21:33:45.765Z
2024-07-24,5:30 PM,0,1,6,0,8,15,2024-07-24T22:37:43.252Z
2024-07-24,6:30 PM,4,0,2,0,8,14,2024-07-24T23:39:05.416Z
2024-07-24,7:30 PM,1,2,1,0,0,4,2024-07-25T00:29:58.080Z
2024-07-24,8:30 PM,2,0,1,0,0,3,2024-07-25T01:42:00.626Z
2024-07-25,7:30 AM,1,0,0,0,0,1,2024-07-25T12:57:21.503Z
2024-07-25,9:30 AM,2,1,1,0,0,4,2024-07-25T14:27:53.051Z
2024-07-25,10:30 AM,3,2,3,6,0,14,2024-07-25T15:35:54.882Z
2024-07-25,11:30 AM,5,0,2,4,0,11,2024-07-25T16:25:59.170Z
2024-07-25,12:30 PM,5,1,1,1,0,8,2024-07-25T17:37:07.340Z
2024-07-25,1:30 PM,5,0,1,0,0,6,2024-07-25T18:39:14.443Z
2024-07-25,3:30 PM,2,1,2,2,0,7,2024-07-25T20:44:02.459Z
2024-07-25,4:30 PM,3,3,4,2,5,17,2024-07-25T21:41:30.534Z
2024-07-25,5:30 PM,5,3,5,0,1,14,2024-07-25T22:34:04.104Z
2024-07-25,6:30 PM,3,1,3,0,7,14,2024-07-25T23:46:53.012Z
2024-07-25,7:30 PM,2,1,2,2,0,7,2024-07-26T00:37:43.364Z
2024-07-25,8:30 PM,2,0,0,0,0,2,2024-07-26T01:33:17.931Z
2024-07-26,7:30 AM,1,0,0,1,0,2,2024-07-26T13:02:37.849Z
2024-07-26,8:30 AM,1,0,1,0,0,2,2024-07-26T14:14:40.492Z
2024-07-26,9:30 AM,3,0,1,0,0,4,2024-07-26T14:28:37.881Z
2024-07-26,12:30 PM,6,0,2,0,0,8,2024-07-26T17:41:50.323Z
2024-07-26,1:30 PM,5,1,2,0,0,8,2024-07-26T18:42:12.126Z
2024-07-26,2:30 PM,2,1,2,0,0,5,2024-07-26T19:59:15.084Z
2024-07-26,3:30 PM,3,0,2,1,0,6,2024-07-26T20:40:27.829Z
2024-07-26,4:30 PM,2,0,1,1,0,4,2024-07-26T21:40:47.850Z
2024-07-29,7:30 AM,2,0,0,0,0,2,2024-07-29T13:13:38.083Z
2024-07-29,8:30 AM,2,1,0,1,0,4,2024-07-29T13:39:33.021Z
2024-07-29,9:30 AM,5,0,3,2,3,13,2024-07-29T14:30:04.630Z
2024-07-29,10:30 AM,5,0,5,3,1,14,2024-07-29T15:33:43.935Z
2024-07-29,11:30 AM,6,2,4,0,0,12,2024-07-29T16:23:48.402Z
2024-07-29,12:30 PM,5,2,8,1,1,17,2024-07-29T17:39:16.297Z
2024-07-29,1:30 PM,3,3,5,0,1,12,2024-07-29T18:47:42.985Z
2024-07-29,2:30 PM,5,2,4,0,1,12,2024-07-29T19:36:40.530Z
2024-07-29,3:30 PM,7,5,6,0,1,19,2024-07-29T20:40:13.251Z
2024-07-29,4:30 PM,2,2,5,3,6,18,2024-07-29T21:36:14.679Z
2024-07-29,5:30 PM,5,1,3,0,0,9,2024-07-29T22:39:01.240Z
2024-07-29,6:30 PM,3,1,3,0,3,10,2024-07-29T23:45:41.908Z
2024-07-29,7:30 PM,2,1,3,1,4,11,2024-07-30T00:38:32.989Z
2024-07-29,8:30 PM,0,0,2,0,0,2,2024-07-30T01:40:33.062Z
2024-07-30,7:30 AM,1,0,0,0,0,1,2024-07-30T12:42:52.415Z
2024-07-30,8:30 AM,2,0,1,0,0,3,2024-07-30T13:39:15.226Z
2024-07-30,9:30 AM,4,0,4,0,0,8,2024-07-30T14:30:25.786Z
2024-07-30,10:30 AM,6,1,2,0,2,11,2024-07-30T15:32:13.255Z
2024-07-30,11:30 AM,4,2,4,0,2,12,2024-07-30T16:34:14.007Z
2024-07-30,12:30 PM,7,1,3,1,1,13,2024-07-30T17:31:00.297Z
2024-07-30,1:30 PM,1,3,3,2,0,9,2024-07-30T18:38:16.288Z
2024-07-30,2:30 PM,4,2,3,1,0,10,2024-07-30T19:38:31.826Z
2024-07-30,3:30 PM,2,1,1,2,0,6,2024-07-30T20:32:21.161Z
2024-07-30,4:30 PM,0,1,2,0,1,4,2024-07-30T21:39:38.819Z
2024-07-30,5:30 PM,2,2,1,0,1,6,2024-07-30T22:37:54.259Z
2024-07-30,6:30 PM,2,1,1,0,1,5,2024-07-30T23:26:59.690Z
2024-07-30,7:30 PM,2,0,1,0,1,4,2024-07-31T00:47:35.379Z
2024-07-30,8:30 PM,0,0,0,0,0,0,2024-07-31T01:32:10.297Z
2024-07-31,7:30 AM,0,0,0,0,0,0,2024-07-31T12:33:40.614Z
2024-07-31,9:30 AM,6,1,2,0,2,11,2024-07-31T14:31:39.555Z
2024-07-31,10:30 AM,3,2,6,0,0,11,2024-07-31T15:40:25.651Z
2024-07-31,11:30 AM,4,2,6,0,0,12,2024-07-31T16:39:42.749Z
2024-07-31,12:30 PM,1,5,2,0,0,8,2024-07-31T17:41:33.148Z
2024-07-31,1:30 PM,0,2,3,0,0,5,2024-07-31T18:37:05.877Z
2024-07-31,2:30 PM,0,1,2,0,0,3,2024-07-31T19:39:01.841Z
2024-07-31,3:30 PM,2,4,3,0,3,12,2024-07-31T20:29:14.917Z
2024-07-31,4:30 PM,1,2,2,0,0,5,2024-07-31T21:32:08.139Z
2024-07-31,5:30 PM,0,0,3,0,0,3,2024-07-31T22:33:09.620Z
2024-07-31,6:30 PM,3,1,1,1,1,7,2024-07-31T23:30:13.910Z
2024-07-31,7:30 PM,2,1,1,2,0,6,2024-08-01T00:32:02.636Z
2024-08-01,7:30 AM,1,0,0,0,0,1,2024-08-01T13:29:08.776Z
2024-08-01,8:30 AM,3,0,0,0,0,3,2024-08-01T13:39:47.009Z
2024-08-01,9:30 AM,3,2,0,1,0,6,2024-08-01T14:48:21.581Z
2024-08-01,10:30 AM,7,1,1,1,0,10,2024-08-01T15:33:11.997Z
2024-08-01,11:30 AM,8,5,5,4,0,22,2024-08-01T16:28:42.531Z
2024-08-01,12:30 PM,11,0,2,2,1,16,2024-08-01T17:40:13.299Z
2024-08-01,1:30 PM,4,0,2,1,0,7,2024-08-01T18:30:37.044Z
2024-08-01,2:30 PM,1,0,1,1,0,3,2024-08-01T19:35:28.439Z
2024-08-01,3:30 PM,4,0,0,0,0,4,2024-08-01T20:34:19.851Z
2024-08-01,4:30 PM,7,2,0,0,0,9,2024-08-01T21:32:35.220Z
2024-08-01,5:30 PM,2,1,1,0,1,5,2024-08-01T22:31:43.153Z
2024-08-01,6:30 PM,3,0,1,0,1,5,2024-08-02T00:44:26.133Z
2024-08-01,7:30 PM,1,0,2,0,0,3,2024-08-02T00:46:32.461Z
2024-08-01,8:30 PM,0,0,0,0,0,0,2024-08-02T01:54:40.396Z
2024-08-02,7:30 AM,1,0,0,0,0,1,2024-08-02T13:25:16.013Z
2024-08-02,8:30 AM,2,2,0,0,0,4,2024-08-02T13:54:09.021Z
2024-08-02,9:30 AM,1,1,0,0,0,2,2024-08-02T14:55:36.843Z
2024-08-02,10:30 AM,4,1,1,0,0,6,2024-08-02T15:54:13.799Z
2024-08-02,11:30 AM,8,1,4,0,0,13,2024-08-02T16:28:38.026Z
2024-08-02,12:30 PM,3,1,7,0,2,13,2024-08-02T17:42:06.938Z
2024-08-02,1:30 PM,5,0,3,0,1,9,2024-08-02T18:45:03.972Z
2024-08-02,2:30 PM,4,1,4,0,3,12,2024-08-02T19:32:54.945Z
2024-08-02,3:30 PM,5,1,4,1,1,12,2024-08-02T20:46:51.498Z
2024-08-05,7:30 AM,1,0,0,0,0,1,2024-08-05T12:47:24.958Z
2024-08-05,8:30 AM,3,0,0,0,0,3,2024-08-05T13:59:46.972Z
2024-08-05,9:30 AM,1,0,0,0,0,1,2024-08-05T14:43:35.840Z
2024-08-05,10:30 AM,1,0,2,2,0,5,2024-08-05T15:29:03.205Z
2024-08-05,11:30 AM,2,1,3,2,0,8,2024-08-05T16:33:20.313Z
2024-08-05,12:30 PM,2,1,5,2,0,10,2024-08-05T17:33:09.148Z
2024-08-05,1:30 PM,3,0,6,0,0,9,2024-08-05T18:34:01.035Z
2024-08-05,2:30 PM,4,0,2,0,0,6,2024-08-05T19:46:25.943Z
2024-08-05,3:30 PM,4,2,2,0,0,8,2024-08-05T20:32:22.208Z
2024-08-05,4:30 PM,5,0,3,0,0,8,2024-08-05T21:32:51.114Z
2024-08-05,5:30 PM,0,0,2,0,0,2,2024-08-05T22:47:29.362Z
2024-08-06,7:30 AM,0,0,0,0,0,0,2024-08-06T12:43:45.701Z
2024-08-06,8:30 AM,1,0,0,0,0,1,2024-08-06T13:29:30.726Z
2024-08-06,9:30 AM,5,0,0,0,0,5,2024-08-06T14:38:42.042Z
2024-08-06,10:30 AM,4,0,1,0,0,5,2024-08-06T15:39:10.098Z
2024-08-06,11:30 AM,2,0,3,0,0,5,2024-08-06T16:34:04.805Z
2024-08-06,12:30 PM,4,0,2,0,0,6,2024-08-06T17:38:33.833Z
2024-08-06,1:30 PM,1,0,2,1,0,4,2024-08-06T18:47:45.645Z
2024-08-06,2:30 PM,2,1,3,0,0,6,2024-08-06T19:36:13.698Z
2024-08-06,3:30 PM,2,0,3,0,0,5,2024-08-06T20:37:54.789Z
2024-08-06,4:30 PM,0,0,1,0,1,2,2024-08-06T21:32:22.573Z
2024-08-06,5:30 PM,1,0,0,2,1,4,2024-08-06T22:46:22.301Z
2024-08-07,7:30 AM,1,0,0,1,0,2,2024-08-07T12:59:11.956Z
2024-08-07,8:30 AM,1,0,0,1,0,2,2024-08-07T13:42:58.044Z
2024-08-07,9:30 AM,0,0,0,1,0,1,2024-08-07T14:33:47.267Z
2024-08-07,10:30 AM,1,2,1,1,0,5,2024-08-07T15:31:12.247Z
2024-08-07,11:30 AM,3,0,1,0,0,4,2024-08-07T16:38:09.874Z
2024-08-07,12:30 PM,4,1,1,0,0,6,2024-08-07T17:32:58.274Z
2024-08-07,1:30 PM,1,0,3,0,0,4,2024-08-07T18:44:12.614Z
2024-08-07,2:30 PM,2,0,1,0,0,3,2024-08-07T19:39:04.534Z
2024-08-07,3:30 PM,1,0,1,0,0,2,2024-08-07T20:32:25.365Z
2024-08-07,4:30 PM,2,0,1,0,0,3,2024-08-07T21:34:24.781Z
2024-08-08,7:30 AM,0,0,0,0,0,0,2024-08-08T12:48:54.372Z
2024-08-08,8:30 AM,1,0,0,0,0,1,2024-08-08T13:30:08.534Z
2024-08-08,9:30 AM,2,0,0,0,0,2,2024-08-08T14:29:10.203Z
2024-08-08,11:30 AM,2,0,2,0,0,4,2024-08-08T16:44:44.996Z
2024-08-08,10:30 AM,2,0,2,0,0,4,2024-08-08T16:45:05.966Z
2024-08-08,12:30 PM,3,0,3,0,0,6,2024-08-08T17:35:30.823Z
2024-08-08,1:30 PM,1,1,2,0,0,4,2024-08-08T18:32:55.356Z
2024-08-08,2:30 PM,3,2,2,0,0,7,2024-08-08T19:33:22.438Z
2024-08-08,3:30 PM,2,5,0,1,0,8,2024-08-08T20:40:28.239Z
2024-08-08,4:30 PM,4,4,0,0,0,8,2024-08-08T21:38:10.217Z
2024-08-08,5:30 PM,4,4,0,0,0,8,2024-08-08T22:51:36.504Z
2024-08-09,7:30 AM,0,0,0,0,0,0,2024-08-09T12:59:38.038Z
2024-08-09,8:30 AM,0,0,0,0,0,0,2024-08-09T13:43:26.121Z
2024-08-09,9:30 AM,1,0,0,0,0,1,2024-08-09T14:28:36.785Z
2024-08-09,10:30 AM,2,0,0,0,0,2,2024-08-09T15:20:04.476Z
2024-08-09,11:30 AM,4,0,0,0,0,4,2024-08-09T16:33:15.312Z
2024-08-09,12:30 PM,0,0,1,0,0,1,2024-08-09T17:41:14.549Z
2024-08-09,1:30 PM,2,0,2,2,0,6,2024-08-09T18:36:20.755Z
2024-08-09,2:30 PM,1,1,3,0,0,5,2024-08-09T19:34:29.962Z
2024-08-09,3:30 PM,1,2,0,0,0,3,2024-08-09T20:56:37.262Z
2024-08-09,4:30 PM,3,2,0,0,0,5,2024-08-09T21:43:11.015Z
2024-08-09,5:30 PM,1,0,0,0,0,1,2024-08-09T22:39:54.810Z
2024-08-12,7:30 AM,1,0,0,0,0,1,2024-08-12T12:52:18.340Z
2024-08-12,8:30 AM,1,0,0,0,0,1,2024-08-12T13:32:44.989Z
2024-08-12,9:30 AM,1,0,0,0,0,1,2024-08-12T14:47:09.001Z
2024-08-12,10:30 AM,2,0,1,0,0,3,2024-08-12T15:31:08.169Z
2024-08-12,11:30 AM,4,0,2,0,0,6,2024-08-12T16:32:03.707Z
2024-08-12,12:30 PM,4,0,2,0,0,6,2024-08-12T17:33:16.979Z
2024-08-12,1:30 PM,2,0,2,0,0,4,2024-08-12T18:57:27.633Z
2024-08-12,2:30 PM,1,0,2,0,0,3,2024-08-12T19:29:42.516Z
2024-08-12,3:30 PM,1,0,2,1,0,4,2024-08-12T21:03:50.600Z
2024-08-12,4:30 PM,2,0,1,0,0,3,2024-08-12T21:56:28.538Z
2024-08-12,5:30 PM,1,0,0,0,1,2,2024-08-12T22:33:03.336Z
2024-08-13,7:30 AM,0,0,0,0,0,0,2024-08-13T13:05:43.744Z
2024-08-13,8:30 AM,0,0,1,0,0,1,2024-08-13T14:17:01.472Z
2024-08-13,9:30 AM,0,0,2,0,0,2,2024-08-13T14:30:17.484Z
2024-08-13,10:30 AM,0,1,1,1,1,4,2024-08-13T15:43:41.890Z
2024-08-13,11:30 AM,1,1,0,0,0,2,2024-08-13T16:33:11.716Z
2024-08-13,12:30 PM,1,2,1,0,1,5,2024-08-13T17:48:48.169Z
2024-08-13,1:30 PM,5,0,2,0,0,7,2024-08-13T18:43:04.158Z
2024-08-13,2:30 PM,3,2,1,0,0,6,2024-08-13T19:40:06.848Z
2024-08-13,4:30 PM,1,2,3,0,0,6,2024-08-13T21:31:02.482Z
2024-08-13,5:30 PM,2,0,0,0,0,2,2024-08-13T22:58:56.634Z
2024-08-14,7:30 AM,0,0,0,0,0,0,2024-08-14T12:37:55.787Z
2024-08-14,8:30 AM,2,0,0,0,0,2,2024-08-14T13:34:19.048Z
2024-08-14,9:30 AM,5,0,2,0,0,7,2024-08-14T14:50:41.032Z
2024-08-14,10:30 AM,1,0,3,0,0,4,2024-08-14T15:34:15.666Z
2024-08-14,11:30 AM,2,2,0,0,3,7,2024-08-14T16:37:47.852Z
2024-08-14,12:30 PM,3,0,1,0,0,4,2024-08-14T17:35:23.128Z
2024-08-14,1:30 PM,1,1,0,0,0,2,2024-08-14T18:35:38.627Z
2024-08-14,2:30 PM,3,0,0,2,0,5,2024-08-14T19:44:42.951Z
2024-08-14,3:30 PM,3,3,2,0,0,8,2024-08-14T20:37:57.376Z
2024-08-14,4:30 PM,2,2,1,0,2,7,2024-08-14T21:33:34.825Z
2024-08-14,5:30 PM,5,0,1,0,0,6,2024-08-14T22:29:12.569Z
2024-08-15,7:30 AM,0,0,0,0,0,0,2024-08-15T13:05:20.483Z
2024-08-15,7:30 AM,0,0,0,0,0,0,2024-08-15T13:06:36.358Z
2024-08-15,8:30 AM,0,0,0,0,0,0,2024-08-15T13:33:21.845Z
2024-08-15,9:30 AM,1,0,1,0,0,2,2024-08-15T14:30:36.458Z
2024-08-15,10:30 AM,2,0,2,0,0,4,2024-08-15T15:30:36.170Z
2024-08-15,11:30 AM,4,1,2,0,0,7,2024-08-15T16:37:14.636Z
2024-08-15,12:30 PM,7,1,2,0,0,10,2024-08-15T17:36:01.830Z
2024-08-15,4:30 PM,2,0,0,0,0,2,2024-08-15T21:31:27.670Z
2024-08-16,7:30 AM,1,0,0,0,0,1,2024-08-16T13:16:42.191Z
2024-08-16,8:30 AM,1,0,0,0,0,1,2024-08-16T13:16:59.995Z
2024-08-16,10:30 AM,1,0,0,0,0,1,2024-08-16T15:28:52.483Z
2024-08-16,9:30 AM,1,0,1,0,0,2,2024-08-16T15:40:22.377Z
2024-08-16,11:30 AM,3,0,3,0,0,6,2024-08-16T16:36:27.558Z
2024-08-16,12:30 PM,5,0,3,0,0,8,2024-08-16T17:36:03.734Z
2024-08-16,1:30 PM,4,2,1,0,0,7,2024-08-16T18:47:13.987Z
2024-08-16,2:30 PM,3,1,0,0,0,4,2024-08-16T19:35:04.634Z
2024-08-16,3:30 PM,4,0,0,0,0,4,2024-08-16T20:48:10.304Z
2024-08-16,4:30 PM,2,0,0,0,0,2,2024-08-16T21:33:34.133Z
2024-08-16,5:30 PM,4,0,0,0,1,5,2024-08-16T22:33:34.852Z
2024-08-19,7:30 AM,4,0,2,0,0,6,2024-08-19T13:00:43.086Z
2024-08-19,8:30 AM,6,2,7,0,1,16,2024-08-19T13:46:37.780Z
2024-08-19,9:30 AM,12,1,9,3,0,25,2024-08-19T14:34:59.972Z
2024-08-19,10:30 AM,12,3,15,4,1,35,2024-08-19T15:30:30.086Z
2024-08-19,11:30 AM,14,6,13,2,2,37,2024-08-19T16:49:03.447Z
2024-08-19,12:30 PM,31,8,23,2,0,64,2024-08-19T17:58:56.237Z
2024-08-19,1:30 PM,11,10,23,3,0,47,2024-08-19T18:41:55.853Z
2024-08-19,2:30 PM,10,5,17,1,1,34,2024-08-19T19:37:41.506Z
2024-08-19,3:30 PM,16,2,8,2,2,30,2024-08-19T20:33:27.905Z
2024-08-19,4:30 PM,11,2,11,0,0,24,2024-08-19T21:37:56.714Z
2024-08-19,5:30 PM,9,2,7,0,2,20,2024-08-19T22:32:58.036Z
2024-08-19,6:30 PM,3,1,3,1,0,8,2024-08-19T23:33:56.694Z
2024-08-19,7:30 PM,2,0,1,1,1,5,2024-08-20T00:31:10.585Z
2024-08-19,8:30 PM,4,0,0,1,2,7,2024-08-20T01:34:03.212Z
2024-08-20,7:30 AM,5,0,1,0,0,6,2024-08-20T12:51:10.584Z
2024-08-20,8:30 AM,3,3,4,1,0,11,2024-08-20T13:32:44.986Z
2024-08-20,9:30 AM,6,2,11,1,0,20,2024-08-20T14:36:47.867Z
2024-08-20,10:30 AM,25,3,14,4,0,46,2024-08-20T15:44:28.602Z
2024-08-20,11:30 AM,14,7,23,0,0,44,2024-08-20T16:54:48.128Z
2024-08-20,12:30 PM,16,4,22,4,0,46,2024-08-20T17:48:34.973Z
2024-08-20,1:30 PM,13,5,12,7,0,37,2024-08-20T18:38:31.619Z
2024-08-20,2:30 PM,9,5,13,1,0,28,2024-08-20T19:34:01.295Z
2024-08-20,3:30 PM,8,5,13,2,2,30,2024-08-20T20:35:05.844Z
2024-08-20,4:30 PM,6,0,11,0,4,21,2024-08-20T21:36:22.939Z
2024-08-20,5:30 PM,9,3,5,1,0,18,2024-08-20T22:35:18.812Z
2024-08-20,6:30 PM,5,1,8,0,0,14,2024-08-20T23:35:32.416Z
2024-08-20,7:30 PM,2,0,3,0,2,7,2024-08-21T00:32:03.406Z
2024-08-20,8:30 PM,2,0,2,0,0,4,2024-08-21T01:40:56.434Z
2024-08-21,7:30 AM,4,0,3,0,0,7,2024-08-21T12:49:45.527Z
2024-08-21,8:30 AM,2,1,5,0,0,8,2024-08-21T13:33:29.977Z
2024-08-21,9:30 AM,10,5,7,0,0,22,2024-08-21T14:36:45.570Z
2024-08-21,10:30 AM,13,8,12,0,7,40,2024-08-21T15:31:32.164Z
2024-08-21,12:30 PM,13,11,20,5,0,49,2024-08-21T17:15:14.392Z
2024-08-21,12:30 PM,11,10,23,5,0,49,2024-08-21T17:53:53.492Z
2024-08-21,1:30 PM,10,3,20,5,0,38,2024-08-21T18:50:00.703Z
2024-08-21,2:30 PM,16,7,13,4,0,40,2024-08-21T19:38:43.298Z
2024-08-21,3:30 PM,10,8,8,4,2,32,2024-08-21T20:33:00.538Z
2024-08-21,4:30 PM,8,3,13,3,0,27,2024-08-21T21:33:24.904Z
2024-08-21,5:30 PM,9,4,8,2,0,23,2024-08-21T22:48:27.716Z
2024-08-21,6:30 PM,8,9,3,2,0,22,2024-08-21T23:43:01.316Z
2024-08-21,7:30 PM,6,0,3,2,0,11,2024-08-22T00:40:15.612Z
2024-08-21,8:30 PM,0,1,1,0,0,2,2024-08-22T01:35:10.332Z
2024-08-22,7:30 AM,9,0,1,0,0,10,2024-08-22T12:46:45.014Z
2024-08-22,8:30 AM,5,1,3,0,0,9,2024-08-22T13:32:44.305Z
2024-08-22,9:30 AM,11,4,13,1,0,29,2024-08-22T14:31:51.091Z
2024-08-22,10:30 AM,5,2,10,1,0,18,2024-08-22T16:06:25.709Z
2024-08-22,11:30 AM,11,4,17,6,0,38,2024-08-22T16:47:49.062Z
2024-08-22,12:30 PM,21,7,28,1,2,59,2024-08-22T17:49:42.889Z
2024-08-22,1:30 PM,12,5,17,3,0,37,2024-08-22T18:34:12.556Z
2024-08-22,2:30 PM,11,4,14,2,0,31,2024-08-22T19:42:28.596Z
2024-08-22,3:30 PM,12,5,19,2,3,41,2024-08-22T20:39:55.002Z
2024-08-22,4:30 PM,10,5,7,4,0,26,2024-08-22T21:39:38.210Z
2024-08-22,5:30 PM,12,0,10,3,0,25,2024-08-22T22:43:36.146Z
2024-08-22,6:30 PM,5,0,6,0,0,11,2024-08-22T23:46:58.774Z
2024-08-22,7:30 PM,6,0,5,2,0,13,2024-08-23T00:31:47.614Z
2024-08-22,7:30 PM,3,1,6,0,0,10,2024-08-23T00:43:17.405Z
2024-08-22,8:30 PM,2,0,2,0,0,4,2024-08-23T01:44:24.286Z
2024-08-23,7:30 AM,4,0,0,0,0,4,2024-08-23T13:26:19.556Z
2024-08-23,8:30 AM,4,1,3,0,0,8,2024-08-23T13:56:49.086Z
2024-08-23,9:30 AM,1,1,2,2,0,6,2024-08-23T14:30:40.291Z
2024-08-23,10:30 AM,4,1,3,2,0,10,2024-08-23T15:33:32.505Z
2024-08-23,11:30 AM,11,1,6,2,0,20,2024-08-23T16:33:04.696Z
2024-08-23,12:30 PM,11,1,5,4,0,21,2024-08-23T17:09:20.922Z
2024-08-23,1:30 PM,7,5,5,2,0,19,2024-08-23T18:36:02.527Z
2024-08-23,2:30 PM,4,1,7,3,0,15,2024-08-23T19:34:19.141Z
2024-08-23,3:30 PM,8,1,6,2,0,17,2024-08-23T20:44:48.848Z
2024-08-23,5:30 PM,1,1,5,2,0,9,2024-08-23T22:43:04.533Z
2024-08-23,6:30 PM,0,1,3,0,1,5,2024-08-23T23:43:22.064Z
2024-08-23,6:30 PM,0,1,4,2,0,7,2024-08-23T23:58:18.453Z
2024-08-24,10:30 AM,2,1,3,0,1,7,2024-08-24T15:33:48.136Z
2024-08-24,11:30 AM,3,1,4,0,1,9,2024-08-24T16:29:58.268Z
2024-08-24,12:30 PM,5,0,4,2,2,13,2024-08-24T17:42:44.454Z
2024-08-24,1:30 PM,3,1,5,0,2,11,2024-08-24T18:27:35.061Z
2024-08-24,2:30 PM,9,2,8,0,0,19,2024-08-24T19:31:08.937Z
2024-08-24,3:30 PM,6,0,5,0,2,13,2024-08-24T20:31:47.064Z
2024-08-24,4:30 PM,1,1,5,0,0,7,2024-08-24T21:34:58.285Z
2024-08-26,7:30 AM,8,0,2,0,0,10,2024-08-26T12:51:20.614Z
2024-08-26,8:30 AM,5,2,4,0,0,11,2024-08-26T13:35:20.073Z
2024-08-26,9:30 AM,11,6,6,0,0,23,2024-08-26T14:26:35.266Z
2024-08-26,10:30 AM,12,6,21,0,0,39,2024-08-26T15:31:08.647Z
2024-08-26,11:30 AM,12,7,17,4,0,40,2024-08-26T16:43:08.827Z
2024-08-26,12:30 PM,21,7,29,7,0,64,2024-08-26T17:34:50.914Z
2024-08-26,2:30 PM,14,7,20,4,0,45,2024-08-26T19:06:26.465Z
2024-08-26,2:30 PM,17,7,14,3,0,41,2024-08-26T19:47:32.381Z
2024-08-26,3:30 PM,8,6,9,3,5,31,2024-08-26T20:39:45.296Z
2024-08-26,4:30 PM,11,5,18,4,2,40,2024-08-26T21:37:56.692Z
2024-08-26,5:30 PM,8,3,12,3,2,28,2024-08-26T22:34:55.242Z
2024-08-26,6:30 PM,2,6,6,3,0,17,2024-08-26T23:34:52.071Z
2024-08-26,7:30 PM,1,3,3,1,2,10,2024-08-27T00:31:43.156Z
2024-08-27,7:30 AM,2,0,0,0,0,2,2024-08-27T12:41:54.299Z
2024-08-27,8:30 AM,4,2,2,1,0,9,2024-08-27T13:44:04.200Z
2024-08-27,9:30 AM,6,3,10,5,0,24,2024-08-27T14:31:58.226Z
2024-08-27,10:30 AM,6,8,21,4,3,42,2024-08-27T15:34:37.097Z
2024-08-27,11:30 AM,8,8,21,10,0,47,2024-08-27T16:57:39.605Z
2024-08-27,12:30 PM,16,8,24,3,0,51,2024-08-27T17:48:20.062Z
2024-08-27,1:30 PM,11,6,17,4,2,40,2024-08-27T18:33:46.051Z
2024-08-27,2:30 PM,7,6,16,4,0,33,2024-08-27T19:37:57.136Z
2024-08-27,3:30 PM,8,3,12,1,3,27,2024-08-27T20:42:23.225Z
2024-08-27,4:30 PM,6,3,10,1,0,20,2024-08-27T21:32:34.583Z
2024-08-27,5:30 PM,4,2,4,3,1,14,2024-08-27T22:32:27.661Z
2024-08-27,6:30 PM,5,3,8,1,0,17,2024-08-27T23:33:01.250Z
2024-08-27,7:30 PM,5,3,4,0,0,12,2024-08-28T00:32:19.680Z
2024-08-27,8:30 PM,9,1,0,0,0,10,2024-08-28T01:33:48.266Z
2024-08-28,7:30 AM,3,0,4,0,0,7,2024-08-28T13:06:29.189Z
2024-08-28,8:30 AM,3,5,4,0,0,12,2024-08-28T13:49:01.161Z
2024-08-28,9:30 AM,6,5,13,0,0,24,2024-08-28T14:34:39.019Z
2024-08-28,10:30 AM,8,7,18,3,1,37,2024-08-28T15:32:38.538Z
2024-08-28,11:30 AM,6,8,13,3,0,30,2024-08-28T16:38:17.524Z
2024-08-28,12:30 PM,8,9,16,4,2,39,2024-08-28T17:58:32.745Z
2024-08-28,1:30 PM,12,7,15,9,0,43,2024-08-28T18:35:19.771Z
2024-08-28,2:30 PM,8,5,14,4,0,31,2024-08-28T19:45:21.893Z
2024-08-28,3:30 PM,11,6,18,3,0,38,2024-08-28T20:35:15.533Z
2024-08-28,4:30 PM,8,3,17,3,0,31,2024-08-28T21:34:46.733Z
2024-08-28,5:30 PM,12,3,12,1,0,28,2024-08-28T22:45:39.485Z
2024-08-28,6:30 PM,5,3,11,1,2,22,2024-08-28T23:32:55.239Z
2024-08-28,7:30 PM,5,2,4,1,0,12,2024-08-29T00:38:40.375Z
2024-08-28,8:30 PM,3,0,1,0,0,4,2024-08-29T01:53:16.388Z
2024-08-29,7:30 AM,2,2,0,0,0,4,2024-08-29T12:43:08.077Z
2024-08-29,9:30 AM,4,3,6,0,2,15,2024-08-29T14:16:59.965Z
2024-08-29,9:30 AM,0,3,10,2,0,15,2024-08-29T14:46:06.084Z
2024-08-29,11:30 AM,7,8,16,5,0,36,2024-08-29T16:48:49.384Z
2024-08-29,12:30 PM,7,7,24,0,4,42,2024-08-29T17:42:00.075Z
2024-08-29,1:30 PM,8,8,19,0,0,35,2024-08-29T18:35:12.468Z
2024-08-29,2:30 PM,5,1,17,1,0,24,2024-08-29T19:44:42.368Z
2024-08-29,3:30 PM,5,1,12,3,2,23,2024-08-29T20:42:00.250Z
2024-08-29,4:30 PM,7,2,5,5,1,20,2024-08-29T21:36:51.513Z
2024-08-29,5:30 PM,8,3,8,2,0,21,2024-08-29T22:35:14.134Z
2024-08-29,6:30 PM,6,3,5,1,0,15,2024-08-29T23:31:45.683Z
2024-08-29,7:30 PM,5,1,8,1,0,15,2024-08-30T00:40:27.404Z
2024-08-29,8:30 PM,3,0,3,0,0,6,2024-08-30T01:34:20.680Z
2024-08-30,7:30 AM,5,0,2,0,0,7,2024-08-30T13:13:15.704Z
2024-08-30,8:30 AM,4,0,4,0,0,8,2024-08-30T13:50:17.732Z
2024-08-30,9:30 AM,1,0,0,0,0,1,2024-08-30T14:38:55.470Z
2024-08-30,10:30 AM,2,2,1,0,0,5,2024-08-30T16:01:06.672Z
2024-08-30,11:30 AM,8,1,5,0,0,14,2024-08-30T16:53:24.946Z
2024-08-30,12:30 PM,3,0,5,0,0,8,2024-08-30T17:40:14.538Z
2024-08-30,1:30 PM,6,0,8,3,2,19,2024-08-30T18:45:18.964Z
2024-08-30,2:30 PM,3,3,3,4,0,13,2024-08-30T19:37:36.005Z
2024-08-30,3:30 PM,4,4,3,2,0,13,2024-08-30T20:34:00.290Z
2024-08-30,4:30 PM,3,2,1,2,0,8,2024-08-30T21:31:27.248Z
2024-08-30,5:30 PM,3,2,1,1,1,8,2024-08-30T22:39:28.826Z
2024-08-30,6:30 PM,2,1,0,0,0,3,2024-08-30T23:57:30.030Z
2024-08-31,10:30 PM,1,0,0,0,1,2,2024-08-31T17:38:36.124Z
2024-08-31,11:30 PM,2,0,1,1,0,4,2024-08-31T17:39:30.134Z
2024-08-31,12:30 PM,2,1,2,1,0,6,2024-08-31T17:41:25.799Z
2024-08-31,1:30 PM,1,1,2,1,0,5,2024-08-31T18:27:19.301Z
2024-08-31,2:30 PM,3,1,4,1,0,9,2024-08-31T19:35:24.595Z
2024-08-31,3:30 PM,4,1,3,0,0,8,2024-08-31T20:31:45.429Z
2024-08-31,4:30 PM,4,2,1,0,0,7,2024-08-31T21:33:37.906Z
2024-09-04,7:30 AM,8,0,3,0,0,11,2024-09-04T13:01:19.586Z
2024-09-04,8:30 AM,4,0,7,0,0,11,2024-09-04T13:31:01.015Z
2024-09-04,9:30 AM,8,4,7,0,0,19,2024-09-04T14:30:45.200Z
2024-09-04,10:30 AM,30,5,14,1,0,50,2024-09-04T15:32:05.386Z
2024-09-04,11:30 AM,23,7,20,12,0,62,2024-09-04T16:34:56.590Z
2024-09-04,12:30 PM,16,10,31,1,3,61,2024-09-04T17:36:00.822Z
2024-09-04,1:30 PM,11,7,30,3,0,51,2024-09-04T18:31:18.178Z
2024-09-04,2:30 PM,14,8,17,5,0,44,2024-09-04T19:40:01.122Z
2024-09-04,3:30 PM,10,9,19,5,2,45,2024-09-04T20:29:17.010Z
2024-09-04,4:30 PM,11,8,13,2,0,34,2024-09-04T21:31:13.838Z
2024-09-04,5:30 PM,6,2,11,1,0,20,2024-09-04T22:36:16.528Z
2024-09-04,6:30 PM,3,2,6,2,0,13,2024-09-04T23:37:17.038Z
2024-09-04,8:30 PM,2,1,7,0,0,10,2024-09-05T01:41:44.323Z
2024-09-05,7:30 AM,6,0,1,1,0,8,2024-09-05T13:04:19.904Z
2024-09-05,8:30 AM,1,1,4,1,0,7,2024-09-05T13:29:27.914Z
2024-09-05,9:30 AM,10,1,11,2,0,24,2024-09-05T14:35:58.745Z
2024-09-05,10:30 AM,7,6,10,4,0,27,2024-09-05T15:26:56.795Z
2024-09-05,11:30 AM,6,6,22,0,0,34,2024-09-05T16:41:19.725Z
2024-09-05,12:30 PM,14,10,39,5,2,70,2024-09-05T17:40:49.980Z
2024-09-05,1:30 PM,11,8,21,4,1,45,2024-09-05T18:31:12.175Z
2024-09-05,2:30 PM,10,7,14,4,0,35,2024-09-05T19:33:28.513Z
2024-09-05,3:30 PM,9,7,15,4,1,36,2024-09-05T20:40:30.286Z
2024-09-05,4:30 PM,7,2,12,3,1,25,2024-09-05T21:31:46.015Z
2024-09-05,5:30 PM,6,1,8,5,1,21,2024-09-05T22:38:58.166Z
2024-09-05,6:30 PM,6,0,4,2,0,12,2024-09-05T23:38:50.713Z
2024-09-05,7:30 PM,7,1,3,1,0,12,2024-09-06T00:29:44.802Z
2024-09-06,7:30 AM,1,0,0,0,0,1,2024-09-06T12:40:37.465Z
2024-09-06,8:30 AM,2,1,0,0,0,3,2024-09-06T13:30:22.565Z
2024-09-06,9:30 AM,4,2,1,0,0,7,2024-09-06T14:25:31.194Z
2024-09-06,10:30 AM,4,2,1,0,0,7,2024-09-06T15:28:15.368Z
2024-09-06,11:30 AM,5,0,2,0,0,7,2024-09-06T16:51:09.712Z
2024-09-06,12:30 PM,7,0,5,0,0,12,2024-09-06T17:34:10.141Z
2024-09-06,1:30 PM,6,0,3,0,0,9,2024-09-06T18:31:57.628Z
2024-09-06,2:30 PM,2,1,3,0,0,6,2024-09-06T19:33:29.301Z
2024-09-06,3:30 PM,2,2,5,0,0,9,2024-09-06T20:34:36.444Z
2024-09-06,4:30 PM,2,4,3,0,0,9,2024-09-06T21:31:02.227Z
2024-09-06,5:30 PM,4,1,2,0,0,7,2024-09-06T22:29:45.479Z
2024-09-06,6:30 PM,3,0,2,1,1,7,2024-09-06T23:32:05.612Z
2024-09-07,10:30 AM,2,0,1,0,0,3,2024-09-07T15:28:56.027Z
2024-09-07,11:30 AM,2,1,3,0,1,7,2024-09-07T16:29:11.733Z
2024-09-07,12:30 PM,1,1,5,0,3,10,2024-09-07T17:28:13.998Z
2024-09-07,1:30 PM,5,1,3,1,0,10,2024-09-07T18:52:22.009Z
2024-09-07,2:30 PM,1,2,5,1,0,9,2024-09-07T19:41:32.761Z
2024-09-07,3:30 PM,5,0,4,2,2,13,2024-09-07T20:34:24.834Z
2024-09-09,7:30 AM,6,0,4,0,0,10,2024-09-09T12:52:03.443Z
2024-09-09,8:30 AM,3,3,6,0,0,12,2024-09-09T13:35:12.588Z
2024-09-09,9:30 AM,8,4,10,2,0,24,2024-09-09T14:40:57.830Z
2024-09-09,10:30 AM,12,6,18,4,3,43,2024-09-09T15:32:32.171Z
2024-09-09,11:30 AM,8,7,17,2,0,34,2024-09-09T16:45:03.790Z
2024-09-09,12:30 PM,14,6,25,2,7,54,2024-09-09T17:43:08.940Z
2024-09-09,1:30 PM,11,4,23,2,0,40,2024-09-09T18:32:57.620Z
2024-09-09,2:30 PM,7,10,14,5,0,36,2024-09-09T19:36:41.922Z
2024-09-09,3:30 PM,7,7,15,4,1,34,2024-09-09T20:41:02.052Z
2024-09-09,4:30 PM,5,2,12,2,1,22,2024-09-09T21:29:05.804Z
2024-09-09,5:30 PM,4,3,14,8,1,30,2024-09-09T22:29:48.383Z
2024-09-09,6:30 PM,2,2,8,0,0,12,2024-09-09T23:31:13.338Z
2024-09-09,8:30 PM,1,2,2,0,0,5,2024-09-10T01:45:34.768Z
2024-09-10,7:30 AM,4,0,6,3,0,13,2024-09-10T13:11:09.256Z
2024-09-10,8:30 AM,6,0,2,1,0,9,2024-09-10T13:13:45.600Z
2024-09-10,9:30 AM,10,6,12,6,2,36,2024-09-10T15:41:19.747Z
2024-09-10,10:30 AM,11,6,11,2,1,31,2024-09-10T15:43:17.007Z
2024-09-10,11:30 AM,12,9,14,5,0,40,2024-09-10T16:33:49.632Z
2024-09-10,12:30 PM,14,11,49,5,0,79,2024-09-10T17:33:52.977Z
2024-09-10,1:30 PM,10,6,20,4,0,40,2024-09-10T18:36:39.057Z
2024-09-10,2:30 PM,12,7,17,5,0,41,2024-09-10T19:31:53.233Z
2024-09-10,3:30 PM,8,5,13,1,1,28,2024-09-10T20:37:17.054Z
2024-09-10,4:30 PM,7,4,17,2,0,30,2024-09-10T21:35:19.298Z
2024-09-10,5:30 PM,5,1,11,3,0,20,2024-09-10T22:28:25.966Z
2024-09-10,6:30 PM,1,3,5,1,0,10,2024-09-10T23:30:12.707Z
2024-09-10,7:30 PM,3,5,3,4,0,15,2024-09-11T00:31:36.089Z
2024-09-10,8:30 PM,2,2,3,2,0,9,2024-09-11T01:44:51.951Z
2024-09-11,7:30 AM,2,0,3,1,0,6,2024-09-11T12:47:42.282Z
2024-09-11,8:30 AM,3,1,5,2,0,11,2024-09-11T13:33:24.613Z
2024-09-11,9:30 AM,4,6,5,0,3,18,2024-09-11T14:37:29.417Z
2024-09-11,10:30 AM,5,9,14,0,0,28,2024-09-11T15:26:14.734Z
2024-09-11,11:30 AM,8,7,19,3,0,37,2024-09-11T16:59:43.128Z
2024-09-11,12:30 PM,6,5,18,4,0,33,2024-09-11T17:58:14.788Z
2024-09-11,1:30 PM,7,7,20,4,1,39,2024-09-11T18:44:32.536Z
2024-09-11,2:30 PM,11,9,15,4,0,39,2024-09-11T19:35:12.815Z
2024-09-11,3:30 PM,8,8,11,4,1,32,2024-09-11T20:38:59.921Z
2024-09-11,4:30 PM,10,7,17,4,0,38,2024-09-11T21:39:30.788Z
2024-09-11,5:30 PM,9,4,16,4,0,33,2024-09-11T22:34:18.835Z
2024-09-11,6:30 PM,4,4,6,2,0,16,2024-09-11T23:41:06.148Z
2024-09-11,7:30 PM,5,6,2,2,0,15,2024-09-12T00:44:24.358Z
2024-09-12,7:30 AM,4,0,0,0,0,4,2024-09-12T12:45:58.559Z
2024-09-12,8:30 AM,6,1,7,0,0,14,2024-09-12T13:29:01.889Z
2024-09-12,9:30 AM,8,3,7,2,0,20,2024-09-12T14:36:53.764Z
2024-09-12,10:30 AM,7,7,11,4,0,29,2024-09-12T15:30:44.199Z
2024-09-12,11:30 AM,5,9,17,4,1,36,2024-09-12T16:44:21.801Z
2024-09-12,12:30 PM,19,8,30,8,3,68,2024-09-12T17:37:14.804Z
2024-09-12,1:30 PM,4,5,8,5,0,22,2024-09-12T18:36:26.765Z
2024-09-12,2:30 PM,3,4,17,6,1,31,2024-09-12T19:42:28.229Z
2024-09-12,3:30 PM,11,4,14,4,1,34,2024-09-12T20:57:21.775Z
2024-09-12,4:30 PM,5,3,14,4,0,26,2024-09-12T21:31:14.833Z
2024-09-12,5:30 PM,4,2,8,5,2,21,2024-09-12T22:44:17.437Z
2024-09-12,6:30 PM,6,3,8,4,0,21,2024-09-12T23:30:15.998Z
2024-09-13,7:30 AM,4,0,0,0,0,4,2024-09-13T12:58:59.495Z
2024-09-13,8:30 AM,2,0,1,0,0,3,2024-09-13T13:35:14.533Z
2024-09-13,9:30 AM,3,0,2,0,0,5,2024-09-13T14:35:23.584Z
2024-09-13,10:30 AM,3,2,3,0,0,8,2024-09-13T15:35:06.771Z
2024-09-13,11:30 AM,7,1,9,0,0,17,2024-09-13T16:35:01.343Z
2024-09-13,12:30 PM,8,1,14,1,0,24,2024-09-13T17:38:14.658Z
2024-09-13,1:30 PM,6,3,9,1,1,20,2024-09-13T18:34:58.559Z
2024-09-13,2:30 PM,8,3,9,1,2,23,2024-09-13T19:33:50.524Z
2024-09-13,3:30 PM,10,2,8,0,1,21,2024-09-13T20:32:37.884Z
2024-09-13,4:30 PM,2,1,8,1,0,12,2024-09-13T21:26:39.736Z
2024-09-13,5:30 PM,3,1,2,1,0,7,2024-09-13T22:39:34.927Z
2024-09-13,6:30 PM,1,0,2,0,0,3,2024-09-13T23:32:43.315Z
2024-09-14,10:30 AM,3,0,2,1,0,6,2024-09-14T15:30:27.250Z
2024-09-14,11:30 AM,1,0,2,1,0,4,2024-09-14T16:31:07.037Z
2024-09-14,12:30 PM,3,1,3,1,0,8,2024-09-14T17:28:09.091Z
2024-09-14,1:30 PM,5,3,3,1,0,12,2024-09-14T18:28:06.400Z
2024-09-14,2:30 PM,9,1,10,0,0,20,2024-09-14T19:40:14.418Z
2024-09-14,3:30 PM,3,0,6,1,0,10,2024-09-14T20:32:12.915Z
2024-09-14,4:30 PM,3,1,5,0,0,9,2024-09-14T21:38:49.412Z
2024-09-16,7:30 AM,8,0,2,0,1,11,2024-09-16T12:46:06.152Z
2024-09-16,8:30 AM,4,2,8,0,0,14,2024-09-16T13:32:28.990Z
2024-09-16,9:30 AM,4,3,13,2,1,23,2024-09-16T15:02:35.042Z
2024-09-16,10:30 AM,8,5,11,0,1,25,2024-09-16T15:32:58.512Z
2024-09-16,11:30 AM,5,9,22,1,0,37,2024-09-16T16:36:10.672Z
2024-09-16,12:30 PM,24,6,23,7,3,63,2024-09-16T17:36:54.125Z
2024-09-16,1:30 PM,8,6,18,8,1,41,2024-09-16T18:33:51.091Z
2024-09-16,2:30 PM,10,4,21,3,0,38,2024-09-16T19:41:22.107Z
2024-09-16,3:30 PM,8,4,17,5,0,34,2024-09-16T20:33:23.787Z
2024-09-16,4:30 PM,6,4,13,2,1,26,2024-09-16T21:29:39.205Z
2024-09-16,5:30 PM,5,3,13,1,1,23,2024-09-16T22:29:50.299Z
2024-09-16,6:30 PM,7,2,4,1,0,14,2024-09-16T23:33:28.718Z
2024-09-16,7:30 PM,6,1,4,0,0,11,2024-09-17T00:45:42.772Z
2024-09-17,8:30 AM,6,1,4,0,0,11,2024-09-17T13:41:58.812Z
2024-09-17,9:30 AM,6,4,11,3,0,24,2024-09-17T14:31:02.137Z
2024-09-17,10:30 AM,8,6,10,5,0,29,2024-09-17T15:35:38.434Z
2024-09-17,11:30 AM,9,11,21,6,0,47,2024-09-17T16:35:27.015Z
2024-09-17,12:30 PM,15,8,28,2,1,54,2024-09-17T17:41:30.374Z
2024-09-17,1:30 PM,9,5,23,7,0,44,2024-09-17T18:34:32.391Z
2024-09-17,2:30 PM,7,4,15,3,0,29,2024-09-17T19:36:25.289Z
2024-09-17,3:30 PM,9,5,16,7,0,37,2024-09-17T20:33:45.013Z
2024-09-17,4:30 PM,9,3,10,1,0,23,2024-09-17T21:50:54.532Z
2024-09-17,5:30 PM,6,4,8,1,0,19,2024-09-17T22:32:08.108Z
2024-09-17,6:30 PM,3,3,8,2,0,16,2024-09-17T23:33:44.718Z
2024-09-17,7:30 PM,5,2,5,3,0,15,2024-09-18T00:46:02.042Z
2024-09-18,7:30 AM,5,0,3,0,0,8,2024-09-18T13:02:58.033Z
2024-09-18,8:30 AM,4,2,6,1,0,13,2024-09-18T13:31:51.899Z
2024-09-18,9:30 AM,7,4,5,2,0,18,2024-09-18T14:38:08.924Z
2024-09-18,10:30 AM,13,6,19,3,2,43,2024-09-18T15:31:23.269Z
2024-09-18,11:30 AM,20,8,10,11,1,50,2024-09-18T16:34:29.914Z
2024-09-18,12:30 PM,18,6,20,10,2,56,2024-09-18T17:41:03.801Z
2024-09-18,1:30 PM,21,8,21,15,3,68,2024-09-18T18:35:11.989Z
2024-09-18,2:30 PM,13,8,18,7,0,46,2024-09-18T19:34:36.546Z
2024-09-18,3:30 PM,13,10,15,4,2,44,2024-09-18T20:35:38.226Z
2024-09-18,4:30 PM,8,2,6,2,0,18,2024-09-18T21:32:27.436Z
2024-09-18,5:30 PM,5,6,7,5,0,23,2024-09-18T22:28:50.659Z
2024-09-18,6:30 PM,3,5,5,2,0,15,2024-09-18T23:42:13.095Z
2024-09-18,7:30 PM,5,5,9,5,0,24,2024-09-19T00:45:45.126Z
2024-09-18,8:30 PM,2,2,3,2,0,9,2024-09-19T01:25:35.799Z
2024-09-19,7:30 AM,1,0,0,0,0,1,2024-09-19T12:35:36.873Z
2024-09-19,8:30 AM,8,3,11,2,2,26,2024-09-19T14:20:28.853Z
2024-09-19,9:30 AM,5,2,6,0,0,13,2024-09-19T14:33:14.839Z
2024-09-19,10:30 AM,10,5,7,5,0,27,2024-09-19T15:34:35.384Z
2024-09-19,11:30 AM,14,7,13,13,1,48,2024-09-19T16:41:36.826Z
2024-09-19,12:30 PM,16,6,22,9,0,53,2024-09-19T17:34:27.165Z
2024-09-19,1:30 PM,20,6,27,8,2,63,2024-09-19T18:35:39.113Z
2024-09-19,2:30 PM,6,6,14,3,4,33,2024-09-19T19:31:35.563Z
2024-09-19,3:30 PM,9,5,19,5,0,38,2024-09-19T20:45:43.599Z
2024-09-19,4:30 PM,5,4,15,2,1,27,2024-09-19T21:30:41.525Z
2024-09-19,5:30 PM,4,2,8,5,0,19,2024-09-19T22:36:34.179Z
2024-09-19,6:30 PM,8,3,2,5,0,18,2024-09-19T23:32:31.960Z
2024-09-19,7:30 PM,5,0,1,1,0,7,2024-09-20T00:50:47.667Z
2024-09-19,8:30 PM,2,0,0,0,0,2,2024-09-20T01:50:07.112Z
2024-09-20,7:30 AM,1,0,0,0,0,1,2024-09-20T12:35:19.790Z
2024-09-20,8:30 AM,4,1,0,0,0,5,2024-09-20T13:43:14.203Z
2024-09-20,9:30 AM,4,2,2,0,0,8,2024-09-20T14:31:54.462Z
2024-09-20,10:30 AM,3,1,2,0,0,6,2024-09-20T15:35:16.584Z
2024-09-20,11:30 AM,9,3,1,4,3,20,2024-09-20T16:37:59.753Z
2024-09-20,12:30 PM,4,2,5,4,1,16,2024-09-20T17:32:46.793Z
2024-09-20,1:30 PM,7,4,6,2,0,19,2024-09-20T18:35:40.060Z
2024-09-20,2:30 PM,4,2,6,2,2,16,2024-09-20T19:34:23.303Z
2024-09-20,3:30 PM,3,1,6,3,0,13,2024-09-20T20:37:16.292Z
2024-09-20,4:30 PM,3,2,5,0,0,10,2024-09-20T21:45:10.585Z
2024-09-20,5:30 PM,1,2,3,0,0,6,2024-09-20T22:52:01.252Z
2024-09-20,6:30 PM,3,2,0,0,0,5,2024-09-20T23:25:56.867Z
2024-09-21,10:30 AM,1,1,3,0,0,5,2024-09-21T15:29:35.582Z
2024-09-21,11:30 AM,3,1,4,0,0,8,2024-09-21T16:28:00.915Z
2024-09-21,12:30 PM,3,2,3,1,0,9,2024-09-21T17:33:28.759Z
2024-09-21,1:30 PM,3,5,4,3,0,15,2024-09-21T18:37:25.002Z
2024-09-21,2:30 PM,5,7,5,2,0,19,2024-09-21T19:37:17.603Z
2024-09-21,3:30 PM,5,5,3,2,0,15,2024-09-21T20:36:39.163Z
2024-09-21,4:30 PM,5,2,2,1,0,10,2024-09-21T21:57:51.110Z
2024-09-23,7:30 AM,6,0,1,0,0,7,2024-09-23T12:41:55.142Z
2024-09-23,8:30 AM,7,2,11,0,0,20,2024-09-23T13:29:17.919Z
2024-09-23,9:30 AM,8,4,14,2,0,28,2024-09-23T15:01:59.127Z
2024-09-23,10:30 AM,18,5,20,1,0,44,2024-09-23T15:45:27.158Z
2024-09-23,11:30 AM,13,4,16,6,2,41,2024-09-23T16:34:21.098Z
2024-09-23,12:30 PM,21,11,24,7,1,64,2024-09-23T17:36:31.772Z
2024-09-23,1:30 PM,15,6,22,12,2,57,2024-09-23T18:36:09.872Z
2024-09-23,2:30 PM,11,5,16,9,3,44,2024-09-23T19:31:00.310Z
2024-09-23,3:30 PM,11,3,22,4,2,42,2024-09-23T21:03:47.106Z
2024-09-23,4:30 PM,14,2,21,3,3,43,2024-09-23T21:31:44.831Z
2024-09-23,5:30 PM,7,6,7,5,0,25,2024-09-23T22:28:09.398Z
2024-09-23,6:30 PM,5,3,6,0,0,14,2024-09-23T23:28:07.252Z
2024-09-23,7:30 PM,3,1,5,0,3,12,2024-09-24T00:31:30.933Z
2024-09-23,8:30 PM,2,1,5,1,0,9,2024-09-24T01:31:29.656Z
2024-09-24,7:30 AM,16,2,5,1,4,28,2024-09-24T13:11:27.980Z
2024-09-24,8:30 AM,18,4,17,1,5,45,2024-09-24T14:11:25.769Z
2024-09-24,9:30 AM,2,5,10,3,0,20,2024-09-24T14:34:19.014Z
2024-09-24,10:30 AM,10,3,15,0,0,28,2024-09-24T15:30:47.950Z
2024-09-24,11:30 AM,8,12,25,4,0,49,2024-09-24T16:53:55.496Z
2024-09-24,12:30 PM,15,10,40,1,3,69,2024-09-24T17:41:16.412Z
2024-09-24,1:30 PM,11,8,20,5,1,45,2024-09-24T18:38:57.111Z
2024-09-24,2:30 PM,7,8,14,4,0,33,2024-09-24T19:40:43.685Z
2024-09-24,3:30 PM,10,6,14,4,0,34,2024-09-24T20:28:00.568Z
2024-09-24,4:30 PM,12,3,6,2,0,23,2024-09-24T21:42:43.713Z
2024-09-24,5:30 PM,4,5,8,0,0,17,2024-09-24T22:28:13.017Z
2024-09-24,6:30 PM,13,4,5,1,4,27,2024-09-24T23:29:56.419Z
2024-09-24,8:30 PM,9,2,4,0,0,15,2024-09-25T01:45:18.701Z
2024-09-25,7:30 AM,3,0,0,0,0,3,2024-09-25T12:34:05.076Z
2024-09-25,8:30 AM,7,3,4,0,0,14,2024-09-25T13:43:05.857Z
2024-09-25,9:30 AM,10,4,4,3,0,21,2024-09-25T14:33:34.656Z
2024-09-25,10:30 AM,16,6,16,2,0,40,2024-09-25T15:56:53.826Z
2024-09-25,11:30 AM,11,8,20,4,2,45,2024-09-25T16:43:01.168Z
2024-09-25,12:30 PM,14,8,29,6,2,59,2024-09-25T17:40:27.111Z
2024-09-25,1:30 PM,13,5,17,10,1,46,2024-09-25T18:33:48.927Z
2024-09-25,2:30 PM,14,8,17,2,2,43,2024-09-25T19:39:58.956Z
2024-09-25,3:30 PM,3,6,16,6,0,31,2024-09-25T20:29:07.689Z
2024-09-25,4:30 PM,3,7,18,3,0,31,2024-09-25T21:30:24.602Z
2024-09-25,5:30 PM,5,5,16,1,0,27,2024-09-25T22:29:15.302Z
2024-09-25,6:30 PM,4,6,4,5,0,19,2024-09-25T23:35:16.673Z
2024-09-25,7:30 PM,1,4,8,1,0,14,2024-09-26T00:44:31.887Z
2024-09-26,7:30 AM,1,1,0,0,0,2,2024-09-26T12:34:25.237Z
2024-09-26,8:30 AM,3,1,3,1,0,8,2024-09-26T13:35:21.989Z
2024-09-26,9:30 AM,4,1,7,4,0,16,2024-09-26T14:30:41.375Z
2024-09-26,10:30 AM,10,5,11,4,0,30,2024-09-26T15:45:34.747Z
2024-09-26,12:30 PM,25,7,26,5,0,63,2024-09-26T17:33:09.516Z
2024-09-26,1:30 PM,11,4,20,4,1,40,2024-09-26T18:40:14.818Z
2024-09-26,2:30 PM,7,5,8,1,0,21,2024-09-26T19:33:32.824Z
2024-09-26,3:30 PM,7,1,7,4,2,21,2024-09-26T20:29:14.197Z
2024-09-26,4:30 PM,6,5,9,0,3,23,2024-09-26T21:27:47.037Z
2024-09-26,5:30 PM,4,4,9,3,0,20,2024-09-26T22:27:40.575Z
2024-09-26,6:30 PM,5,1,3,0,0,9,2024-09-26T23:34:01.990Z
2024-09-26,7:30 PM,3,1,4,2,0,10,2024-09-27T00:33:12.889Z
2024-09-26,8:30 PM,3,1,3,1,0,8,2024-09-27T01:36:02.018Z
2024-09-27,7:30 AM,4,0,0,0,0,4,2024-09-27T13:10:41.251Z
2024-09-27,8:30 AM,1,0,0,0,1,2,2024-09-27T13:43:38.075Z
2024-09-27,9:30 AM,2,0,1,1,0,4,2024-09-27T14:29:18.880Z
2024-09-27,10:30 AM,4,0,6,3,1,14,2024-09-27T15:31:18.726Z
2024-09-27,11:30 AM,5,2,4,1,0,12,2024-09-27T16:34:12.278Z
2024-09-27,12:30 PM,4,1,3,3,0,11,2024-09-27T17:37:06.966Z
2024-09-27,1:30 PM,4,2,4,3,1,14,2024-09-27T18:32:44.753Z
2024-09-27,2:30 PM,3,2,3,3,0,11,2024-09-27T19:32:34.283Z
2024-09-27,3:30 PM,3,3,3,2,0,11,2024-09-27T20:28:05.947Z
2024-09-27,4:30 PM,5,2,1,0,0,8,2024-09-27T21:30:52.934Z
2024-09-27,5:30 PM,3,2,0,0,0,5,2024-09-27T22:29:55.053Z
2024-09-27,6:30 PM,1,1,0,0,0,2,2024-09-27T23:33:24.102Z
2024-09-28,10:30 AM,2,1,0,0,0,3,2024-09-28T15:29:25.264Z
2024-09-28,11:30 AM,3,0,0,0,0,3,2024-09-28T16:33:21.636Z
2024-09-28,12:30 PM,2,0,6,0,0,8,2024-09-28T17:29:37.847Z
2024-09-28,1:30 PM,3,1,4,0,0,8,2024-09-28T18:29:08.709Z
2024-09-28,2:30 PM,2,0,0,0,1,3,2024-09-28T19:56:18.068Z
2024-09-28,3:30 PM,1,0,3,2,0,6,2024-09-28T20:44:21.785Z
2024-09-30,7:30 AM,2,0,0,0,0,2,2024-09-30T12:34:41.618Z
2024-09-30,8:30 AM,7,2,8,0,0,17,2024-09-30T13:41:06.080Z
2024-09-30,9:30 AM,5,5,7,1,0,18,2024-09-30T14:29:35.214Z
2024-09-30,11:30 AM,7,5,17,4,0,33,2024-09-30T16:37:55.780Z
2024-09-30,12:30 PM,24,6,21,9,3,63,2024-09-30T17:34:15.953Z
2024-09-30,1:30 PM,14,7,17,8,4,50,2024-09-30T18:29:18.528Z
2024-09-30,2:30 PM,12,8,22,5,1,48,2024-09-30T19:40:09.688Z
2024-09-30,3:30 PM,10,5,18,4,4,41,2024-09-30T20:31:56.506Z
2024-09-30,4:30 PM,7,8,17,0,0,32,2024-09-30T21:31:57.432Z
2024-09-30,5:30 PM,6,3,15,0,0,24,2024-09-30T22:30:20.691Z
2024-09-30,6:30 PM,7,2,8,0,1,18,2024-09-30T23:25:31.189Z
2024-09-30,7:30 PM,6,2,4,1,0,13,2024-10-01T00:28:31.821Z
2024-09-30,8:30 PM,3,0,3,1,0,7,2024-10-01T01:32:29.281Z
2024-10-01,7:30 AM,0,0,0,0,0,0,2024-10-01T12:31:52.794Z
2024-10-01,10:30 AM,10,5,11,4,0,30,2024-10-01T16:04:55.950Z
2024-10-01,12:30 PM,8,10,20,8,1,47,2024-10-01T17:10:08.732Z
2024-10-01,12:30 PM,11,7,25,10,3,56,2024-10-01T17:36:43.591Z
2024-10-01,1:30 PM,7,2,15,6,3,33,2024-10-01T18:47:58.932Z
2024-10-01,2:30 PM,8,4,12,5,0,29,2024-10-01T19:37:15.711Z
2024-10-01,3:30 PM,11,4,9,2,1,27,2024-10-01T20:28:37.628Z
2024-10-01,4:30 PM,8,2,7,2,2,21,2024-10-01T21:44:26.472Z
2024-10-01,5:30 PM,6,1,7,3,1,18,2024-10-01T22:30:16.823Z
2024-10-01,6:30 PM,6,0,3,2,1,12,2024-10-01T23:30:46.877Z
2024-10-01,7:30 PM,5,0,2,4,0,11,2024-10-02T00:33:08.197Z
2024-10-01,8:30 PM,4,0,3,0,0,7,2024-10-02T01:28:02.516Z
2024-10-02,7:30 AM,0,0,1,0,0,1,2024-10-02T12:39:01.851Z
2024-10-02,8:30 AM,6,2,6,2,1,17,2024-10-02T13:35:05.474Z
2024-10-02,9:30 AM,4,3,7,2,0,16,2024-10-02T14:36:14.976Z
2024-10-02,10:30 AM,7,3,10,1,0,21,2024-10-02T15:32:59.334Z
2024-10-02,11:30 AM,7,5,14,2,0,28,2024-10-02T16:36:17.394Z
2024-10-02,12:30 PM,12,7,25,5,0,49,2024-10-02T17:48:38.571Z
2024-10-02,1:30 PM,11,4,14,8,3,40,2024-10-02T18:42:29.013Z
2024-10-02,2:30 PM,10,4,17,5,2,38,2024-10-02T19:38:45.748Z
2024-10-02,3:30 PM,10,3,13,5,0,31,2024-10-02T20:30:15.266Z
2024-10-02,4:30 PM,4,4,12,3,0,23,2024-10-02T21:31:26.201Z
2024-10-02,5:30 PM,7,5,11,3,0,26,2024-10-02T22:27:32.434Z
2024-10-02,6:30 PM,4,2,6,1,0,13,2024-10-02T23:59:40.334Z
2024-10-02,7:30 PM,0,2,3,2,0,7,2024-10-03T00:34:32.859Z
2024-10-03,7:30 AM,3,0,0,0,0,3,2024-10-03T12:36:22.941Z
2024-10-03,8:30 AM,6,2,7,2,0,17,2024-10-03T14:35:51.879Z
2024-10-03,9:30 AM,3,3,9,3,0,18,2024-10-03T14:37:50.423Z
2024-10-03,10:30 AM,4,9,10,3,0,26,2024-10-03T15:30:26.784Z
2024-10-03,11:30 AM,10,12,17,3,0,42,2024-10-03T16:41:58.691Z
2024-10-03,12:30 PM,15,7,28,5,3,58,2024-10-03T17:43:59.688Z
2024-10-03,1:30 PM,12,6,18,3,1,40,2024-10-03T18:32:50.323Z
2024-10-03,2:30 PM,9,7,14,9,1,40,2024-10-03T19:51:16.885Z
2024-10-03,3:30 PM,11,5,12,6,1,35,2024-10-03T20:36:32.716Z
2024-10-03,4:30 PM,7,5,14,2,0,28,2024-10-03T21:30:51.739Z
2024-10-03,5:30 PM,8,6,10,4,0,28,2024-10-03T22:36:53.566Z
2024-10-03,6:30 PM,5,3,7,1,0,16,2024-10-03T23:33:30.302Z
2024-10-03,7:30 PM,4,2,3,3,0,12,2024-10-04T00:33:19.705Z
2024-10-03,8:30 PM,3,1,0,1,0,5,2024-10-04T01:44:17.505Z
2024-10-04,7:30 AM,3,0,2,0,0,5,2024-10-04T13:03:06.026Z
2024-10-04,8:30 AM,1,0,1,0,0,2,2024-10-04T13:36:26.611Z
2024-10-04,9:30 AM,4,0,3,0,0,7,2024-10-04T14:41:33.178Z
2024-10-04,11:30 AM,3,0,5,1,1,10,2024-10-04T16:27:19.459Z
2024-10-04,10:30 AM,2,0,4,1,0,7,2024-10-04T16:27:58.324Z
2024-10-04,12:30 PM,3,0,5,4,1,13,2024-10-04T17:36:47.261Z
2024-10-04,1:30 PM,3,0,2,4,0,9,2024-10-04T19:36:29.431Z
2024-10-04,2:30 PM,2,0,2,1,0,5,2024-10-04T19:36:47.414Z
2024-10-04,3:30 PM,2,0,2,0,0,4,2024-10-04T20:41:44.288Z
2024-10-04,4:30 PM,2,1,2,0,0,5,2024-10-04T21:28:36.789Z
2024-10-04,5:30 PM,2,1,1,0,0,4,2024-10-04T22:39:13.186Z
2024-10-04,6:30 PM,3,1,0,0,0,4,2024-10-04T23:24:49.054Z
2024-10-05,10:30 AM,4,1,1,1,0,7,2024-10-05T15:26:20.749Z
2024-10-05,11:30 AM,2,2,3,1,0,8,2024-10-05T16:35:10.131Z
2024-10-05,12:30 PM,3,2,2,1,0,8,2024-10-05T17:28:16.009Z
2024-10-05,1:30 PM,3,2,2,0,0,7,2024-10-05T18:29:51.480Z
2024-10-05,2:30 PM,6,4,1,0,0,11,2024-10-05T19:37:14.923Z
2024-10-05,3:30 PM,3,3,1,0,0,7,2024-10-05T20:37:12.774Z
2024-10-05,4:30 PM,2,2,2,0,0,6,2024-10-05T21:37:00.426Z
2024-10-07,7:30 AM,2,0,3,1,0,6,2024-10-07T12:50:03.358Z
2024-10-07,8:30 AM,4,4,8,4,0,20,2024-10-07T13:37:39.792Z
2024-10-07,9:30 AM,7,6,12,3,1,29,2024-10-07T14:34:22.244Z
2024-10-07,10:30 AM,11,4,13,1,0,29,2024-10-07T15:31:36.886Z
2024-10-07,11:30 AM,9,8,12,1,0,30,2024-10-07T16:29:13.710Z
2024-10-07,12:30 PM,16,10,19,10,0,55,2024-10-07T17:32:43.460Z
2024-10-07,1:30 PM,14,7,19,10,2,52,2024-10-07T18:35:05.920Z
2024-10-07,2:30 PM,8,9,13,4,0,34,2024-10-07T19:41:44.470Z
2024-10-07,3:30 PM,7,8,16,3,0,34,2024-10-07T20:29:07.389Z
2024-10-07,4:30 PM,8,2,12,2,1,25,2024-10-07T21:30:06.312Z
2024-10-07,5:30 PM,9,5,6,2,0,22,2024-10-07T22:28:27.484Z
2024-10-07,6:30 PM,4,3,5,0,1,13,2024-10-07T23:32:54.445Z
2024-10-08,7:30 AM,2,0,0,0,0,2,2024-10-08T12:44:52.569Z
2024-10-08,8:30 AM,9,4,6,1,1,21,2024-10-08T14:16:01.240Z
2024-10-08,9:30 AM,8,5,8,1,0,22,2024-10-08T14:27:18.748Z
2024-10-08,10:30 AM,9,5,15,2,0,31,2024-10-08T15:29:43.221Z
2024-10-08,11:30 AM,7,8,20,6,1,42,2024-10-08T16:48:25.505Z
2024-10-08,12:30 PM,11,10,25,3,1,50,2024-10-08T17:43:35.972Z
2024-10-08,1:30 PM,6,5,16,3,1,31,2024-10-08T18:35:42.997Z
2024-10-08,2:30 PM,6,5,18,2,1,32,2024-10-08T19:33:51.260Z
2024-10-08,3:30 PM,11,4,14,5,0,34,2024-10-08T21:01:21.954Z
2024-10-08,4:30 PM,7,4,10,3,0,24,2024-10-08T21:29:39.169Z
2024-10-08,5:30 PM,11,2,12,3,2,30,2024-10-08T22:33:53.506Z
2024-10-08,6:30 PM,12,2,9,1,1,25,2024-10-08T23:32:42.912Z
2024-10-08,7:30 PM,8,1,5,2,0,16,2024-10-09T01:14:47.443Z
2024-10-08,8:30 PM,2,0,2,1,0,5,2024-10-09T01:31:19.529Z
2024-10-09,7:30 AM,5,0,1,0,0,6,2024-10-09T12:56:29.604Z
2024-10-09,8:30 AM,0,4,5,0,0,9,2024-10-09T13:44:09.462Z
2024-10-09,9:30 AM,7,3,8,5,0,23,2024-10-09T14:32:32.668Z
2024-10-09,10:30 AM,13,10,10,8,0,41,2024-10-09T15:34:18.170Z
2024-10-09,11:30 AM,7,6,17,4,0,34,2024-10-09T16:37:16.551Z
2024-10-09,12:30 PM,7,9,19,10,1,46,2024-10-09T17:33:25.349Z
2024-10-09,1:30 PM,4,7,19,2,2,34,2024-10-09T18:50:56.969Z
2024-10-09,2:30 PM,8,10,23,2,3,46,2024-10-09T19:32:26.006Z
2024-10-09,3:30 PM,8,9,15,2,0,34,2024-10-09T20:30:12.914Z
2024-10-09,4:30 PM,10,9,16,4,0,39,2024-10-09T21:33:21.592Z
2024-10-09,5:30 PM,6,6,17,9,0,38,2024-10-09T22:28:11.613Z
2024-10-09,6:30 PM,3,4,9,0,0,16,2024-10-09T23:46:02.286Z
2024-10-09,7:30 PM,6,4,5,2,0,17,2024-10-10T00:32:23.730Z
2024-10-09,8:30 PM,2,1,2,0,0,5,2024-10-10T01:37:16.014Z
2024-10-10,7:30 AM,2,0,0,1,0,3,2024-10-10T12:40:20.858Z
2024-10-10,8:30 AM,6,1,6,0,0,13,2024-10-10T13:34:00.040Z
2024-10-10,9:30 AM,4,0,6,2,0,12,2024-10-10T14:32:15.390Z
2024-10-10,10:30 AM,9,5,8,3,0,25,2024-10-10T16:04:07.102Z
2024-10-10,11:30 AM,6,7,12,5,0,30,2024-10-10T16:57:53.322Z
2024-10-10,12:30 PM,16,4,24,5,6,55,2024-10-10T17:34:03.895Z
2024-10-10,1:30 PM,11,6,20,3,0,40,2024-10-10T18:34:50.593Z
2024-10-10,2:30 PM,6,6,20,5,1,38,2024-10-10T19:34:58.964Z
2024-10-10,3:30 PM,9,5,9,8,4,35,2024-10-10T20:37:12.407Z
2024-10-10,4:30 PM,9,7,5,4,0,25,2024-10-10T21:28:21.001Z
2024-10-10,5:30 PM,6,5,7,3,0,21,2024-10-10T22:29:43.230Z
2024-10-10,6:30 PM,2,1,8,0,0,11,2024-10-10T23:26:57.244Z
2024-10-10,7:30 PM,6,2,7,0,0,15,2024-10-11T00:30:08.489Z
2024-10-10,8:30 PM,2,1,5,0,1,9,2024-10-11T01:29:23.700Z
2024-10-11,7:30 AM,2,0,0,0,0,2,2024-10-11T12:57:56.418Z
2024-10-11,8:30 AM,2,1,2,0,0,5,2024-10-11T13:51:45.552Z
2024-10-11,9:30 AM,3,2,5,4,1,15,2024-10-11T14:31:49.704Z
2024-10-11,10:30 AM,2,2,8,4,0,16,2024-10-11T15:44:03.797Z
2024-10-11,12:30 PM,6,2,7,7,0,22,2024-10-11T17:14:05.718Z
2024-10-11,12:30 PM,8,3,6,4,2,23,2024-10-11T17:34:52.539Z
2024-10-11,1:30 PM,7,3,7,3,0,20,2024-10-11T18:38:06.263Z
2024-10-11,2:30 PM,6,1,9,4,1,21,2024-10-11T19:35:17.683Z
2024-10-11,3:30 PM,8,2,5,0,1,16,2024-10-11T20:29:27.980Z
2024-10-11,4:30 PM,5,1,4,0,0,10,2024-10-11T21:29:59.844Z
2024-10-11,5:30 PM,2,1,4,0,0,7,2024-10-11T22:33:08.584Z
2024-10-11,6:30 PM,1,1,3,0,0,5,2024-10-11T23:40:01.957Z
2024-10-12,10:30 AM,5,0,1,0,0,6,2024-10-12T15:29:18.728Z
2024-10-12,11:30 AM,5,1,2,0,0,8,2024-10-12T16:28:27.438Z
2024-10-12,12:30 PM,7,2,3,0,0,12,2024-10-12T17:30:52.950Z
2024-10-12,1:30 PM,2,0,3,0,0,5,2024-10-12T18:28:39.612Z
2024-10-12,2:30 PM,3,3,4,1,0,11,2024-10-12T19:29:09.299Z
2024-10-12,3:30 PM,4,2,4,1,0,11,2024-10-12T20:35:23.992Z
2024-10-12,4:30 PM,3,1,4,1,0,9,2024-10-12T21:35:11.877Z
2024-10-14,7:30 AM,5,2,4,1,0,12,2024-10-14T13:01:34.145Z
2024-10-14,8:30 AM,3,4,7,1,0,15,2024-10-14T13:30:00.549Z
2024-10-14,9:30 AM,6,6,7,2,0,21,2024-10-14T14:31:51.078Z
2024-10-14,10:30 AM,5,7,18,3,0,33,2024-10-14T15:31:32.488Z
2024-10-14,11:30 AM,5,5,19,6,1,36,2024-10-14T16:33:08.482Z
2024-10-14,12:30 PM,16,10,17,10,2,55,2024-10-14T17:31:46.706Z
2024-10-14,1:30 PM,10,6,17,10,2,45,2024-10-14T18:37:25.190Z
2024-10-14,2:30 PM,5,13,19,5,2,44,2024-10-14T19:32:07.976Z
2024-10-14,3:30 PM,10,5,11,5,2,33,2024-10-14T20:27:51.267Z
2024-10-14,4:30 PM,7,3,7,6,0,23,2024-10-14T21:29:23.298Z
2024-10-14,5:30 PM,9,2,8,3,0,22,2024-10-14T23:37:30.418Z
2024-10-14,6:30 PM,5,1,6,3,0,15,2024-10-14T23:37:53.744Z
2024-10-14,7:30 PM,4,2,6,1,0,13,2024-10-15T00:30:44.908Z
2024-10-14,8:30 PM,2,1,3,1,0,7,2024-10-15T01:34:20.815Z
2024-10-15,7:30 AM,2,0,0,0,0,2,2024-10-15T12:44:07.982Z
2024-10-15,8:30 AM,5,3,2,2,0,12,2024-10-15T13:38:37.982Z
2024-10-15,9:30 AM,6,3,6,0,0,15,2024-10-15T14:30:06.252Z
2024-10-15,10:30 AM,12,10,20,1,0,43,2024-10-15T15:49:46.349Z
2024-10-15,11:30 AM,3,7,14,6,0,30,2024-10-15T16:39:59.732Z
2024-10-15,12:30 PM,11,8,22,5,3,49,2024-10-15T17:40:58.808Z
2024-10-15,1:30 PM,3,4,13,6,1,27,2024-10-15T18:30:21.701Z
2024-10-15,3:30 PM,14,5,15,6,1,41,2024-10-15T20:46:48.212Z
2024-10-15,4:30 PM,3,4,14,1,3,25,2024-10-15T21:33:15.895Z
2024-10-15,2:30 PM,9,4,17,5,1,36,2024-10-15T21:45:22.413Z
2024-10-15,5:30 PM,4,3,10,1,2,20,2024-10-15T22:31:48.310Z
2024-10-15,6:30 PM,4,3,10,4,0,21,2024-10-15T23:27:58.542Z
2024-10-15,7:30 PM,4,2,7,5,0,18,2024-10-16T00:37:08.732Z
2024-10-15,8:30 PM,2,1,4,5,0,12,2024-10-16T01:45:01.755Z
2024-10-16,7:30 AM,1,0,1,0,0,2,2024-10-16T13:29:09.070Z
2024-10-16,8:30 AM,1,3,5,1,0,10,2024-10-16T13:51:07.962Z
2024-10-16,9:30 AM,4,6,5,1,0,16,2024-10-16T14:47:30.808Z
2024-10-16,10:30 AM,3,9,10,1,0,23,2024-10-16T15:31:07.038Z
2024-10-16,11:30 AM,6,6,14,6,1,33,2024-10-16T16:51:51.980Z
2024-10-16,12:30 PM,11,11,18,5,2,47,2024-10-16T17:39:56.720Z
2024-10-16,1:30 PM,7,4,23,5,1,40,2024-10-16T18:35:27.124Z
2024-10-16,2:30 PM,10,6,11,0,0,27,2024-10-16T19:37:52.644Z
2024-10-16,3:30 PM,3,4,13,1,3,24,2024-10-16T20:36:28.695Z
2024-10-16,4:30 PM,7,5,19,0,0,31,2024-10-16T21:40:03.207Z
2024-10-16,5:30 PM,3,4,14,1,0,22,2024-10-16T22:36:49.883Z
2024-10-16,6:30 PM,3,4,8,0,0,15,2024-10-16T23:34:59.392Z
2024-10-16,7:30 PM,5,2,5,0,0,12,2024-10-17T00:40:16.905Z
2024-10-17,7:30 AM,4,2,1,0,0,7,2024-10-17T12:56:47.027Z
2024-10-17,8:30 AM,7,4,2,1,0,14,2024-10-17T15:33:38.627Z
2024-10-17,9:30 AM,8,4,5,3,0,20,2024-10-17T14:27:19.686Z
2024-10-17,10:30 AM,8,6,13,8,2,37,2024-10-17T15:37:13.371Z
2024-10-17,11:30 AM,16,6,7,8,3,40,2024-10-17T16:39:59.160Z
2024-10-17,1:30 PM,9,3,20,7,1,40,2024-10-17T18:01:12.535Z
2024-10-17,1:30 PM,3,4,16,6,1,30,2024-10-17T18:36:43.541Z
2024-10-17,2:30 PM,6,4,7,2,1,20,2024-10-17T19:35:45.555Z
2024-10-17,3:30 PM,6,4,10,1,0,21,2024-10-17T20:40:02.173Z
2024-10-17,4:30 PM,7,2,10,0,0,19,2024-10-17T21:35:24.295Z
2024-10-17,5:30 PM,5,3,5,0,0,13,2024-10-17T22:35:13.310Z
2024-10-17,6:30 PM,3,2,5,0,0,10,2024-10-17T23:33:00.685Z
2024-10-17,7:30 PM,5,3,3,1,0,12,2024-10-18T00:33:58.737Z
2024-10-18,8:30 AM,2,0,1,0,0,3,2024-10-18T13:19:58.531Z
2024-10-18,7:30 AM,2,0,0,0,0,2,2024-10-18T13:27:37.526Z
2024-10-18,9:30 AM,1,1,3,1,0,6,2024-10-18T14:34:08.817Z
2024-10-18,11:30 AM,2,3,3,0,0,8,2024-10-18T16:36:27.629Z
2024-10-18,10:30 AM,3,1,3,1,0,8,2024-10-18T16:59:29.847Z
2024-10-18,12:30 PM,5,2,1,4,0,12,2024-10-18T17:35:55.248Z
2024-10-18,1:30 PM,5,2,5,1,0,13,2024-10-18T19:56:00.824Z
2024-10-18,2:30 PM,3,2,2,1,2,10,2024-10-18T20:01:24.837Z
2024-10-18,3:30 PM,5,3,2,0,0,10,2024-10-18T20:33:21.334Z
2024-10-18,4:30 PM,3,0,7,0,1,11,2024-10-18T21:35:42.825Z
2024-10-18,5:30 PM,4,1,9,0,0,14,2024-10-18T22:39:19.054Z
2024-10-18,6:30 PM,3,1,4,0,0,8,2024-10-18T23:41:57.195Z
2024-10-19,10:30 AM,1,1,1,0,0,3,2024-10-19T15:36:32.779Z
2024-10-19,11:30 AM,2,2,1,0,0,5,2024-10-19T16:32:07.831Z
2024-10-19,12:30 PM,3,1,0,1,0,5,2024-10-19T17:29:51.774Z
2024-10-19,1:30 PM,2,0,0,0,0,2,2024-10-19T18:24:32.442Z
2024-10-19,2:30 PM,1,0,0,2,0,3,2024-10-19T19:41:47.088Z
2024-10-19,3:30 PM,3,0,2,0,0,5,2024-10-19T21:27:29.056Z
2024-10-19,4:30 PM,2,0,1,1,0,4,2024-10-19T21:29:44.596Z
2024-10-21,7:30 AM,3,0,0,0,0,3,2024-10-21T12:33:57.906Z
2024-10-21,7:30 AM,2,0,0,0,0,2,2024-10-21T12:34:58.805Z
2024-10-21,8:30 AM,3,1,5,2,1,12,2024-10-21T13:25:53.494Z
2024-10-21,9:30 AM,4,2,6,1,0,13,2024-10-21T14:36:14.769Z
2024-10-21,10:30 AM,12,4,13,6,1,36,2024-10-21T15:36:56.311Z
2024-10-21,11:30 AM,9,7,18,20,0,54,2024-10-21T16:47:02.466Z
2024-10-21,12:30 PM,22,9,23,15,3,72,2024-10-21T17:43:58.520Z
2024-10-21,1:30 PM,16,12,14,13,1,56,2024-10-21T18:35:51.263Z
2024-10-21,2:30 PM,10,6,12,5,0,33,2024-10-21T19:36:00.142Z
2024-10-21,3:30 PM,13,6,11,2,0,32,2024-10-21T20:28:11.540Z
2024-10-21,4:30 PM,6,3,9,3,2,23,2024-10-21T21:27:06.590Z
2024-10-21,5:30 PM,6,3,9,7,1,26,2024-10-21T22:35:24.903Z
2024-10-21,6:30 PM,4,2,7,6,1,20,2024-10-21T23:32:10.574Z
2024-10-21,7:30 PM,8,3,2,1,0,14,2024-10-22T01:02:31.699Z
2024-10-22,7:30 AM,7,0,0,0,0,7,2024-10-22T12:48:45.679Z
2024-10-22,8:30 AM,3,0,5,0,1,9,2024-10-22T13:43:09.753Z
2024-10-22,9:30 AM,5,4,12,1,0,22,2024-10-22T14:30:43.622Z
2024-10-22,10:30 AM,8,9,9,8,2,36,2024-10-22T15:35:30.391Z
2024-10-22,11:30 AM,4,8,16,15,0,43,2024-10-22T16:39:15.327Z
2024-10-22,12:30 PM,11,11,21,5,3,51,2024-10-22T17:36:16.950Z
2024-10-22,1:30 PM,5,7,19,15,0,46,2024-10-22T18:35:02.061Z
2024-10-22,2:30 PM,11,6,14,6,0,37,2024-10-22T19:35:14.227Z
2024-10-22,3:30 PM,9,6,6,7,1,29,2024-10-22T20:31:45.601Z
2024-10-22,4:30 PM,8,5,10,3,1,27,2024-10-22T21:34:15.298Z
2024-10-22,5:30 PM,10,4,7,1,1,23,2024-10-22T22:30:31.467Z
2024-10-22,6:30 PM,8,3,10,2,0,23,2024-10-22T23:35:29.080Z
2024-10-22,7:30 PM,8,1,8,2,1,20,2024-10-23T00:32:27.913Z
2024-10-22,8:30 PM,3,2,5,3,0,13,2024-10-23T01:31:17.143Z
2024-10-23,7:30 AM,1,0,0,1,0,2,2024-10-23T12:37:56.611Z
2024-10-23,8:30 AM,3,2,4,2,0,11,2024-10-23T13:35:21.338Z
2024-10-23,9:30 AM,5,4,7,4,0,20,2024-10-23T14:38:23.197Z
2024-10-23,10:30 AM,8,5,8,4,0,25,2024-10-23T15:28:58.981Z
2024-10-23,11:30 AM,14,7,15,15,2,53,2024-10-23T16:41:15.686Z
2024-10-23,12:30 PM,14,8,25,9,3,59,2024-10-23T17:35:52.659Z
2024-10-23,1:30 PM,6,4,12,7,0,29,2024-10-23T18:41:01.255Z
2024-10-23,2:30 PM,2,4,9,7,0,22,2024-10-23T19:34:42.661Z
2024-10-23,3:30 PM,11,4,21,7,1,44,2024-10-23T20:38:46.952Z
2024-10-23,4:30 PM,9,6,12,1,0,28,2024-10-23T21:44:36.787Z
2024-10-23,5:30 PM,9,7,10,3,0,29,2024-10-23T22:32:20.772Z
2024-10-23,6:30 PM,0,8,8,3,0,19,2024-10-23T23:41:15.098Z
2024-10-23,7:30 PM,3,4,7,2,0,16,2024-10-24T01:54:00.726Z
2024-10-23,8:30 PM,1,0,2,4,0,7,2024-10-24T01:54:21.715Z
2024-10-24,7:30 AM,3,0,0,0,0,3,2024-10-24T12:49:28.259Z
2024-10-24,8:30 AM,3,2,1,2,0,8,2024-10-24T13:35:45.333Z
2024-10-24,9:30 AM,3,4,10,2,0,19,2024-10-24T14:30:58.195Z
2024-10-24,10:30 AM,4,5,10,6,2,27,2024-10-24T15:29:55.836Z
2024-10-24,11:30 PM,7,5,13,9,1,35,2024-10-24T17:12:37.484Z
2024-10-24,12:30 PM,14,7,16,14,0,51,2024-10-24T17:48:13.547Z
2024-10-24,1:30 PM,6,8,9,5,0,28,2024-10-24T18:37:56.418Z
2024-10-24,2:30 PM,4,5,12,6,1,28,2024-10-24T19:34:10.744Z
2024-10-24,3:30 PM,11,4,8,7,1,31,2024-10-24T20:35:15.980Z
2024-10-24,4:30 PM,7,4,9,3,1,24,2024-10-24T21:32:15.693Z
2024-10-24,5:30 PM,7,5,8,5,0,25,2024-10-24T22:38:21.755Z
2024-10-24,6:30 PM,7,1,8,5,0,21,2024-10-24T23:30:34.573Z
2024-10-24,7:30 PM,9,4,4,2,0,19,2024-10-25T00:45:11.490Z
2024-10-24,8:30 PM,2,1,1,1,0,5,2024-10-25T01:36:36.420Z
2024-10-25,7:30 AM,1,0,0,0,0,1,2024-10-25T12:33:30.558Z
2024-10-25,8:30 AM,2,2,2,0,0,6,2024-10-25T13:40:15.768Z
2024-10-25,9:30 AM,3,3,3,2,0,11,2024-10-25T14:42:45.639Z
2024-10-25,10:30 AM,3,2,0,3,0,8,2024-10-25T15:26:11.709Z
2024-10-25,11:30 PM,3,0,7,1,0,11,2024-10-25T17:42:56.943Z
2024-10-25,12:30 PM,5,1,11,2,0,19,2024-10-25T17:43:23.446Z
2024-10-25,1:30 PM,5,4,7,1,0,17,2024-10-25T18:38:07.437Z
2024-10-25,2:30 PM,4,1,5,0,0,10,2024-10-25T19:37:55.879Z
2024-10-25,3:30 PM,7,2,4,0,0,13,2024-10-25T20:31:49.130Z
2024-10-25,4:30 PM,6,1,4,2,0,13,2024-10-25T21:29:41.292Z
2024-10-25,5:30 PM,2,1,6,1,0,10,2024-10-25T22:40:18.834Z
2024-10-25,6:30 PM,0,1,2,0,1,4,2024-10-25T23:31:23.254Z
2024-10-26,10:30 AM,3,0,0,0,1,4,2024-10-26T15:28:00.913Z
2024-10-26,11:30 AM,2,0,0,0,0,2,2024-10-26T16:31:04.753Z
2024-10-26,12:30 PM,4,1,2,2,0,9,2024-10-26T17:30:27.603Z
2024-10-26,1:30 PM,2,2,1,0,0,5,2024-10-26T18:44:29.042Z
2024-10-26,2:30 PM,4,1,4,0,0,9,2024-10-26T19:47:13.932Z
2024-10-26,3:30 PM,2,1,3,2,0,8,2024-10-26T20:43:31.861Z
2024-10-26,4:30 PM,3,1,1,1,0,6,2024-10-26T21:45:31.992Z
2024-10-28,7:30 AM,1,0,0,0,0,1,2024-10-28T12:42:25.485Z
2024-10-28,8:30 AM,6,1,2,2,0,11,2024-10-28T13:38:46.429Z
2024-10-28,9:30 AM,5,4,6,3,0,18,2024-10-28T14:32:30.465Z
2024-10-28,10:30 AM,8,5,10,3,0,26,2024-10-28T16:02:04.634Z
2024-10-28,11:30 AM,9,7,13,8,1,38,2024-10-28T16:39:15.630Z
2024-10-28,12:30 PM,15,10,17,6,4,52,2024-10-28T17:43:17.603Z
2024-10-28,1:30 PM,6,4,18,12,1,41,2024-10-28T18:33:08.073Z
2024-10-28,2:30 PM,9,8,19,6,0,42,2024-10-28T19:36:14.760Z
2024-10-28,3:30 PM,8,6,11,3,1,29,2024-10-28T20:30:44.754Z
2024-10-28,4:30 PM,6,4,12,4,1,27,2024-10-28T21:39:10.508Z
2024-10-28,5:30 PM,11,1,5,1,1,19,2024-10-28T22:32:15.563Z
2024-10-28,6:30 PM,6,2,5,1,0,14,2024-10-28T23:32:27.073Z
2024-10-28,7:30 PM,8,1,3,2,0,14,2024-10-29T01:08:06.291Z
2024-10-29,7:30 AM,4,0,0,0,1,5,2024-10-29T12:40:02.719Z
2024-10-29,8:30 AM,3,0,0,3,0,6,2024-10-29T13:29:29.706Z
2024-10-29,9:30 AM,3,5,6,1,0,15,2024-10-29T14:32:28.816Z
2024-10-29,10:30 AM,5,7,13,3,1,29,2024-10-29T15:32:13.695Z
2024-10-29,11:30 AM,5,7,13,10,2,37,2024-10-29T16:39:14.232Z
2024-10-29,12:30 PM,15,12,14,8,1,50,2024-10-29T17:38:56.536Z
2024-10-29,1:30 PM,7,3,14,6,2,32,2024-10-29T18:42:17.210Z
2024-10-29,2:30 PM,7,6,15,3,2,33,2024-10-29T19:32:49.594Z
2024-10-29,3:30 PM,9,3,12,5,0,29,2024-10-29T20:33:10.097Z
2024-10-29,4:30 PM,9,3,10,1,1,24,2024-10-29T21:29:24.462Z
2024-10-29,5:30 PM,4,2,5,1,2,14,2024-10-29T22:31:29.347Z
2024-10-29,6:30 PM,7,1,5,1,0,14,2024-10-29T23:27:57.034Z
2024-10-29,7:30 PM,7,0,5,1,0,13,2024-10-30T00:35:29.305Z
2024-10-30,7:30 AM,2,0,0,1,1,4,2024-10-30T12:40:04.072Z
2024-10-30,8:30 AM,3,3,4,3,0,13,2024-10-30T13:33:08.782Z
2024-10-30,9:30 AM,12,4,7,2,1,26,2024-10-30T14:34:49.426Z
2024-10-30,10:30 AM,10,4,20,3,0,37,2024-10-30T15:34:47.763Z
2024-10-30,11:30 AM,8,6,16,4,1,35,2024-10-30T16:33:34.443Z
2024-10-30,12:30 PM,12,9,19,9,1,50,2024-10-30T17:35:24.177Z
2024-10-30,1:30 PM,10,3,15,10,2,40,2024-10-30T18:41:22.161Z
2024-10-30,2:30 PM,9,3,13,5,0,30,2024-10-30T19:36:03.410Z
2024-10-30,3:30 PM,7,4,7,5,0,23,2024-10-30T20:32:06.058Z
2024-10-30,4:30 PM,4,3,10,5,0,22,2024-10-30T21:47:16.352Z
2024-10-30,5:30 PM,5,2,9,0,0,16,2024-10-30T22:31:39.136Z
2024-10-30,6:30 PM,3,2,3,0,0,8,2024-10-30T23:52:08.077Z
2024-10-30,7:30 PM,2,1,2,0,0,5,2024-10-31T00:27:49.640Z
2024-10-30,8:30 PM,3,1,1,0,0,5,2024-10-31T01:32:17.343Z
2024-10-31,7:30 AM,0,0,0,1,0,1,2024-10-31T12:35:22.934Z
2024-10-31,8:30 AM,2,3,1,1,0,7,2024-10-31T13:34:42.137Z
2024-10-31,10:30 AM,8,4,4,2,1,19,2024-10-31T15:31:35.551Z
2024-10-31,12:30 PM,9,4,9,4,0,26,2024-10-31T17:23:33.591Z
2024-10-31,12:30 PM,11,7,13,6,0,37,2024-10-31T17:42:53.068Z
2024-10-31,1:30 PM,5,4,7,0,0,16,2024-10-31T18:43:36.878Z
2024-10-31,2:30 PM,9,3,4,4,0,20,2024-10-31T19:34:37.888Z
2024-10-31,3:30 PM,8,2,4,5,0,19,2024-10-31T20:44:17.297Z
2024-10-31,4:30 PM,5,2,7,0,0,14,2024-10-31T21:33:04.051Z
2024-10-31,5:30 PM,4,3,6,0,0,13,2024-10-31T22:31:49.420Z
2024-10-31,6:30 PM,4,3,3,1,0,11,2024-10-31T23:33:32.470Z
2024-11-01,7:30 AM,2,0,0,0,0,2,2024-11-01T12:36:27.379Z
2024-11-01,8:30 AM,3,0,0,0,0,3,2024-11-01T13:33:02.303Z
2024-11-01,9:30 AM,3,1,0,0,0,4,2024-11-01T14:32:02.080Z
2024-11-01,10:30 AM,4,1,0,1,0,6,2024-11-01T15:33:03.655Z
2024-11-01,12:30 PM,6,1,6,0,0,13,2024-11-01T17:14:57.555Z
2024-11-01,12:30 PM,5,2,6,3,0,16,2024-11-01T17:31:53.377Z
2024-11-01,1:30 PM,2,3,2,4,0,11,2024-11-01T18:36:06.654Z
2024-11-01,2:30 PM,1,1,2,1,0,5,2024-11-01T19:35:44.015Z
2024-11-01,3:30 PM,2,3,2,3,0,10,2024-11-01T20:37:23.884Z
2024-11-01,4:30 PM,2,1,3,3,1,10,2024-11-01T21:27:34.440Z
2024-11-01,5:30 PM,2,2,4,4,0,12,2024-11-01T22:34:34.016Z
2024-11-01,6:30 PM,1,0,1,0,0,2,2024-11-01T23:36:43.543Z
2024-11-02,10:30 AM,0,0,2,0,0,2,2024-11-02T15:30:41.891Z
2024-11-02,11:30 AM,0,0,2,1,0,3,2024-11-02T16:40:50.249Z
2024-11-02,12:30 PM,0,0,2,1,0,3,2024-11-02T17:38:02.921Z
2024-11-02,2:30 PM,4,2,2,1,0,9,2024-11-02T19:36:22.082Z
2024-11-02,3:30 PM,3,2,3,1,0,9,2024-11-02T20:38:49.030Z
2024-11-02,4:30 PM,2,0,4,0,0,6,2024-11-02T21:39:25.946Z
2024-11-04,8:30 AM,6,2,6,0,0,14,2024-11-04T14:30:28.044Z
2024-11-04,7:30 AM,3,0,1,0,0,4,2024-11-04T14:30:53.419Z
2024-11-04,9:30 AM,11,4,5,2,1,23,2024-11-04T15:36:50.171Z
2024-11-04,10:30 AM,10,7,17,2,3,39,2024-11-04T16:49:05.264Z
2024-11-04,11:30 AM,10,10,10,9,0,39,2024-11-04T17:52:53.983Z
2024-11-04,12:30 PM,14,8,26,4,2,54,2024-11-04T18:50:43.140Z
2024-11-04,1:30 PM,6,6,9,6,0,27,2024-11-04T20:41:00.788Z
2024-11-04,2:30 PM,5,7,8,2,0,22,2024-11-04T20:41:23.793Z
2024-11-04,3:30 PM,3,5,10,1,0,19,2024-11-04T21:33:29.177Z
2024-11-04,4:30 PM,7,3,11,0,0,21,2024-11-04T22:30:20.244Z
2024-11-04,5:30 PM,9,1,9,0,2,21,2024-11-04T23:28:04.051Z
2024-11-04,6:30 PM,2,1,1,1,0,5,2024-11-05T00:33:27.424Z
2024-11-05,7:30 AM,3,0,0,0,0,3,2024-11-05T13:56:34.141Z
2024-11-05,8:30 AM,3,4,1,2,0,10,2024-11-05T14:52:21.930Z
2024-11-05,9:30 AM,11,4,7,2,0,24,2024-11-05T15:48:55.764Z
2024-11-05,10:30 AM,14,8,12,2,0,36,2024-11-05T16:32:01.611Z
2024-11-05,11:30 AM,9,10,7,3,1,30,2024-11-05T17:44:40.610Z
2024-11-05,12:30 PM,12,10,33,4,3,62,2024-11-05T18:33:43.735Z
2024-11-05,1:30 PM,7,8,10,1,1,27,2024-11-05T19:32:44.710Z
2024-11-05,2:30 PM,9,8,13,4,1,35,2024-11-05T20:47:36.675Z
2024-11-05,3:30 PM,5,7,11,3,3,29,2024-11-05T21:30:43.048Z
2024-11-05,4:30 PM,7,5,6,3,0,21,2024-11-05T22:32:44.841Z
2024-11-05,5:30 PM,7,0,8,3,3,21,2024-11-05T23:30:56.850Z
2024-11-05,6:30 PM,4,2,7,2,1,16,2024-11-06T00:31:21.211Z
2024-11-05,7:30 PM,1,2,2,3,0,8,2024-11-06T01:39:58.109Z
2024-11-05,8:30 PM,0,2,3,2,0,7,2024-11-06T02:35:35.742Z
2024-11-06,7:30 AM,0,1,3,0,2,6,2024-11-06T14:03:34.493Z
2024-11-06,8:30 AM,4,2,3,2,0,11,2024-11-06T14:33:06.431Z
2024-11-06,9:30 AM,4,4,4,6,4,22,2024-11-06T15:34:35.671Z
2024-11-06,10:30 AM,6,10,12,12,1,41,2024-11-06T16:29:08.803Z
2024-11-06,11:30 AM,5,8,11,19,1,44,2024-11-06T17:33:53.846Z
2024-11-06,12:30 PM,9,6,20,12,3,50,2024-11-06T18:34:05.785Z
2024-11-06,1:30 PM,8,6,17,9,1,41,2024-11-06T19:36:03.140Z
2024-11-06,2:30 PM,6,7,9,7,0,29,2024-11-06T20:40:39.947Z
2024-11-06,3:30 PM,3,6,8,2,5,24,2024-11-06T21:29:42.982Z
2024-11-06,4:30 PM,7,4,9,6,0,26,2024-11-06T22:46:41.383Z
2024-11-06,5:30 PM,5,5,6,4,0,20,2024-11-06T23:40:08.208Z
2024-11-06,6:30 PM,3,5,18,4,0,30,2024-11-07T00:38:46.805Z
2024-11-06,7:30 PM,2,1,4,5,0,12,2024-11-07T01:30:30.193Z
2024-11-06,8:30 PM,5,1,1,6,0,13,2024-11-07T02:31:29.358Z
2024-11-07,7:30 AM,2,0,0,0,0,2,2024-11-07T13:36:51.548Z
2024-11-07,8:30 AM,7,3,1,5,0,16,2024-11-07T14:51:04.371Z
2024-11-07,9:30 AM,7,4,5,5,0,21,2024-11-07T15:36:35.303Z
2024-11-07,11:30 AM,3,6,6,5,3,23,2024-11-07T17:11:24.019Z
2024-11-07,10:30 AM,2,5,5,4,0,16,2024-11-07T17:12:44.315Z
2024-11-07,12:30 PM,5,9,22,5,1,42,2024-11-07T18:33:46.365Z
2024-11-07,1:30 PM,4,5,11,2,0,22,2024-11-07T19:38:14.831Z
2024-11-07,2:30 PM,9,5,9,3,1,27,2024-11-07T20:32:31.491Z
2024-11-07,3:30 PM,8,4,11,6,0,29,2024-11-07T21:51:45.316Z
2024-11-07,4:30 PM,7,4,13,1,0,25,2024-11-07T22:27:23.133Z
2024-11-07,5:30 PM,6,3,9,3,0,21,2024-11-07T23:48:25.843Z
2024-11-07,6:30 PM,4,2,8,3,1,18,2024-11-08T00:28:16.309Z
2024-11-07,7:30 PM,0,1,6,2,0,9,2024-11-08T01:30:44.555Z
2024-11-07,8:30 PM,0,4,1,1,0,6,2024-11-08T02:32:26.060Z
2024-11-08,7:30 AM,2,1,0,0,0,3,2024-11-08T13:33:31.286Z
2024-11-08,8:30 AM,2,0,1,0,0,3,2024-11-08T14:42:53.277Z
2024-11-08,9:30 AM,3,3,1,2,0,9,2024-11-08T15:31:34.199Z
2024-11-08,10:30 AM,2,2,3,3,1,11,2024-11-08T16:38:16.335Z
2024-11-08,11:30 AM,5,3,8,3,0,19,2024-11-08T17:51:29.253Z
2024-11-08,1:30 PM,2,2,3,1,0,8,2024-11-08T19:49:38.005Z
2024-11-08,2:30 PM,4,0,3,2,0,9,2024-11-08T20:31:01.175Z
2024-11-08,3:30 PM,4,0,4,1,1,10,2024-11-08T21:31:41.001Z
2024-11-08,4:30 PM,6,1,1,1,0,9,2024-11-08T22:27:57.487Z
2024-11-08,5:30 PM,1,1,2,0,0,4,2024-11-09T00:05:38.560Z
2024-11-08,6:30 PM,2,0,1,0,0,3,2024-11-09T00:50:36.803Z
2024-11-09,10:30 AM,4,0,0,2,0,6,2024-11-09T16:36:43.732Z
2024-11-09,11:30 AM,4,2,1,1,0,8,2024-11-09T17:33:17.825Z
2024-11-09,12:30 PM,5,1,0,0,0,6,2024-11-09T18:29:51.944Z
2024-11-09,1:30 PM,3,0,1,0,0,4,2024-11-09T19:28:28.151Z
2024-11-09,2:30 PM,3,3,3,1,0,10,2024-11-09T20:27:37.406Z
2024-11-09,3:30 PM,0,1,3,2,0,6,2024-11-09T21:36:18.201Z
2024-11-11,7:30 AM,3,1,3,2,0,9,2024-11-11T15:12:17.095Z
2024-11-11,8:30 AM,8,6,6,5,1,26,2024-11-11T15:12:48.141Z
2024-11-11,9:30 AM,9,6,6,4,0,25,2024-11-11T15:29:04.982Z
2024-11-11,10:30 AM,9,10,26,5,3,53,2024-11-11T16:38:45.450Z
2024-11-11,11:30 AM,8,8,19,5,0,40,2024-11-11T17:38:28.689Z
2024-11-11,12:30 PM,10,8,20,13,1,52,2024-11-11T19:09:57.784Z
2024-11-11,1:30 PM,11,7,20,12,1,51,2024-11-11T19:35:34.575Z
2024-11-11,2:30 PM,7,9,19,4,2,41,2024-11-11T20:33:50.052Z
2024-11-11,3:30 PM,11,9,15,3,2,40,2024-11-11T21:31:36.682Z
2024-11-11,4:30 PM,6,6,12,1,0,25,2024-11-11T22:32:58.315Z
2024-11-11,5:30 PM,4,5,11,0,2,22,2024-11-11T23:30:56.013Z
2024-11-11,6:30 PM,3,2,9,1,0,15,2024-11-12T00:31:30.231Z
2024-11-11,7:30 PM,1,2,4,1,0,8,2024-11-12T01:31:29.150Z
2024-11-12,7:30 AM,2,1,0,0,0,3,2024-11-12T13:51:16.095Z
2024-11-12,8:30 AM,3,5,3,2,0,13,2024-11-12T14:34:19.652Z
2024-11-12,9:30 AM,6,3,6,3,0,18,2024-11-12T15:31:39.617Z
2024-11-12,10:30 AM,10,7,11,3,0,31,2024-11-12T16:31:04.387Z
2024-11-12,11:30 AM,6,7,15,4,2,34,2024-11-12T17:47:49.307Z
2024-11-12,12:30 PM,18,8,23,8,0,57,2024-11-12T18:34:21.382Z
2024-11-12,1:30 PM,8,6,27,4,2,47,2024-11-12T19:33:03.240Z
2024-11-12,2:30 PM,7,7,32,6,2,54,2024-11-12T20:41:14.087Z
2024-11-12,3:30 PM,13,6,25,6,1,51,2024-11-12T21:38:04.998Z
2024-11-12,4:30 PM,8,4,7,2,1,22,2024-11-12T22:35:00.214Z
2024-11-12,5:30 PM,9,2,9,0,0,20,2024-11-12T23:43:38.592Z
2024-11-12,6:30 PM,6,2,3,1,0,12,2024-11-13T00:31:40.215Z
2024-11-12,7:30 PM,6,2,5,1,0,14,2024-11-13T01:29:20.151Z
2024-11-12,8:30 PM,5,1,2,0,0,8,2024-11-13T02:33:47.015Z
2024-11-13,7:30 AM,2,0,0,0,0,2,2024-11-13T13:33:21.651Z
2024-11-13,8:30 AM,3,5,5,2,0,15,2024-11-13T14:35:33.887Z
2024-11-13,9:30 AM,4,5,7,2,1,19,2024-11-13T15:35:14.700Z
2024-11-13,10:30 AM,11,10,16,1,1,39,2024-11-13T16:37:42.911Z
2024-11-13,11:30 AM,10,9,8,2,0,29,2024-11-13T17:35:20.200Z
2024-11-13,12:30 PM,16,8,13,6,2,45,2024-11-13T18:42:35.557Z
2024-11-13,1:30 PM,11,5,13,8,0,37,2024-11-13T19:35:17.036Z
2024-11-13,2:30 PM,12,5,14,0,0,31,2024-11-13T20:36:43.874Z
2024-11-13,3:30 PM,8,6,14,3,2,33,2024-11-13T21:35:02.315Z
2024-11-13,4:30 PM,5,4,9,3,0,21,2024-11-13T22:48:10.826Z
2024-11-13,5:30 PM,8,3,7,3,0,21,2024-11-13T23:35:38.237Z
2024-11-13,6:30 PM,4,1,7,1,0,13,2024-11-14T00:39:06.996Z
2024-11-13,7:30 PM,5,1,3,1,0,10,2024-11-14T01:37:36.964Z
2024-11-13,8:30 PM,2,0,2,0,0,4,2024-11-14T02:49:37.361Z
2024-11-14,7:30 AM,4,0,1,1,0,6,2024-11-14T13:45:11.389Z
2024-11-14,8:30 AM,5,2,3,2,0,12,2024-11-14T14:26:36.336Z
2024-11-14,9:30 AM,7,4,11,1,1,24,2024-11-14T15:31:44.276Z
2024-11-14,10:30 AM,5,8,10,3,1,27,2024-11-14T16:29:31.650Z
2024-11-14,11:30 AM,16,5,19,4,3,47,2024-11-14T17:45:18.172Z
2024-11-14,12:30 PM,13,8,18,9,2,50,2024-11-14T18:39:32.597Z
2024-11-14,1:30 PM,8,6,12,5,5,36,2024-11-14T19:34:56.722Z
2024-11-14,2:30 PM,5,4,8,6,2,25,2024-11-14T20:33:30.734Z
2024-11-14,3:30 PM,6,4,7,10,0,27,2024-11-14T21:29:39.865Z
2024-11-14,4:30 PM,5,6,2,2,0,15,2024-11-14T22:42:59.963Z
2024-11-14,5:30 PM,3,6,2,3,1,15,2024-11-14T23:32:26.325Z
2024-11-14,6:30 PM,2,5,2,3,0,12,2024-11-15T00:33:35.517Z
2024-11-14,7:30 PM,3,2,2,2,0,9,2024-11-15T01:42:46.656Z
2024-11-14,8:30 PM,2,1,0,0,0,3,2024-11-15T02:56:28.879Z
2024-11-15,7:30 AM,0,0,0,0,0,0,2024-11-15T13:32:05.329Z
2024-11-15,8:30 AM,2,1,1,0,0,4,2024-11-15T14:42:03.844Z
2024-11-15,9:30 AM,1,1,1,0,0,3,2024-11-15T15:23:24.338Z
2024-11-15,10:30 AM,5,1,1,0,1,8,2024-11-15T16:26:00.790Z
2024-11-15,12:30 PM,2,3,3,0,0,8,2024-11-15T18:15:28.565Z
2024-11-15,12:30 PM,4,2,2,0,1,9,2024-11-15T18:31:13.354Z
2024-11-15,1:30 PM,4,3,1,0,0,8,2024-11-15T19:35:15.592Z
2024-11-15,2:30 PM,4,4,2,0,0,10,2024-11-15T20:39:01.391Z
2024-11-15,3:30 PM,5,2,2,1,0,10,2024-11-15T21:32:46.734Z
2024-11-15,4:30 PM,9,2,1,1,0,13,2024-11-15T22:46:04.481Z
2024-11-15,5:30 PM,2,2,2,1,0,7,2024-11-15T23:43:16.454Z
2024-11-15,6:30 PM,1,0,3,4,0,8,2024-11-16T00:36:04.902Z
2024-11-16,10:30 AM,2,0,1,0,0,3,2024-11-16T16:30:23.475Z
2024-11-16,11:30 AM,2,1,4,0,3,10,2024-11-16T17:49:23.054Z
2024-11-16,12:30 PM,2,2,3,0,0,7,2024-11-16T18:33:14.486Z
2024-11-16,1:30 PM,3,3,5,0,0,11,2024-11-16T19:50:47.244Z
2024-11-16,2:30 PM,1,0,4,2,0,7,2024-11-16T20:46:18.814Z
2024-11-16,3:30 PM,1,1,3,2,0,7,2024-11-16T21:42:37.579Z
2024-11-16,5:30 PM,1,1,1,3,0,6,2024-11-16T23:26:57.209Z
2024-11-18,7:30 AM,2,0,0,0,0,2,2024-11-18T13:39:37.741Z
2024-11-18,8:30 AM,5,4,5,3,1,18,2024-11-18T14:31:48.960Z
2024-11-18,9:30 AM,8,2,6,2,3,21,2024-11-18T15:31:57.430Z
2024-11-18,10:30 AM,7,5,8,2,1,23,2024-11-18T16:37:56.375Z
2024-11-18,11:30 AM,2,4,15,1,0,22,2024-11-18T17:39:38.180Z
2024-11-18,12:30 PM,3,8,21,4,4,40,2024-11-18T18:40:21.846Z
2024-11-18,1:30 PM,9,8,17,9,0,43,2024-11-18T19:43:24.215Z
2024-11-18,2:30 PM,5,5,19,8,0,37,2024-11-18T20:45:20.929Z
2024-11-18,3:30 PM,7,4,14,5,1,31,2024-11-18T21:32:01.748Z
2024-11-18,4:30 PM,10,4,9,2,0,25,2024-11-18T22:43:22.579Z
2024-11-18,5:30 PM,9,4,13,0,0,26,2024-11-18T23:28:39.000Z
2024-11-18,6:30 PM,11,2,5,2,1,21,2024-11-19T00:33:25.216Z
2024-11-18,7:30 PM,8,1,4,2,0,15,2024-11-19T01:27:49.617Z
2024-11-18,8:30 PM,4,0,1,0,0,5,2024-11-19T02:51:28.043Z
2024-11-19,7:30 AM,1,0,0,0,0,1,2024-11-19T13:43:13.283Z
2024-11-19,8:30 AM,5,3,1,2,0,11,2024-11-19T14:38:12.906Z
2024-11-19,9:30 AM,7,6,6,4,1,24,2024-11-19T15:30:26.095Z
2024-11-19,10:30 AM,18,7,20,7,1,53,2024-11-19T16:41:35.296Z
2024-11-19,11:30 AM,6,7,16,6,0,35,2024-11-19T17:38:45.887Z
2024-11-19,12:30 PM,17,9,20,11,8,65,2024-11-19T18:36:01.889Z
2024-11-19,1:30 PM,9,5,30,6,4,54,2024-11-19T19:35:10.557Z
2024-11-19,2:30 PM,17,5,20,7,3,52,2024-11-19T20:37:31.068Z
2024-11-19,3:30 PM,21,5,16,7,0,49,2024-11-19T21:36:16.679Z
2024-11-19,4:30 PM,2,5,8,3,1,19,2024-11-19T22:33:26.307Z
2024-11-19,5:30 PM,5,5,8,6,0,24,2024-11-19T23:32:26.318Z
2024-11-19,6:30 PM,3,3,6,2,0,14,2024-11-20T00:31:55.402Z
2024-11-19,7:30 PM,7,2,4,0,0,13,2024-11-20T01:58:12.461Z
2024-11-19,8:30 PM,2,3,4,0,0,9,2024-11-20T02:34:43.067Z
2024-11-20,7:30 AM,2,0,0,0,0,2,2024-11-20T13:37:36.057Z
2024-11-20,9:30 AM,7,3,7,5,2,24,2024-11-20T15:22:57.004Z
2024-11-20,10:30 AM,5,7,9,6,1,28,2024-11-20T16:28:32.591Z
2024-11-20,11:30 AM,5,6,12,8,2,33,2024-11-20T17:41:53.447Z
2024-11-20,12:30 PM,15,12,23,11,2,63,2024-11-20T18:40:35.015Z
2024-11-20,1:30 PM,10,5,16,3,1,35,2024-11-20T19:41:58.488Z
2024-11-20,2:30 PM,11,6,15,5,4,41,2024-11-20T20:33:43.869Z
2024-11-20,5:30 PM,6,2,4,4,0,16,2024-11-20T23:04:34.920Z
2024-11-20,5:30 PM,2,1,4,7,0,14,2024-11-20T23:33:18.945Z
2024-11-20,6:30 PM,1,4,1,3,0,9,2024-11-21T00:52:19.257Z
2024-11-20,7:30 PM,0,3,4,4,0,11,2024-11-21T01:50:04.745Z
2024-11-20,8:30 PM,0,1,1,0,0,2,2024-11-21T02:48:58.296Z
2024-11-21,7:30 AM,4,0,0,1,0,5,2024-11-21T13:37:45.893Z
2024-11-21,8:30 AM,5,2,0,2,0,9,2024-11-21T14:27:00.729Z
2024-11-21,9:30 AM,6,4,6,3,0,19,2024-11-21T15:31:36.092Z
2024-11-21,10:30 AM,6,3,14,3,0,26,2024-11-21T16:26:30.588Z
2024-11-21,11:30 AM,8,7,13,2,1,31,2024-11-21T17:30:55.933Z
2024-11-21,12:30 PM,10,11,21,5,1,48,2024-11-21T18:38:51.952Z
2024-11-21,1:30 PM,7,6,11,2,2,28,2024-11-21T19:40:46.314Z
2024-11-21,2:30 PM,4,3,3,1,1,12,2024-11-21T20:41:11.083Z
2024-11-21,3:30 PM,4,6,9,5,0,24,2024-11-21T21:31:03.489Z
2024-11-21,4:30 PM,2,6,6,3,0,17,2024-11-21T22:31:30.786Z
2024-11-21,5:30 PM,2,2,7,4,1,16,2024-11-21T23:32:27.261Z
2024-11-21,6:30 PM,4,4,7,1,0,16,2024-11-22T00:30:02.508Z
2024-11-21,7:30 PM,3,1,2,1,0,7,2024-11-22T01:50:04.066Z
2024-11-21,8:30 PM,1,1,1,1,0,4,2024-11-22T02:42:58.071Z
2024-11-22,7:30 AM,3,2,0,0,0,5,2024-11-22T14:11:03.969Z
2024-11-22,8:30 AM,1,0,1,0,0,2,2024-11-22T14:48:14.114Z
2024-11-22,9:30 AM,2,1,0,0,0,3,2024-11-22T15:31:42.753Z
2024-11-22,10:30 AM,1,2,2,1,0,6,2024-11-22T16:33:34.237Z
2024-11-22,11:30 PM,5,1,3,2,1,12,2024-11-22T18:01:01.866Z
2024-11-22,12:30 PM,7,2,3,1,0,13,2024-11-22T18:35:13.729Z
2024-11-22,1:30 PM,7,2,2,1,0,12,2024-11-22T19:35:20.251Z
2024-11-22,2:30 PM,1,2,2,3,0,8,2024-11-22T20:34:00.997Z
2024-11-22,3:30 PM,3,2,8,3,0,16,2024-11-22T21:57:54.100Z
2024-11-22,4:30 PM,1,2,2,1,0,6,2024-11-22T22:37:30.603Z
2024-11-22,5:30 PM,1,1,3,0,0,5,2024-11-22T23:34:28.409Z
2024-11-22,6:30 PM,0,1,2,0,0,3,2024-11-23T00:49:11.354Z
2024-11-23,10:30 AM,3,0,1,0,0,4,2024-11-23T16:37:20.520Z
2024-11-23,11:30 AM,5,0,0,0,1,6,2024-11-23T17:35:30.044Z
2024-11-23,12:30 PM,5,0,2,0,0,7,2024-11-23T18:49:40.526Z
2024-11-23,1:30 PM,4,1,3,0,0,8,2024-11-23T19:52:39.843Z
2024-11-23,2:30 PM,4,1,1,1,0,7,2024-11-23T20:59:27.738Z
2024-11-23,3:30 PM,4,0,1,0,0,5,2024-11-23T21:34:43.957Z
2024-11-23,4:30 PM,3,0,2,0,0,5,2024-11-23T22:33:13.826Z
2024-11-25,7:30 AM,6,0,0,0,0,6,2024-11-25T13:36:34.344Z
2024-11-25,8:30 AM,5,2,4,1,0,12,2024-11-25T14:27:30.562Z
2024-11-25,9:30 AM,7,2,4,0,0,13,2024-11-25T15:13:25.314Z
2024-11-25,10:30 AM,5,1,6,4,1,17,2024-11-25T16:32:55.772Z
2024-11-25,11:30 AM,7,4,13,3,0,27,2024-11-25T17:31:19.344Z
2024-11-25,12:30 PM,15,7,16,7,1,46,2024-11-25T18:32:38.906Z
2024-11-25,1:30 PM,6,4,9,14,1,34,2024-11-25T19:35:45.050Z
2024-11-25,2:30 PM,6,2,10,2,1,21,2024-11-25T20:35:24.062Z
2024-11-25,3:30 PM,10,3,3,2,0,18,2024-11-25T21:36:45.973Z
2024-11-25,4:30 PM,6,1,6,5,0,18,2024-11-25T22:36:29.000Z
2024-11-25,5:30 PM,5,1,1,5,0,12,2024-11-25T23:32:33.481Z
2024-11-25,6:30 PM,2,0,2,0,1,5,2024-11-26T00:34:01.783Z
2024-11-25,7:30 PM,3,0,2,1,0,6,2024-11-26T02:40:16.205Z
2024-11-25,8:30 PM,1,1,0,0,0,2,2024-11-26T02:40:34.993Z
2024-11-26,7:30 AM,1,0,0,0,0,1,2024-11-26T14:17:41.445Z
2024-11-26,8:30 AM,3,0,0,0,0,3,2024-11-26T14:31:28.125Z
2024-11-26,9:30 AM,5,0,6,3,1,15,2024-11-26T15:42:37.708Z
2024-11-26,10:30 AM,10,3,9,3,1,26,2024-11-26T16:32:23.920Z
2024-11-26,11:30 AM,15,6,13,8,2,44,2024-11-26T17:34:20.220Z
2024-11-26,12:30 PM,15,4,15,10,0,44,2024-11-26T18:33:37.143Z
2024-11-26,1:30 PM,12,2,8,4,0,26,2024-11-26T19:32:48.165Z
2024-11-26,2:30 PM,10,1,7,7,1,26,2024-11-26T20:35:57.390Z
2024-11-26,3:30 PM,7,2,6,4,0,19,2024-11-26T21:32:16.364Z
2024-11-26,4:30 PM,5,3,5,0,1,14,2024-11-26T22:41:35.531Z
2024-11-26,5:30 PM,2,2,2,2,0,8,2024-11-26T23:39:54.833Z
2024-11-26,6:30 PM,2,2,2,2,1,9,2024-11-27T00:36:06.975Z
2024-11-26,7:30 PM,2,0,2,1,0,5,2024-11-27T01:26:22.663Z
2024-11-26,8:30 PM,5,1,3,1,0,10,2024-11-27T02:35:14.983Z
2024-12-02,7:30 AM,3,0,3,1,0,7,2024-12-02T13:49:03.513Z
2024-12-02,8:30 AM,3,2,5,1,1,12,2024-12-02T14:24:56.979Z
2024-12-02,9:30 AM,5,4,7,5,0,21,2024-12-02T15:54:24.348Z
2024-12-02,10:30 AM,16,5,18,10,1,50,2024-12-02T16:38:06.711Z
2024-12-02,11:30 AM,12,10,15,8,2,47,2024-12-02T17:51:53.994Z
2024-12-02,12:30 PM,10,4,20,14,1,49,2024-12-02T19:05:08.666Z
2024-12-02,1:30 PM,16,5,21,10,1,53,2024-12-02T19:38:20.156Z
2024-12-02,3:30 PM,5,3,14,6,1,29,2024-12-02T21:32:39.444Z
2024-12-02,4:30 PM,6,3,11,5,0,25,2024-12-02T22:42:06.944Z
2024-12-02,2:30 PM,10,6,18,5,2,41,2024-12-02T22:46:38.309Z
2024-12-02,5:30 PM,6,5,8,2,2,23,2024-12-02T23:37:51.354Z
2024-12-02,6:30 PM,7,2,1,2,1,13,2024-12-03T01:04:13.075Z
2024-12-02,7:30 PM,6,0,1,0,0,7,2024-12-03T01:41:30.578Z
2024-12-02,8:30 PM,3,0,2,0,0,5,2024-12-03T02:43:35.984Z
2024-12-03,7:30 AM,1,0,0,0,0,1,2024-12-03T13:34:15.160Z
2024-12-03,8:30 AM,4,3,1,1,0,9,2024-12-03T14:33:28.285Z
2024-12-03,9:30 AM,3,5,8,1,2,19,2024-12-03T15:25:14.066Z
2024-12-03,10:30 AM,12,10,20,4,2,48,2024-12-03T16:31:51.076Z
2024-12-03,11:30 AM,11,7,17,4,0,39,2024-12-03T17:43:57.641Z
2024-12-03,12:30 PM,11,9,22,3,2,47,2024-12-03T18:45:46.909Z
2024-12-03,1:30 PM,14,7,19,4,0,44,2024-12-03T19:35:11.225Z
2024-12-03,2:30 PM,17,7,19,3,1,47,2024-12-03T20:34:08.348Z
2024-12-03,3:30 PM,19,5,6,7,3,40,2024-12-03T21:32:00.819Z
2024-12-03,4:30 PM,4,6,5,3,1,19,2024-12-03T22:35:58.715Z
2024-12-03,5:30 PM,3,4,2,2,1,12,2024-12-03T23:34:28.989Z
2024-12-03,6:30 PM,4,1,2,4,0,11,2024-12-04T00:42:13.618Z
2024-12-03,7:30 PM,5,0,3,0,0,8,2024-12-04T01:38:52.910Z
2024-12-04,7:30 AM,3,2,3,1,1,10,2024-12-04T14:03:53.478Z
2024-12-04,8:30 AM,7,4,5,3,0,19,2024-12-04T14:35:26.841Z
2024-12-04,9:30 AM,7,4,4,2,1,18,2024-12-04T15:33:54.669Z
2024-12-04,10:30 AM,10,7,10,5,0,32,2024-12-04T16:36:35.585Z
2024-12-04,11:30 AM,12,5,21,5,0,43,2024-12-04T18:05:56.815Z
2024-12-04,12:30 PM,10,7,26,12,2,57,2024-12-04T18:39:25.571Z
2024-12-04,1:30 PM,10,4,20,15,1,50,2024-12-04T19:39:49.354Z
2024-12-04,2:30 PM,7,2,8,8,0,25,2024-12-04T20:34:14.359Z
2024-12-04,3:30 PM,5,1,6,3,1,16,2024-12-04T21:38:33.600Z
2024-12-04,4:30 PM,6,2,5,2,0,15,2024-12-04T23:04:45.652Z
2024-12-04,5:30 PM,5,1,4,5,0,15,2024-12-04T23:58:30.918Z
2024-12-04,6:30 PM,2,5,1,2,0,10,2024-12-05T00:58:42.794Z
2024-12-04,7:30 PM,3,2,0,2,0,7,2024-12-05T01:53:16.747Z
2024-12-05,7:30 AM,3,0,0,0,0,3,2024-12-05T13:43:17.255Z
2024-12-05,8:30 AM,6,1,3,1,0,11,2024-12-05T14:38:16.149Z
2024-12-05,9:30 AM,10,3,7,3,2,25,2024-12-05T15:30:47.394Z
2024-12-05,10:30 AM,10,8,16,2,3,39,2024-12-05T16:32:04.910Z
2024-12-05,11:30 AM,12,7,22,2,1,44,2024-12-05T17:37:53.009Z
2024-12-05,12:30 PM,18,7,22,5,1,53,2024-12-05T18:37:38.828Z
2024-12-05,1:30 PM,14,5,28,1,1,49,2024-12-05T19:37:58.259Z
2024-12-05,2:30 PM,19,6,28,3,1,57,2024-12-05T20:35:23.689Z
2024-12-05,3:30 PM,20,3,13,5,2,43,2024-12-05T21:38:17.512Z
2024-12-05,4:30 PM,8,4,3,2,1,18,2024-12-05T22:29:09.376Z
2024-12-05,5:30 PM,3,2,3,2,0,10,2024-12-05T23:30:37.346Z
2024-12-05,6:30 PM,6,1,4,2,1,14,2024-12-06T00:36:51.933Z
2024-12-05,7:30 PM,3,1,5,3,0,12,2024-12-06T01:33:59.780Z
2024-12-06,7:30 AM,1,0,1,0,0,2,2024-12-06T13:45:53.422Z
2024-12-06,8:30 AM,1,1,0,0,0,2,2024-12-06T14:27:29.032Z
2024-12-06,9:30 AM,3,1,2,1,0,7,2024-12-06T15:34:01.156Z
2024-12-06,10:30 AM,1,1,3,1,0,6,2024-12-06T16:30:51.733Z
2024-12-06,11:30 AM,5,1,3,3,0,12,2024-12-06T18:30:39.554Z
2024-12-06,12:30 PM,3,1,3,1,0,8,2024-12-06T18:31:23.410Z
2024-12-06,1:30 PM,7,2,2,2,0,13,2024-12-06T19:33:31.776Z
2024-12-06,2:30 PM,5,1,3,3,0,12,2024-12-06T20:34:48.482Z
2024-12-06,3:30 PM,4,2,2,5,0,13,2024-12-06T21:51:36.694Z
2024-12-06,4:30 PM,3,2,2,2,1,10,2024-12-06T22:48:58.626Z
2024-12-06,5:30 PM,2,1,3,2,0,8,2024-12-07T00:31:13.836Z
2024-12-06,6:30 PM,1,0,4,2,0,7,2024-12-07T00:31:40.053Z
2024-12-07,10:30 AM,5,1,0,0,0,6,2024-12-07T16:39:45.769Z
2024-12-07,11:30 AM,5,1,0,0,0,6,2024-12-07T17:39:15.034Z
2024-12-07,12:30 PM,6,1,3,0,0,10,2024-12-07T18:50:06.652Z
2024-12-07,1:30 PM,5,0,2,0,0,7,2024-12-07T19:27:58.168Z
2024-12-07,2:30 PM,4,1,2,2,0,9,2024-12-07T20:31:15.001Z
2024-12-07,3:30 PM,2,3,1,2,0,8,2024-12-07T21:55:56.190Z
2024-12-09,7:30 AM,2,0,0,0,1,3,2024-12-09T13:39:35.323Z
2024-12-09,8:30 AM,5,2,0,0,0,7,2024-12-09T14:34:20.714Z
2024-12-09,9:30 AM,4,2,4,2,1,13,2024-12-09T15:39:52.974Z
2024-12-09,10:30 AM,7,3,11,3,0,24,2024-12-09T16:15:59.756Z
2024-12-09,11:30 AM,9,4,16,15,0,44,2024-12-09T18:10:29.222Z
2024-12-09,12:30 PM,8,5,13,12,2,40,2024-12-09T18:40:34.582Z
2024-12-09,1:30 PM,9,5,12,9,0,35,2024-12-09T19:40:17.516Z
2024-12-09,2:30 PM,9,1,8,4,2,24,2024-12-09T20:35:42.786Z
2024-12-09,3:30 PM,10,3,7,2,1,23,2024-12-09T21:32:01.064Z
2024-12-09,4:30 PM,7,3,10,2,2,24,2024-12-09T22:34:01.331Z
2024-12-09,5:30 PM,10,2,5,1,1,19,2024-12-09T23:33:10.105Z
2024-12-09,6:30 PM,7,2,3,2,2,16,2024-12-10T00:44:59.108Z
2024-12-09,7:30 PM,6,0,5,0,1,12,2024-12-10T01:29:27.120Z
2024-12-10,7:30 AM,1,0,0,0,0,1,2024-12-10T14:18:37.939Z
2024-12-10,8:30 AM,1,0,0,0,0,1,2024-12-10T14:55:15.766Z
2024-12-10,9:30 AM,3,1,2,0,0,6,2024-12-10T15:29:50.373Z
2024-12-10,10:30 AM,4,2,4,1,1,12,2024-12-10T16:31:55.313Z
2024-12-10,11:30 AM,4,6,8,2,1,21,2024-12-10T17:40:00.505Z
2024-12-10,12:30 PM,7,8,10,2,0,27,2024-12-10T18:46:03.654Z
2024-12-10,1:30 PM,12,5,11,2,0,30,2024-12-10T19:46:29.871Z
2024-12-10,2:30 PM,10,5,8,7,1,31,2024-12-10T20:36:34.736Z
2024-12-10,3:30 PM,7,6,3,1,1,18,2024-12-10T21:40:40.875Z
2024-12-10,4:30 PM,5,6,2,0,0,13,2024-12-10T22:36:03.861Z
2024-12-10,5:30 PM,7,3,4,0,1,15,2024-12-10T23:28:51.884Z
2024-12-10,6:30 PM,6,2,10,3,1,22,2024-12-11T00:32:12.189Z
2024-12-10,7:30 PM,6,1,3,2,0,12,2024-12-11T01:34:57.802Z
2024-12-11,7:30 AM,1,0,0,0,0,1,2024-12-11T14:14:44.898Z
2024-12-11,8:30 AM,3,1,2,1,0,7,2024-12-11T14:19:58.073Z
2024-12-11,9:30 AM,2,2,8,0,0,12,2024-12-11T15:44:31.452Z
2024-12-11,10:30 AM,12,5,20,3,1,41,2024-12-11T16:42:17.203Z
2024-12-11,11:30 AM,6,5,19,5,1,36,2024-12-11T17:44:33.521Z
2024-12-11,12:30 PM,13,8,20,5,0,46,2024-12-11T18:33:11.665Z
2024-12-11,1:30 PM,6,9,17,8,1,41,2024-12-11T20:05:08.979Z
2024-12-11,2:30 PM,12,6,8,2,2,30,2024-12-11T20:45:13.382Z
2024-12-11,3:30 PM,3,3,8,7,0,21,2024-12-11T21:49:38.870Z
2024-12-11,4:30 PM,5,3,2,5,0,15,2024-12-11T22:48:42.531Z
2024-12-11,5:30 PM,7,3,5,0,0,15,2024-12-11T23:53:02.201Z
2024-12-11,6:30 PM,6,2,3,5,0,16,2024-12-12T00:28:52.863Z
2024-12-11,7:30 PM,5,1,2,3,0,11,2024-12-12T01:30:39.965Z
2024-12-11,8:30 PM,6,0,1,3,0,10,2024-12-12T02:37:05.414Z
2024-12-12,7:30 AM,3,0,1,1,0,5,2024-12-12T13:49:24.025Z
2024-12-12,8:30 AM,6,0,3,1,0,10,2024-12-12T14:30:25.481Z
2024-12-12,9:30 AM,7,1,1,1,0,10,2024-12-12T15:20:44.056Z
2024-12-12,10:30 AM,12,3,15,4,2,36,2024-12-12T16:33:26.994Z
2024-12-12,11:30 AM,9,5,7,4,1,26,2024-12-12T17:54:58.169Z
2024-12-12,12:30 PM,5,6,6,1,0,18,2024-12-12T18:36:59.483Z
2024-12-12,1:30 PM,1,7,9,3,1,21,2024-12-12T19:33:43.847Z
2024-12-12,2:30 PM,7,4,5,2,0,18,2024-12-12T20:41:33.027Z
2024-12-12,3:30 PM,7,4,5,1,1,18,2024-12-12T21:31:42.606Z
2024-12-12,4:30 PM,5,2,9,2,0,18,2024-12-12T22:43:07.430Z
2024-12-12,5:30 PM,6,4,7,1,0,18,2024-12-12T23:31:38.646Z
2024-12-12,6:30 PM,5,2,1,1,0,9,2024-12-13T00:34:08.720Z
2024-12-12,7:30 PM,3,2,1,2,0,8,2024-12-13T01:46:47.049Z
2024-12-12,8:30 PM,2,2,1,0,0,5,2024-12-13T02:32:44.936Z
2024-12-13,7:30 AM,1,0,0,0,0,1,2024-12-13T13:36:27.360Z
2024-12-13,8:30 AM,1,0,0,0,0,1,2024-12-13T14:29:01.477Z
2024-12-13,9:30 AM,3,0,0,0,0,3,2024-12-13T15:36:51.529Z
2024-12-13,10:30 AM,3,1,3,0,0,7,2024-12-13T16:52:00.716Z
2024-12-13,12:30 PM,3,2,3,0,0,8,2024-12-13T18:05:56.717Z
2024-12-13,1:30 PM,3,2,1,2,1,9,2024-12-13T19:28:04.006Z
2024-12-13,2:30 PM,4,2,3,1,1,11,2024-12-13T20:35:17.819Z
2024-12-13,3:30 PM,3,0,3,0,0,6,2024-12-13T21:38:25.625Z
2024-12-13,4:30 PM,1,0,1,0,0,2,2024-12-13T22:45:56.405Z
2024-12-13,5:30 PM,0,0,0,1,0,1,2024-12-13T23:36:17.145Z
2024-12-13,6:30 PM,1,0,0,0,0,1,2024-12-14T00:32:50.956Z
2024-12-14,10:30 AM,1,0,0,0,0,1,2024-12-14T16:40:34.793Z
2024-12-14,11:30 AM,3,1,0,0,0,4,2024-12-14T17:34:23.907Z
2024-12-14,12:30 PM,3,1,1,0,0,5,2024-12-14T18:32:12.898Z
2024-12-14,1:30 PM,3,1,1,0,0,5,2024-12-14T20:01:16.994Z
2024-12-14,2:30 PM,2,0,0,0,0,2,2024-12-14T20:36:42.112Z
2024-12-14,3:30 PM,2,1,0,0,0,3,2024-12-14T21:32:15.862Z
2024-12-14,4:30 PM,2,0,0,0,0,2,2024-12-14T22:35:11.009Z
2024-12-16,7:30 AM,1,0,0,0,0,1,2024-12-16T13:52:00.848Z
2024-12-16,8:30 AM,1,0,0,0,0,1,2024-12-16T14:29:12.373Z
2024-12-16,10:30 AM,2,0,0,3,0,5,2024-12-16T16:36:06.484Z
2024-12-16,11:30 AM,2,0,0,0,0,2,2024-12-16T18:14:27.802Z
2024-12-16,12:30 PM,0,0,0,2,0,2,2024-12-16T18:34:33.126Z
2024-12-16,1:30 PM,1,0,0,0,0,1,2024-12-16T19:39:24.759Z
2024-12-16,2:30 PM,0,0,0,0,0,0,2024-12-16T20:37:19.479Z
2024-12-16,3:30 PM,1,0,0,0,0,1,2024-12-16T21:39:10.569Z
2024-12-16,4:30 PM,1,0,0,0,0,1,2024-12-16T22:27:49.701Z
2024-12-16,5:30 PM,1,0,0,0,0,1,2024-12-16T23:24:53.277Z
2024-12-17,7:30 AM,0,0,0,0,0,0,2024-12-17T13:31:56.666Z
2024-12-17,8:30 AM,1,0,0,0,0,1,2024-12-17T14:28:01.421Z
2024-12-17,9:30 AM,1,0,0,0,0,1,2024-12-17T15:27:16.151Z
2024-12-17,10:30 AM,1,0,0,0,0,1,2024-12-17T16:35:16.179Z
2024-12-17,11:30 AM,2,0,0,0,0,2,2024-12-17T17:34:14.938Z
2024-12-17,12:30 PM,2,0,0,0,0,2,2024-12-17T18:33:49.560Z
2024-12-17,1:30 PM,3,1,0,0,0,4,2024-12-17T19:47:19.691Z
2024-12-17,2:30 PM,4,1,1,0,0,6,2024-12-17T20:49:28.602Z
2024-12-17,3:30 PM,4,0,1,0,0,5,2024-12-17T21:35:11.264Z
2024-12-17,4:30 PM,3,0,2,0,0,5,2024-12-17T23:11:55.940Z
2024-12-17,5:30 PM,1,0,2,0,0,3,2024-12-17T23:38:29.760Z
2024-12-19,7:30 AM,0,0,0,0,0,0,2024-12-19T14:17:02.303Z
2024-12-19,8:30 AM,0,0,0,0,0,0,2024-12-19T14:36:25.242Z
2024-12-19,9:30 AM,2,0,0,0,0,2,2024-12-19T15:37:46.713Z
2024-12-19,10:30 AM,2,0,0,0,0,2,2024-12-19T16:33:43.509Z
2024-12-19,11:30 AM,0,0,1,0,0,1,2024-12-19T17:43:10.156Z
2024-12-19,12:30 PM,1,0,1,0,0,2,2024-12-19T18:46:22.668Z
2024-12-19,1:30 PM,2,1,1,0,0,4,2024-12-19T19:32:51.975Z
2024-12-19,2:30 PM,2,0,2,0,0,4,2024-12-19T21:03:41.091Z
2024-12-19,3:30 PM,2,1,2,0,0,5,2024-12-19T21:42:54.881Z
2024-12-19,4:30 PM,1,0,0,0,0,1,2024-12-19T23:16:05.139Z
2024-12-19,5:30 PM,1,0,0,0,0,1,2024-12-19T23:48:14.326Z
2024-12-20,7:30 AM,1,0,0,0,0,1,2024-12-20T14:30:59.779Z
2024-12-20,8:30 AM,2,0,0,0,0,2,2024-12-20T14:31:22.315Z
2024-12-20,9:30 AM,2,0,0,0,0,2,2024-12-20T15:32:35.496Z
2024-12-20,10:30 AM,3,2,0,0,0,5,2024-12-20T16:33:42.589Z
2024-12-20,12:30 PM,2,1,0,0,0,3,2024-12-20T18:27:04.543Z
2024-12-20,1:30 PM,1,1,0,0,0,2,2024-12-20T19:31:01.124Z
2024-12-20,2:30 PM,1,0,3,0,0,4,2024-12-20T20:40:55.488Z
2024-12-20,3:30 PM,0,0,1,0,0,1,2024-12-20T21:39:42.969Z
2024-12-20,4:30 PM,0,0,1,0,1,2,2024-12-20T22:29:41.798Z
2024-12-20,4:30 PM,0,0,0,0,0,0,2024-12-20T22:52:58.781Z
2024-12-20,5:30 PM,1,0,0,0,0,1,2024-12-20T23:30:52.254Z
2025-01-02,9:30 AM,0,0,0,0,0,0,2025-01-02T15:27:32.842Z
2025-01-02,8:30 AM,0,0,0,0,0,0,2025-01-02T15:27:50.879Z
2025-01-02,7:30 AM,0,0,0,0,0,0,2025-01-02T15:28:09.015Z
2025-01-02,10:30 AM,1,0,0,0,0,1,2025-01-02T16:31:01.125Z
2025-01-02,11:30 AM,0,0,0,0,0,0,2025-01-02T17:41:41.168Z
2025-01-02,12:30 PM,0,0,0,0,0,0,2025-01-02T19:30:49.048Z
2025-01-02,2:30 PM,0,0,0,0,0,0,2025-01-02T20:39:33.463Z
2025-01-02,3:30 PM,0,0,0,0,0,0,2025-01-02T21:32:56.680Z
2025-01-02,4:30 PM,1,0,0,0,0,1,2025-01-02T22:44:32.547Z
2025-01-02,5:30 PM,0,0,0,0,0,0,2025-01-02T23:51:07.427Z
2025-01-03,7:30 AM,1,0,0,0,0,1,2025-01-03T13:32:11.130Z
2025-01-03,8:30 AM,1,0,0,0,0,1,2025-01-03T14:30:23.893Z
2025-01-03,8:30 AM,1,0,0,0,0,1,2025-01-03T14:30:25.484Z
2025-01-03,9:30 AM,2,0,0,0,1,3,2025-01-03T15:50:15.268Z
2025-01-03,10:30 AM,1,0,0,0,0,1,2025-01-03T16:59:53.214Z
2025-01-03,11:30 AM,1,0,0,0,0,1,2025-01-03T17:57:02.890Z
2025-01-03,12:30 PM,2,0,1,0,0,3,2025-01-03T18:57:04.426Z
2025-01-03,1:30 PM,2,0,1,1,0,4,2025-01-03T19:44:51.448Z
2025-01-03,2:30 PM,2,0,0,0,0,2,2025-01-03T20:31:07.423Z
2025-01-03,3:30 PM,1,0,0,0,0,1,2025-01-03T21:27:02.669Z
2025-01-03,4:30 PM,2,0,0,0,0,2,2025-01-03T22:31:21.594Z
2025-01-03,5:30 PM,1,0,0,0,1,2,2025-01-03T23:29:23.373Z
2025-01-06,7:30 AM,1,0,0,0,0,1,2025-01-06T13:51:22.887Z
2025-01-06,8:30 AM,1,0,1,1,0,3,2025-01-06T14:59:23.752Z
2025-01-06,9:30 AM,1,0,3,2,0,6,2025-01-06T15:34:20.226Z
2025-01-06,10:30 AM,2,0,1,1,0,4,2025-01-06T16:58:33.159Z
2025-01-06,10:30 AM,2,0,0,2,0,4,2025-01-06T17:00:08.824Z
2025-01-06,11:30 AM,3,0,1,2,0,6,2025-01-06T17:43:58.698Z
2025-01-06,12:30 PM,3,0,0,2,0,5,2025-01-06T18:46:07.692Z
2025-01-06,1:30 PM,4,0,0,0,0,4,2025-01-06T19:42:09.217Z
2025-01-06,2:30 PM,1,0,1,0,0,2,2025-01-06T20:38:57.153Z
2025-01-06,3:30 PM,2,1,0,0,1,4,2025-01-06T21:29:39.607Z
2025-01-06,4:30 PM,0,0,0,0,0,0,2025-01-06T22:39:18.621Z
2025-01-06,5:30 PM,0,0,1,0,0,1,2025-01-06T23:47:55.941Z
2025-01-07,7:30 AM,0,0,0,0,0,0,2025-01-07T15:27:40.789Z
2025-01-07,8:30 AM,2,0,0,1,0,3,2025-01-07T15:28:14.164Z
2025-01-07,9:30 AM,2,0,0,1,0,3,2025-01-07T15:28:35.134Z
2025-01-07,10:30 AM,1,0,0,0,0,1,2025-01-07T16:30:36.400Z
2025-01-07,11:30 AM,2,0,1,0,0,3,2025-01-07T17:47:51.741Z
2025-01-07,12:30 PM,4,0,0,1,0,5,2025-01-07T18:53:01.126Z
2025-01-07,2:30 PM,4,0,1,0,0,5,2025-01-07T20:36:42.043Z
2025-01-07,3:30 PM,4,0,1,0,0,5,2025-01-07T21:27:43.732Z
2025-01-07,4:30 PM,1,0,1,0,2,4,2025-01-07T22:27:59.598Z
2025-01-07,5:30 PM,0,0,1,1,0,2,2025-01-07T23:26:32.118Z
2025-01-08,7:30 AM,0,0,0,0,0,0,2025-01-08T13:41:00.087Z
2025-01-08,8:30 AM,2,0,1,1,0,4,2025-01-08T14:55:46.277Z
2025-01-08,9:30 AM,3,0,0,0,1,4,2025-01-08T15:29:42.383Z
2025-01-08,10:30 AM,6,0,0,0,0,6,2025-01-08T17:35:11.529Z
2025-01-08,11:30 AM,3,0,1,0,2,6,2025-01-08T17:35:31.063Z
2025-01-08,12:30 PM,2,0,3,0,0,5,2025-01-08T18:48:04.482Z
2025-01-08,1:30 PM,2,0,2,0,0,4,2025-01-08T19:41:33.019Z
2025-01-08,2:30 PM,1,0,4,0,2,7,2025-01-08T20:32:38.130Z
2025-01-08,3:30 PM,0,0,3,0,0,3,2025-01-08T21:30:43.390Z
2025-01-08,4:30 PM,1,0,1,0,0,2,2025-01-08T22:34:51.596Z
2025-01-08,5:30 PM,0,0,1,0,0,1,2025-01-08T23:36:48.208Z
2025-01-09,7:30 AM,0,0,0,0,0,0,2025-01-09T14:49:24.678Z
2025-01-09,8:30 AM,1,0,0,0,0,1,2025-01-09T14:49:39.940Z
2025-01-09,9:30 AM,0,0,0,0,0,0,2025-01-09T15:22:17.120Z
2025-01-09,10:30 AM,2,0,0,0,0,2,2025-01-09T17:43:40.567Z
2025-01-09,11:30 AM,0,1,0,0,0,1,2025-01-09T17:43:54.470Z
2025-01-09,12:30 PM,2,1,0,0,0,3,2025-01-09T18:37:30.959Z
2025-01-09,1:30 PM,1,1,0,0,0,2,2025-01-09T19:31:16.250Z
2025-01-09,2:30 PM,2,0,0,0,1,3,2025-01-09T20:31:44.183Z
2025-01-09,3:30 PM,1,0,0,0,0,1,2025-01-09T21:31:41.232Z
2025-01-13,7:30 AM,2,0,0,1,0,3,2025-01-13T14:21:35.864Z
2025-01-13,8:30 AM,3,0,3,2,0,8,2025-01-13T14:33:04.166Z
2025-01-13,9:30 AM,3,5,4,3,2,17,2025-01-13T15:30:39.317Z
2025-01-13,10:30 AM,6,3,7,3,4,23,2025-01-13T16:37:17.965Z
2025-01-13,11:30 AM,18,7,15,8,2,50,2025-01-13T18:02:16.687Z
2025-01-13,12:30 PM,7,5,19,0,4,35,2025-01-13T19:01:10.508Z
2025-01-13,1:30 PM,19,5,17,1,3,45,2025-01-13T19:36:36.772Z
2025-01-13,2:30 PM,9,7,9,2,0,27,2025-01-13T20:39:31.849Z
2025-01-13,3:30 PM,10,4,6,3,0,23,2025-01-13T21:31:18.147Z
2025-01-13,4:30 PM,5,6,5,2,3,21,2025-01-13T22:32:33.544Z
2025-01-13,5:30 PM,2,3,4,1,2,12,2025-01-13T23:34:36.860Z
2025-01-13,6:30 PM,3,5,1,0,1,10,2025-01-14T00:34:44.949Z
2025-01-13,7:30 PM,2,1,1,0,0,4,2025-01-14T01:35:38.648Z
2025-01-13,8:30 PM,1,0,0,0,0,1,2025-01-14T02:33:29.935Z
2025-01-14,7:30 AM,2,0,0,0,1,3,2025-01-14T13:41:20.900Z
2025-01-14,8:30 AM,8,2,4,0,2,16,2025-01-14T15:04:37.830Z
2025-01-14,9:30 AM,6,2,3,0,3,14,2025-01-14T15:31:31.165Z
2025-01-14,10:30 AM,9,2,9,2,0,22,2025-01-14T16:36:55.281Z
2025-01-14,11:30 AM,11,15,2,3,0,31,2025-01-14T17:39:56.341Z
2025-01-14,12:30 PM,17,8,16,5,3,49,2025-01-14T18:36:40.594Z
2025-01-14,1:30 PM,11,3,14,5,1,34,2025-01-14T19:35:02.298Z
2025-01-14,2:30 PM,15,4,22,2,2,45,2025-01-14T20:46:28.402Z
2025-01-14,3:30 PM,13,5,8,0,1,27,2025-01-14T21:38:22.802Z
2025-01-14,4:30 PM,10,3,5,0,2,20,2025-01-14T22:31:06.843Z
2025-01-14,5:30 PM,10,3,8,1,0,22,2025-01-14T23:33:05.246Z
2025-01-14,6:30 PM,5,2,5,1,0,13,2025-01-15T00:35:48.071Z
2025-01-14,7:30 PM,3,1,3,2,0,9,2025-01-15T01:32:27.786Z
2025-01-14,8:30 PM,3,2,3,0,0,8,2025-01-15T02:31:54.182Z
2025-01-15,7:30 AM,3,0,0,0,0,3,2025-01-15T13:33:15.381Z
2025-01-15,8:30 AM,2,2,5,2,0,11,2025-01-15T14:35:08.687Z
2025-01-15,9:30 AM,5,5,9,0,2,21,2025-01-15T15:25:54.238Z
2025-01-15,10:30 AM,16,4,20,2,1,43,2025-01-15T17:09:55.228Z
2025-01-15,11:30 AM,14,3,18,3,2,40,2025-01-15T17:36:29.457Z
2025-01-15,12:30 PM,22,6,40,4,4,76,2025-01-15T18:58:45.210Z
2025-01-15,2:30 PM,9,6,13,3,2,33,2025-01-15T20:38:58.688Z
2025-01-15,3:30 PM,8,1,2,2,0,13,2025-01-15T21:41:54.755Z
2025-01-15,4:30 PM,7,4,1,2,0,14,2025-01-15T23:14:01.704Z
2025-01-15,5:30 PM,8,2,9,1,0,20,2025-01-15T23:38:07.089Z
2025-01-15,7:30 PM,3,2,3,1,1,10,2025-01-16T01:32:11.275Z
2025-01-15,8:30 PM,2,1,3,0,1,7,2025-01-16T02:27:53.201Z
2025-01-16,7:30 AM,0,0,0,1,0,1,2025-01-16T14:04:59.197Z
2025-01-16,8:30 AM,7,4,5,1,2,19,2025-01-16T15:13:15.596Z
2025-01-16,9:30 AM,6,2,5,1,0,14,2025-01-16T15:50:05.900Z
2025-01-16,10:30 AM,11,4,15,1,0,31,2025-01-16T17:21:27.715Z
2025-01-16,11:30 AM,11,2,14,1,1,29,2025-01-16T17:45:24.700Z
2025-01-16,12:30 PM,18,7,16,4,1,46,2025-01-16T18:35:59.504Z
2025-01-16,1:30 PM,13,5,17,4,0,39,2025-01-16T19:44:32.821Z
2025-01-16,2:30 PM,10,5,13,2,2,32,2025-01-16T20:32:20.297Z
2025-01-16,3:30 PM,7,5,10,2,0,24,2025-01-16T21:49:56.639Z
2025-01-16,4:30 PM,10,2,3,10,2,27,2025-01-16T22:37:49.930Z
2025-01-16,5:30 PM,4,0,5,3,1,13,2025-01-16T23:40:17.426Z
2025-01-16,6:30 PM,2,4,4,0,0,10,2025-01-17T00:31:27.572Z
2025-01-16,8:30 PM,2,2,1,1,0,6,2025-01-17T02:33:40.119Z
2025-01-17,7:30 AM,1,0,0,0,0,1,2025-01-17T13:38:51.271Z
2025-01-17,8:30 AM,3,2,1,0,0,6,2025-01-17T14:40:54.090Z
2025-01-17,9:30 AM,5,2,1,0,0,8,2025-01-17T15:31:08.430Z
2025-01-17,10:30 AM,8,3,0,0,0,11,2025-01-17T16:45:11.221Z
2025-01-17,11:30 AM,7,2,3,0,0,12,2025-01-17T17:39:09.167Z
2025-01-17,12:30 PM,8,6,7,0,2,23,2025-01-17T18:51:56.686Z
2025-01-17,1:30 PM,7,3,4,1,0,15,2025-01-17T19:44:44.914Z
2025-01-17,2:30 PM,6,1,6,2,0,15,2025-01-17T20:49:55.425Z
2025-01-17,3:30 PM,6,1,3,2,1,13,2025-01-17T21:33:00.332Z
2025-01-17,4:30 PM,5,0,2,2,0,9,2025-01-17T22:35:10.450Z
2025-01-17,5:30 PM,2,1,0,2,0,5,2025-01-17T23:37:29.731Z
2025-01-17,6:30 PM,1,2,1,3,1,8,2025-01-18T00:40:21.945Z
2025-01-18,10:30 AM,3,0,0,1,1,5,2025-01-18T16:41:49.096Z
2025-01-18,11:30 AM,2,0,0,1,0,3,2025-01-18T17:33:04.267Z
2025-01-18,12:30 PM,4,0,1,1,0,6,2025-01-18T18:39:44.841Z
2025-01-18,1:30 PM,1,1,3,0,0,5,2025-01-18T19:40:14.077Z
2025-01-18,2:30 PM,9,1,4,0,0,14,2025-01-18T20:28:15.992Z
2025-01-18,3:30 PM,3,3,1,0,0,7,2025-01-18T21:50:34.103Z
2025-01-18,4:30 PM,2,5,1,0,0,8,2025-01-18T22:47:09.402Z
2025-01-21,7:30 AM,6,0,0,0,0,6,2025-01-21T13:51:08.209Z
2025-01-21,8:30 AM,7,1,5,0,0,13,2025-01-21T14:48:15.364Z
2025-01-21,9:30 AM,5,4,7,0,0,16,2025-01-21T15:54:09.792Z
2025-01-21,10:30 AM,4,4,11,0,0,19,2025-01-21T16:36:28.758Z
2025-01-21,11:30 AM,18,7,15,6,1,47,2025-01-21T17:35:27.416Z
2025-01-21,12:30 PM,19,11,21,7,4,62,2025-01-21T18:36:47.714Z
2025-01-21,1:30 PM,10,8,18,1,1,38,2025-01-21T19:40:06.479Z
2025-01-21,2:30 PM,11,8,11,2,2,34,2025-01-21T20:42:04.992Z
2025-01-21,3:30 PM,10,3,12,3,2,30,2025-01-21T21:38:12.534Z
2025-01-21,4:30 PM,10,4,8,3,2,27,2025-01-21T22:30:16.114Z
2025-01-21,5:30 PM,10,2,8,0,0,20,2025-01-21T23:46:26.778Z
2025-01-21,6:30 PM,9,5,5,2,1,22,2025-01-22T00:28:16.037Z
2025-01-21,7:30 PM,3,2,2,1,0,8,2025-01-22T01:52:31.798Z
2025-01-21,8:30 PM,2,1,0,3,2,8,2025-01-22T02:43:20.393Z
2025-01-22,7:30 AM,2,0,0,0,0,2,2025-01-22T13:51:10.625Z
2025-01-22,8:30 AM,3,2,10,2,0,17,2025-01-22T14:28:38.177Z
2025-01-22,9:30 AM,3,6,8,2,0,19,2025-01-22T15:53:27.804Z
2025-01-22,10:30 AM,6,5,15,4,1,31,2025-01-22T16:33:08.181Z
2025-01-22,11:30 AM,10,6,26,4,2,48,2025-01-22T17:55:00.654Z
2025-01-22,12:30 PM,12,11,28,11,2,64,2025-01-22T18:42:56.928Z
2025-01-22,1:30 PM,5,3,13,5,2,28,2025-01-22T19:32:05.096Z
2025-01-22,3:30 PM,7,6,8,3,0,24,2025-01-22T21:37:42.935Z
2025-01-22,4:30 PM,7,3,8,3,0,21,2025-01-22T22:42:29.896Z
2025-01-22,5:30 PM,6,3,7,3,0,19,2025-01-22T23:37:11.763Z
2025-01-22,6:30 PM,2,4,4,2,0,12,2025-01-23T00:38:50.797Z
2025-01-22,8:30 PM,2,2,3,2,0,9,2025-01-23T02:27:27.860Z
2025-01-23,7:30 AM,3,0,1,0,1,5,2025-01-23T13:46:57.978Z
2025-01-23,8:30 AM,6,2,4,0,0,12,2025-01-23T14:45:00.262Z
2025-01-23,9:30 AM,5,3,6,0,0,14,2025-01-23T15:43:42.907Z
2025-01-23,10:30 AM,12,6,20,3,4,45,2025-01-23T16:36:42.833Z
2025-01-23,11:30 AM,12,7,16,1,2,38,2025-01-23T17:49:13.890Z
2025-01-23,12:30 PM,19,7,28,4,1,59,2025-01-23T18:45:14.422Z
2025-01-23,1:30 PM,6,3,20,7,0,36,2025-01-23T19:36:47.019Z
2025-01-23,2:30 PM,13,5,17,0,1,36,2025-01-23T20:40:44.002Z
2025-01-23,3:30 PM,11,8,10,5,0,34,2025-01-23T21:30:29.061Z
2025-01-23,4:30 PM,7,3,8,1,0,19,2025-01-23T22:34:14.272Z
2025-01-23,5:30 PM,5,4,10,2,1,22,2025-01-23T23:43:06.706Z
2025-01-23,6:30 PM,7,3,8,4,0,22,2025-01-24T00:37:01.644Z
2025-01-23,8:30 PM,7,2,4,2,0,15,2025-01-24T02:25:17.548Z
2025-01-24,7:30 AM,1,0,0,1,0,2,2025-01-24T13:47:22.509Z
2025-01-24,9:30 AM,2,1,0,0,0,3,2025-01-24T15:21:49.749Z
2025-01-24,10:30 AM,2,1,1,0,0,4,2025-01-24T16:40:16.212Z
2025-01-24,11:30 AM,5,1,6,1,1,14,2025-01-24T17:54:16.520Z
2025-01-24,12:30 PM,3,1,8,2,0,14,2025-01-24T18:41:03.211Z
2025-01-24,1:30 PM,5,3,5,4,0,17,2025-01-24T19:37:39.824Z
2025-01-24,2:30 PM,5,1,2,1,0,9,2025-01-24T20:38:00.568Z
2025-01-24,3:30 PM,12,2,1,0,0,15,2025-01-24T21:45:46.274Z
2025-01-24,4:30 PM,9,4,3,0,1,17,2025-01-24T22:42:20.125Z
2025-01-24,5:30 PM,7,3,3,0,0,13,2025-01-24T23:33:17.038Z
2025-01-24,6:30 PM,6,1,3,0,1,11,2025-01-25T00:31:08.265Z
2025-01-25,10:30 AM,3,0,1,0,0,4,2025-01-25T16:29:26.858Z
2025-01-25,11:30 AM,2,0,3,0,0,5,2025-01-25T17:36:26.188Z
2025-01-25,12:30 PM,2,0,6,0,0,8,2025-01-25T18:39:58.969Z
2025-01-25,1:30 PM,3,1,5,0,0,9,2025-01-25T19:29:51.710Z
2025-01-25,2:30 PM,4,3,7,0,0,14,2025-01-25T20:41:28.963Z
2025-01-25,3:30 PM,0,2,8,2,0,12,2025-01-25T21:44:25.360Z
2025-01-25,4:30 PM,2,2,4,2,0,10,2025-01-25T22:41:24.494Z
2025-01-27,7:30 AM,2,0,1,0,0,3,2025-01-27T13:48:43.849Z
2025-01-27,8:30 AM,3,2,2,1,0,8,2025-01-27T14:30:40.730Z
2025-01-27,9:30 AM,9,3,4,0,2,18,2025-01-27T15:21:22.468Z
2025-01-27,10:30 AM,9,5,6,2,2,24,2025-01-27T16:33:04.572Z
2025-01-27,11:30 AM,22,5,17,8,1,53,2025-01-27T17:34:02.893Z
2025-01-27,12:30 PM,17,9,30,12,1,69,2025-01-27T18:40:01.694Z
2025-01-27,1:30 PM,11,8,15,8,0,42,2025-01-27T19:35:33.272Z
2025-01-27,2:30 PM,14,7,15,7,0,43,2025-01-27T20:32:27.081Z
2025-01-27,3:30 PM,8,8,6,1,0,23,2025-01-27T21:43:09.695Z
2025-01-27,4:30 PM,5,4,9,1,0,19,2025-01-27T22:34:33.083Z
2025-01-27,5:30 PM,4,3,9,1,2,19,2025-01-27T23:41:00.140Z
2025-01-27,6:30 PM,3,2,6,1,0,12,2025-01-28T00:32:28.640Z
2025-01-27,7:30 PM,2,2,4,3,3,14,2025-01-28T01:25:20.918Z
2025-01-27,8:30 PM,3,2,1,0,0,6,2025-01-28T02:56:20.386Z
2025-01-28,7:30 AM,2,0,0,0,0,2,2025-01-28T13:34:15.147Z
2025-01-28,8:30 AM,7,3,0,1,0,11,2025-01-28T14:30:19.172Z
2025-01-28,9:30 AM,6,3,4,0,2,15,2025-01-28T15:34:45.546Z
2025-01-28,10:30 AM,12,3,9,1,1,26,2025-01-28T16:34:29.576Z
2025-01-28,11:30 AM,8,6,16,3,2,35,2025-01-28T17:29:01.221Z
2025-01-28,12:30 PM,18,9,22,4,3,56,2025-01-28T18:33:55.711Z
2025-01-28,1:30 PM,8,9,16,4,1,38,2025-01-28T19:35:17.737Z
2025-01-28,2:30 PM,14,4,15,4,0,37,2025-01-28T20:49:22.750Z
2025-01-28,3:30 PM,10,5,14,2,1,32,2025-01-28T21:34:12.095Z
2025-01-28,4:30 PM,9,5,7,1,0,22,2025-01-28T22:42:45.188Z
2025-01-28,5:30 PM,9,4,3,0,2,18,2025-01-28T23:33:01.480Z
2025-01-28,6:30 PM,8,3,1,2,0,14,2025-01-29T00:40:23.823Z
2025-01-28,9:30 PM,2,2,2,3,0,9,2025-01-29T03:02:59.392Z
2025-01-28,8:30 PM,2,2,2,3,0,9,2025-01-29T03:03:48.247Z
2025-01-29,7:30 AM,3,0,1,0,0,4,2025-01-29T13:46:07.519Z
2025-01-29,8:30 AM,2,3,2,0,0,7,2025-01-29T14:28:55.475Z
2025-01-29,9:30 AM,2,3,6,0,0,11,2025-01-29T15:32:04.771Z
2025-01-29,10:30 AM,6,2,11,3,0,22,2025-01-29T16:35:58.291Z
2025-01-29,11:30 AM,12,8,10,3,0,33,2025-01-29T17:29:04.927Z
2025-01-29,12:30 PM,17,7,23,14,1,62,2025-01-29T18:35:39.712Z
2025-01-29,1:30 PM,9,6,13,7,1,36,2025-01-29T19:36:32.409Z
2025-01-29,2:30 PM,8,6,8,5,2,29,2025-01-29T20:35:39.667Z
2025-01-29,3:30 PM,7,6,7,3,0,23,2025-01-29T21:38:07.291Z
2025-01-29,4:30 PM,5,3,11,1,0,20,2025-01-29T22:56:06.935Z
2025-01-29,5:30 PM,4,3,9,2,0,18,2025-01-29T23:25:03.962Z
2025-01-29,6:30 PM,6,2,3,2,0,13,2025-01-30T00:53:22.291Z
2025-01-29,7:30 PM,2,2,2,1,3,10,2025-01-30T01:29:43.425Z
2025-01-29,8:30 PM,3,1,1,1,0,6,2025-01-30T02:51:59.787Z
2025-01-30,8:30 AM,3,3,1,1,0,8,2025-01-30T14:29:57.158Z
2025-01-30,7:30 AM,1,0,0,0,0,1,2025-01-30T14:30:31.982Z
2025-01-30,9:30 AM,3,3,5,0,1,12,2025-01-30T15:37:30.256Z
2025-01-30,10:30 AM,9,3,6,0,1,19,2025-01-30T16:33:25.748Z
2025-01-30,11:30 AM,7,6,12,2,0,27,2025-01-30T17:47:39.113Z
2025-01-30,12:30 PM,14,4,12,3,1,34,2025-01-30T19:14:36.236Z
2025-01-30,1:30 PM,9,4,12,2,3,30,2025-01-30T19:32:42.338Z
2025-01-30,2:30 PM,7,5,15,4,1,32,2025-01-30T20:36:17.918Z
2025-01-30,3:30 PM,11,8,11,1,1,32,2025-01-30T21:32:29.243Z
2025-01-30,4:30 PM,7,7,7,0,1,22,2025-01-30T22:42:50.313Z
2025-01-30,5:30 PM,7,3,8,3,1,22,2025-01-30T23:43:34.680Z
2025-01-30,6:30 PM,5,1,4,2,0,12,2025-01-31T00:42:06.903Z
2025-01-30,7:30 PM,5,2,5,3,0,15,2025-01-31T01:46:13.810Z
2025-01-30,8:30 PM,3,2,3,1,0,9,2025-01-31T02:57:46.139Z
2025-01-31,7:30 AM,2,0,0,0,0,2,2025-01-31T13:55:08.882Z
2025-01-31,8:30 AM,3,2,3,0,0,8,2025-01-31T14:49:50.504Z
2025-01-31,9:30 AM,3,2,1,0,1,7,2025-01-31T15:42:54.197Z
2025-01-31,10:30 AM,3,2,3,0,0,8,2025-01-31T16:30:33.269Z
2025-01-31,11:30 AM,11,2,12,6,0,31,2025-01-31T17:36:09.047Z
2025-01-31,12:30 PM,4,2,12,0,1,19,2025-01-31T18:50:43.391Z
2025-01-31,1:30 PM,3,1,8,2,0,14,2025-01-31T19:38:30.062Z
2025-01-31,2:30 PM,2,1,4,2,0,9,2025-01-31T20:40:49.310Z
2025-01-31,3:30 PM,5,2,9,1,1,18,2025-01-31T21:49:32.362Z
2025-01-31,4:30 PM,2,1,8,3,0,14,2025-01-31T22:41:20.320Z
2025-01-31,5:30 PM,5,1,4,2,1,13,2025-01-31T23:40:59.039Z
2025-01-31,6:30 PM,5,0,1,1,0,7,2025-02-01T00:44:13.397Z
2025-02-01,10:30 AM,5,1,0,1,0,7,2025-02-01T16:34:08.832Z
2025-02-01,11:30 AM,5,1,6,0,0,12,2025-02-01T17:55:38.376Z
2025-02-01,12:30 PM,6,3,2,0,0,11,2025-02-01T18:54:49.515Z
2025-02-01,1:30 PM,6,2,4,2,0,14,2025-02-01T19:41:36.056Z
2025-02-01,2:30 PM,4,2,4,1,0,11,2025-02-01T20:56:18.376Z
2025-02-01,3:30 PM,5,2,4,2,0,13,2025-02-01T21:28:31.730Z
2025-02-01,4:30 PM,6,1,4,3,0,14,2025-02-01T22:34:29.371Z
2025-02-03,7:30 AM,2,0,0,0,0,2,2025-02-03T13:48:26.815Z
2025-02-03,8:30 AM,4,4,4,2,0,14,2025-02-03T14:33:56.725Z
2025-02-03,9:30 AM,5,6,11,4,0,26,2025-02-03T16:41:47.121Z
2025-02-03,10:30 AM,9,7,12,6,1,35,2025-02-03T16:42:03.392Z
2025-02-03,11:30 AM,12,5,11,3,0,31,2025-02-03T17:37:20.481Z
2025-02-03,12:30 PM,16,12,16,8,1,53,2025-02-03T18:38:48.389Z
2025-02-03,1:30 PM,12,5,16,5,0,38,2025-02-03T19:32:16.530Z
2025-02-03,2:30 PM,10,3,7,6,0,26,2025-02-03T20:28:58.312Z
2025-02-03,2:30 PM,11,4,5,5,1,26,2025-02-03T20:41:20.994Z
2025-02-03,3:30 PM,10,2,9,1,2,24,2025-02-03T21:33:07.636Z
2025-02-03,4:30 PM,5,4,4,5,1,19,2025-02-03T22:33:17.343Z
2025-02-03,5:30 PM,7,4,9,2,0,22,2025-02-03T23:33:20.163Z
2025-02-03,6:30 PM,4,3,3,3,0,13,2025-02-04T00:32:30.974Z
2025-02-03,7:30 PM,4,2,5,2,0,13,2025-02-04T01:18:55.512Z
2025-02-04,7:30 AM,2,0,0,0,0,2,2025-02-04T14:24:54.704Z
2025-02-04,8:30 AM,6,3,1,1,1,12,2025-02-04T14:28:03.088Z
2025-02-04,9:30 AM,6,1,1,1,0,9,2025-02-04T15:41:20.343Z
2025-02-04,10:30 AM,11,2,5,2,0,20,2025-02-04T16:38:54.487Z
2025-02-04,11:30 AM,9,5,14,5,2,35,2025-02-04T17:34:22.336Z
2025-02-04,12:30 PM,13,8,29,7,2,59,2025-02-04T18:33:55.331Z
2025-02-04,1:30 PM,15,7,18,4,1,45,2025-02-04T19:37:42.446Z
2025-02-04,2:30 PM,15,4,18,6,2,45,2025-02-04T20:34:15.680Z
2025-02-04,3:30 PM,8,12,2,4,1,27,2025-02-04T21:38:00.686Z
2025-02-04,4:30 PM,2,4,5,5,0,16,2025-02-04T22:35:00.574Z
2025-02-04,5:30 PM,3,1,6,6,0,16,2025-02-04T23:37:41.446Z
2025-02-04,6:30 PM,4,3,6,5,0,18,2025-02-05T00:33:35.537Z
2025-02-04,7:30 PM,10,2,4,0,0,16,2025-02-05T01:53:48.684Z
2025-02-04,7:30 PM,5,2,4,2,1,14,2025-02-05T01:55:37.951Z
2025-02-04,8:30 PM,5,2,4,2,0,13,2025-02-05T02:27:04.555Z
2025-02-05,7:30 AM,1,0,0,0,0,1,2025-02-05T13:37:37.529Z
2025-02-05,8:30 AM,8,3,7,0,0,18,2025-02-05T14:50:26.669Z
2025-02-05,9:30 AM,9,7,10,2,0,28,2025-02-05T15:46:48.741Z
2025-02-05,10:30 AM,10,6,11,4,1,32,2025-02-05T16:40:45.711Z
2025-02-05,11:30 AM,4,8,10,6,2,30,2025-02-05T17:48:06.078Z
2025-02-05,12:30 PM,12,6,23,6,2,49,2025-02-05T19:32:55.911Z
2025-02-05,1:30 PM,8,2,17,5,2,34,2025-02-05T19:37:34.840Z
2025-02-05,3:30 PM,8,5,12,2,0,27,2025-02-05T21:40:07.198Z
2025-02-05,4:30 PM,10,5,9,4,0,28,2025-02-05T22:38:27.616Z
2025-02-05,5:30 PM,9,6,8,4,0,27,2025-02-05T23:40:00.843Z
2025-02-05,6:30 PM,5,2,4,2,0,13,2025-02-06T00:44:33.851Z
2025-02-05,7:30 PM,4,1,4,2,2,13,2025-02-06T01:44:41.575Z
2025-02-05,8:30 PM,4,1,2,2,1,10,2025-02-06T02:27:27.377Z
2025-02-06,7:30 AM,2,0,0,0,0,2,2025-02-06T13:50:56.925Z
2025-02-06,8:30 AM,3,3,3,1,1,11,2025-02-06T14:33:19.549Z
2025-02-06,9:30 AM,2,2,7,0,2,13,2025-02-06T15:33:34.458Z
2025-02-06,10:30 AM,8,8,15,5,2,38,2025-02-06T17:00:28.513Z
2025-02-06,11:30 AM,11,7,14,2,1,35,2025-02-06T17:35:44.999Z
2025-02-06,12:30 PM,15,9,20,12,2,58,2025-02-06T18:33:42.513Z
2025-02-06,1:30 PM,4,0,24,14,3,45,2025-02-06T19:34:29.471Z
2025-02-06,2:30 PM,8,6,19,7,1,41,2025-02-06T20:29:17.799Z
2025-02-06,3:30 PM,7,5,18,7,1,38,2025-02-06T21:40:44.820Z
2025-02-06,4:30 PM,7,1,8,5,0,21,2025-02-06T22:51:24.383Z
2025-02-06,5:30 PM,5,3,5,6,1,20,2025-02-06T23:42:06.640Z
2025-02-06,6:30 PM,5,2,3,6,0,16,2025-02-07T01:04:07.722Z
2025-02-06,7:30 PM,6,4,2,2,0,14,2025-02-07T01:39:03.457Z
2025-02-06,8:30 PM,7,1,2,4,0,14,2025-02-07T02:43:33.053Z
2025-02-07,7:30 AM,2,0,0,0,0,2,2025-02-07T13:46:55.540Z
2025-02-07,8:30 AM,3,0,3,1,0,7,2025-02-07T14:36:57.731Z
2025-02-07,10:30 AM,5,4,3,0,0,12,2025-02-07T16:43:10.518Z
2025-02-07,11:30 AM,2,4,3,2,0,11,2025-02-07T18:44:59.393Z
2025-02-07,12:30 PM,3,4,4,3,0,14,2025-02-07T18:45:16.502Z
2025-02-07,1:30 PM,4,3,5,7,0,19,2025-02-07T19:51:57.842Z
2025-02-07,2:30 PM,2,4,1,4,0,11,2025-02-07T20:37:10.203Z
2025-02-07,3:30 PM,5,5,8,3,0,21,2025-02-07T21:41:00.305Z
2025-02-07,4:30 PM,3,2,10,2,0,17,2025-02-07T22:44:51.356Z
2025-02-07,5:30 PM,3,2,7,2,0,14,2025-02-07T23:57:29.582Z
2025-02-07,6:30 PM,1,1,6,2,0,10,2025-02-08T00:35:39.849Z
2025-02-08,10:30 AM,5,0,0,0,0,5,2025-02-08T17:52:46.678Z
2025-02-08,11:30 AM,4,1,3,1,0,9,2025-02-08T17:53:05.180Z
2025-02-08,12:30 PM,4,1,1,1,0,7,2025-02-08T18:37:55.399Z
2025-02-08,1:30 PM,3,3,3,1,0,10,2025-02-08T19:28:18.748Z
2025-02-08,2:30 PM,2,3,3,2,0,10,2025-02-08T20:39:28.583Z
2025-02-08,4:30 PM,4,1,1,1,0,7,2025-02-08T22:34:02.191Z
2025-02-10,7:30 AM,2,0,0,0,0,2,2025-02-10T13:39:18.990Z
2025-02-10,8:30 AM,5,0,1,0,0,6,2025-02-10T14:37:58.413Z
2025-02-10,9:30 AM,5,4,10,0,0,19,2025-02-10T15:42:42.778Z
2025-02-10,10:30 AM,10,6,12,1,1,30,2025-02-10T16:31:29.916Z
2025-02-10,11:30 AM,8,6,14,7,2,37,2025-02-10T17:34:24.345Z
2025-02-10,12:30 PM,20,10,34,10,6,80,2025-02-10T18:46:40.456Z
2025-02-10,1:30 PM,8,7,17,11,1,44,2025-02-10T19:34:07.890Z
2025-02-10,2:30 PM,11,5,16,6,2,40,2025-02-10T20:38:41.593Z
2025-02-10,3:30 PM,8,4,14,4,0,30,2025-02-10T21:32:36.841Z
2025-02-10,4:30 PM,6,2,13,0,0,21,2025-02-10T22:44:41.203Z
2025-02-10,5:30 PM,5,4,9,0,0,18,2025-02-11T00:03:03.122Z
2025-02-10,6:30 PM,2,3,5,2,1,13,2025-02-11T00:32:05.098Z
2025-02-10,7:30 PM,6,3,8,2,0,19,2025-02-11T01:51:54.914Z
2025-02-10,8:30 PM,4,1,3,2,0,10,2025-02-11T02:55:14.250Z
2025-02-11,7:30 AM,3,1,0,0,0,4,2025-02-11T13:36:46.645Z
2025-02-11,8:30 AM,14,5,5,2,1,27,2025-02-11T15:14:45.874Z
2025-02-11,9:30 AM,6,4,10,3,1,24,2025-02-11T16:33:39.270Z
2025-02-11,10:30 AM,8,5,13,5,2,33,2025-02-11T16:34:01.323Z
2025-02-11,11:30 AM,21,7,20,6,2,56,2025-02-11T17:33:58.476Z
2025-02-11,12:30 PM,22,10,29,6,1,68,2025-02-11T18:33:56.672Z
2025-02-11,1:30 PM,21,8,20,11,4,64,2025-02-11T19:34:09.476Z
2025-02-11,2:30 PM,7,3,15,7,0,32,2025-02-11T20:40:46.821Z
2025-02-11,3:30 PM,10,5,7,2,1,25,2025-02-11T21:32:52.078Z
2025-02-11,4:30 PM,5,6,5,2,0,18,2025-02-11T22:40:18.159Z
2025-02-11,5:30 PM,6,5,9,3,0,23,2025-02-11T23:32:07.758Z
2025-02-11,6:30 PM,5,2,2,2,0,11,2025-02-12T00:35:02.801Z
2025-02-11,7:30 PM,7,2,4,2,0,15,2025-02-12T01:46:32.915Z
2025-02-11,8:30 PM,6,2,3,3,0,14,2025-02-12T02:30:45.118Z
2025-02-13,7:30 AM,2,0,0,1,0,3,2025-02-13T13:40:50.866Z
2025-02-13,8:30 AM,6,2,3,1,0,12,2025-02-13T14:43:37.542Z
2025-02-13,9:30 AM,5,3,6,2,0,16,2025-02-13T15:33:27.047Z
2025-02-13,10:30 AM,10,4,4,2,1,21,2025-02-13T16:33:46.271Z
2025-02-13,11:30 AM,14,9,12,3,1,39,2025-02-13T17:36:52.655Z
2025-02-13,12:30 PM,14,10,17,7,2,50,2025-02-13T18:32:56.067Z
2025-02-13,1:30 PM,8,6,10,4,1,29,2025-02-13T19:35:31.460Z
2025-02-13,2:30 PM,3,3,11,5,1,23,2025-02-13T20:35:24.595Z
2025-02-13,3:30 PM,8,2,14,1,1,26,2025-02-13T21:35:54.532Z
2025-02-13,4:30 PM,3,6,14,4,0,27,2025-02-13T22:33:34.649Z
2025-02-13,5:30 PM,5,4,7,0,2,18,2025-02-13T23:42:16.167Z
2025-02-13,6:30 PM,2,3,6,1,0,12,2025-02-14T00:39:52.529Z
2025-02-13,7:30 PM,4,2,2,1,0,9,2025-02-14T01:58:37.426Z
2025-02-13,8:30 PM,2,1,0,2,0,5,2025-02-14T03:00:37.776Z
2025-02-14,7:30 AM,1,0,0,0,0,1,2025-02-14T13:46:03.339Z
2025-02-14,8:30 AM,2,1,0,0,0,3,2025-02-14T14:30:04.033Z
2025-02-14,9:30 AM,4,2,0,0,0,6,2025-02-14T15:36:13.201Z
2025-02-14,10:30 AM,6,2,6,0,1,15,2025-02-14T16:45:20.640Z
2025-02-14,11:30 AM,4,0,5,3,0,12,2025-02-14T18:32:16.216Z
2025-02-14,12:30 PM,5,0,6,3,0,14,2025-02-14T18:32:34.576Z
2025-02-14,1:30 PM,2,3,3,2,0,10,2025-02-14T19:35:13.432Z
2025-02-14,2:30 PM,2,1,4,0,0,7,2025-02-14T20:36:11.118Z
2025-02-14,3:30 PM,2,4,1,1,1,9,2025-02-14T21:40:17.130Z
2025-02-14,4:30 PM,2,2,1,2,0,7,2025-02-14T22:36:19.310Z
2025-02-14,5:30 PM,0,2,3,2,0,7,2025-02-14T23:32:13.897Z
2025-02-14,6:30 PM,0,1,2,2,0,5,2025-02-15T00:37:00.948Z
2025-02-15,10:30 AM,4,0,4,0,1,9,2025-02-15T16:34:02.773Z
2025-02-15,11:30 AM,4,2,2,0,0,8,2025-02-15T17:30:13.410Z
2025-02-15,12:30 PM,6,2,6,0,0,14,2025-02-15T18:33:12.264Z
2025-02-15,1:30 PM,3,3,6,1,0,13,2025-02-15T19:27:58.212Z
2025-02-15,2:30 PM,3,1,2,2,0,8,2025-02-15T20:21:06.705Z
2025-02-15,3:30 PM,2,3,5,2,0,12,2025-02-15T21:32:00.989Z
2025-02-15,4:30 PM,2,3,2,2,2,11,2025-02-15T22:31:07.178Z
2025-02-17,7:30 AM,4,0,1,0,0,5,2025-02-17T13:43:14.916Z
2025-02-17,8:30 AM,3,2,2,1,0,8,2025-02-17T14:33:33.431Z
2025-02-17,9:30 AM,11,3,10,0,2,26,2025-02-17T15:29:02.851Z
2025-02-17,10:30 AM,6,6,16,2,2,32,2025-02-17T16:31:48.140Z
2025-02-17,11:30 AM,6,2,18,6,1,33,2025-02-17T17:34:08.961Z
2025-02-17,12:30 PM,10,6,20,9,0,45,2025-02-17T19:34:06.078Z
2025-02-17,1:30 PM,8,4,21,0,1,34,2025-02-17T19:53:39.903Z
2025-02-17,2:30 PM,12,5,15,2,0,34,2025-02-17T20:30:16.228Z
2025-02-17,3:30 PM,5,3,9,4,3,24,2025-02-17T21:34:23.689Z
2025-02-17,4:30 PM,1,3,10,4,0,18,2025-02-17T22:35:31.859Z
2025-02-17,5:30 PM,4,5,10,2,1,22,2025-02-17T23:35:08.083Z
2025-02-17,6:30 PM,4,3,6,1,0,14,2025-02-18T00:32:31.355Z
2025-02-17,7:30 PM,4,2,2,2,0,10,2025-02-18T01:30:52.701Z
2025-02-17,8:30 PM,3,2,0,3,0,8,2025-02-18T02:39:11.341Z
2025-02-22,10:30 AM,5,0,2,2,0,9,2025-02-22T16:37:46.604Z
2025-02-22,11:30 AM,5,1,3,0,0,9,2025-02-22T17:31:54.547Z
2025-02-22,12:30 PM,3,1,1,0,0,5,2025-02-22T18:35:58.855Z
2025-02-22,1:30 PM,5,1,1,0,0,7,2025-02-22T19:30:16.560Z
2025-02-22,2:30 PM,4,3,2,1,0,10,2025-02-22T20:49:47.654Z
2025-02-22,3:30 PM,5,2,1,0,0,8,2025-02-22T21:38:35.643Z
2025-02-22,4:30 PM,2,2,2,0,0,6,2025-02-22T22:32:31.556Z
2025-02-24,7:30 AM,5,1,2,0,0,8,2025-02-24T13:54:43.212Z
2025-02-24,8:30 AM,4,2,5,1,1,13,2025-02-24T14:36:16.322Z
2025-02-24,9:30 AM,9,2,6,0,2,19,2025-02-24T15:30:20.857Z
2025-02-24,10:30 AM,11,6,5,3,2,27,2025-02-24T16:40:22.993Z
2025-02-24,11:30 AM,9,3,7,5,3,27,2025-02-24T17:38:57.979Z
2025-02-24,12:30 PM,16,9,21,7,0,53,2025-02-24T18:51:54.784Z
2025-02-24,1:30 PM,4,7,15,5,1,32,2025-02-24T19:35:38.178Z
2025-02-24,2:30 PM,10,5,16,1,0,32,2025-02-24T20:30:36.365Z
2025-02-24,3:30 PM,4,6,12,3,0,25,2025-02-24T21:32:26.510Z
2025-02-24,4:30 PM,4,5,9,2,1,21,2025-02-24T22:31:44.184Z
2025-02-24,5:30 PM,2,3,8,2,0,15,2025-02-24T23:34:27.143Z
2025-02-24,6:30 PM,4,3,7,1,0,15,2025-02-25T00:35:59.902Z
2025-02-24,7:30 PM,2,2,5,2,0,11,2025-02-25T01:28:06.403Z
2025-02-24,8:30 PM,2,1,3,1,1,8,2025-02-25T02:30:12.087Z
2025-02-25,7:30 AM,3,0,0,0,0,3,2025-02-25T13:58:07.763Z
2025-02-25,8:30 AM,5,2,0,1,0,8,2025-02-25T14:36:33.750Z
2025-02-25,9:30 AM,5,2,6,0,0,13,2025-02-25T16:07:44.932Z
2025-02-25,10:30 AM,8,2,7,0,0,17,2025-02-25T16:30:14.318Z
2025-02-25,11:30 AM,10,5,15,4,1,35,2025-02-25T17:32:44.068Z
2025-02-25,12:30 PM,14,10,27,5,1,57,2025-02-25T18:34:15.529Z
2025-02-25,1:30 PM,8,6,13,4,0,31,2025-02-25T19:35:57.989Z
2025-02-25,2:30 PM,5,7,18,4,0,34,2025-02-25T20:32:47.536Z
2025-02-25,3:30 PM,3,6,13,2,1,25,2025-02-25T21:33:06.768Z
2025-02-25,4:30 PM,8,6,5,0,1,20,2025-02-25T22:46:04.500Z
2025-02-25,5:30 PM,9,3,7,1,0,20,2025-02-25T23:36:00.786Z
2025-02-25,6:30 PM,9,2,3,1,1,16,2025-02-26T00:38:34.638Z
2025-02-25,7:30 PM,1,1,4,1,0,7,2025-02-26T01:46:17.661Z
2025-02-26,7:30 AM,3,1,0,0,0,4,2025-02-26T13:38:31.025Z
2025-02-26,8:30 AM,3,2,2,1,0,8,2025-02-26T14:28:08.559Z
2025-02-26,9:30 AM,3,2,8,0,0,13,2025-02-26T15:34:45.788Z
2025-02-26,10:30 AM,15,7,20,2,0,44,2025-02-26T16:45:29.370Z
2025-02-26,11:30 AM,10,5,19,10,2,46,2025-02-26T17:32:36.635Z
2025-02-26,12:30 PM,14,3,29,15,1,62,2025-02-26T18:34:17.176Z
2025-02-26,1:30 PM,3,4,11,5,1,24,2025-02-26T19:33:54.463Z
2025-02-26,2:30 PM,10,5,10,6,3,34,2025-02-26T20:37:54.326Z
2025-02-26,3:30 PM,7,4,6,3,0,20,2025-02-26T21:34:07.212Z
2025-02-26,4:30 PM,8,5,3,2,0,18,2025-02-26T22:53:25.076Z
2025-02-26,5:30 PM,5,3,2,4,0,14,2025-02-26T23:49:33.787Z
2025-02-26,6:30 PM,3,1,2,2,0,8,2025-02-27T01:09:29.084Z
2025-02-26,7:30 PM,2,2,3,1,0,8,2025-02-27T01:48:27.323Z
2025-02-26,8:30 PM,0,2,0,0,0,2,2025-02-27T02:36:03.828Z
2025-02-27,7:30 AM,2,0,0,0,0,2,2025-02-27T13:47:10.273Z
2025-02-27,8:30 AM,1,3,4,0,0,8,2025-02-27T14:30:03.307Z
2025-02-27,9:30 AM,4,3,5,2,0,14,2025-02-27T15:25:55.262Z
2025-02-27,10:30 AM,9,2,11,0,1,23,2025-02-27T16:47:30.332Z
2025-02-27,11:30 AM,6,7,7,4,1,25,2025-02-27T17:31:48.104Z
2025-02-27,12:30 PM,7,6,15,5,2,35,2025-02-27T18:32:50.598Z
2025-02-27,1:30 PM,8,7,10,5,2,32,2025-02-27T19:33:58.382Z
2025-02-27,2:30 PM,7,6,11,4,1,29,2025-02-27T20:35:08.921Z
2025-02-27,3:30 PM,2,2,1,0,0,5,2025-02-27T21:53:30.595Z
2025-02-27,4:30 PM,5,3,2,1,0,11,2025-02-27T22:57:24.729Z
2025-02-27,5:30 PM,10,2,3,1,0,16,2025-02-27T23:41:21.165Z
2025-02-27,6:30 PM,4,0,3,2,0,9,2025-02-28T01:00:52.427Z
2025-02-27,7:30 PM,1,1,2,2,0,6,2025-02-28T01:41:02.547Z
2025-02-27,8:30 PM,1,3,3,0,0,7,2025-02-28T02:31:11.563Z
2025-02-27,8:30 PM,1,1,2,0,0,4,2025-02-28T02:39:09.020Z
2025-02-28,7:30 AM,2,1,0,0,0,3,2025-02-28T14:08:32.137Z
2025-02-28,8:30 AM,2,1,0,1,0,4,2025-02-28T14:36:11.333Z
2025-02-28,9:30 AM,4,3,0,0,0,7,2025-02-28T15:58:56.108Z
2025-02-28,10:30 AM,8,1,0,1,0,10,2025-02-28T16:43:37.030Z
2025-02-28,11:30 AM,11,1,2,3,0,17,2025-02-28T17:22:54.411Z
2025-02-28,12:30 PM,9,1,5,7,0,22,2025-02-28T18:40:20.884Z
2025-02-28,1:30 PM,7,3,4,3,0,17,2025-02-28T19:36:47.749Z
2025-02-28,2:30 PM,7,4,8,4,1,24,2025-02-28T20:34:42.106Z
2025-02-28,3:30 PM,4,1,5,1,0,11,2025-02-28T22:02:15.055Z
2025-02-28,4:30 PM,2,0,3,2,0,7,2025-02-28T22:45:44.853Z
2025-02-28,5:30 PM,0,0,1,1,0,2,2025-03-01T00:00:23.279Z
2025-02-28,6:30 PM,0,1,1,1,0,3,2025-03-01T00:52:58.206Z
2025-03-01,10:30 AM,3,2,2,0,0,7,2025-03-01T16:29:25.683Z
2025-03-01,11:30 AM,2,2,2,0,0,6,2025-03-01T17:35:00.432Z
2025-03-01,12:30 PM,1,3,2,0,0,6,2025-03-01T18:32:46.681Z
2025-03-01,1:30 PM,0,1,2,0,1,4,2025-03-01T19:26:13.059Z
2025-03-01,3:30 PM,5,2,1,2,0,10,2025-03-01T21:31:40.007Z
2025-03-01,4:30 PM,5,2,3,1,0,11,2025-03-01T22:42:08.208Z
2025-03-03,7:30 AM,2,1,1,0,0,4,2025-03-03T13:37:26.027Z
2025-03-03,8:30 AM,3,1,4,0,0,8,2025-03-03T14:36:50.979Z
2025-03-03,9:30 AM,2,2,1,1,1,7,2025-03-03T15:47:31.181Z
2025-03-03,10:30 AM,14,4,8,2,0,28,2025-03-03T16:38:22.098Z
2025-03-03,11:30 AM,11,3,13,7,1,35,2025-03-03T17:34:18.549Z
2025-03-03,12:30 PM,18,6,29,15,3,71,2025-03-03T18:38:27.286Z
2025-03-03,1:30 PM,8,3,10,3,0,24,2025-03-03T19:35:18.855Z
2025-03-03,2:30 PM,10,4,11,8,0,33,2025-03-03T20:33:43.604Z
2025-03-03,3:30 PM,6,4,6,5,0,21,2025-03-03T21:49:49.596Z
2025-03-03,4:30 PM,4,2,13,5,3,27,2025-03-03T22:31:49.023Z
2025-03-03,5:30 PM,9,4,9,1,1,24,2025-03-03T23:33:58.989Z
2025-03-03,6:30 PM,6,1,6,2,0,15,2025-03-04T00:36:05.667Z
2025-03-03,7:30 PM,5,1,2,2,0,10,2025-03-04T01:31:41.115Z
2025-03-03,8:30 PM,3,2,0,2,0,7,2025-03-04T02:50:06.402Z
2025-03-04,7:30 AM,3,1,0,0,0,4,2025-03-04T14:08:23.338Z
2025-03-04,8:30 AM,5,2,1,1,0,9,2025-03-04T15:02:32.676Z
2025-03-04,9:30 AM,3,2,5,0,0,10,2025-03-04T15:34:07.061Z
2025-03-04,10:30 AM,8,4,9,3,0,24,2025-03-04T16:32:24.459Z
2025-03-04,11:30 AM,11,5,17,2,0,35,2025-03-04T17:32:10.350Z
2025-03-04,12:30 PM,14,9,26,5,5,59,2025-03-04T18:38:23.858Z
2025-03-04,1:30 PM,5,6,16,10,2,39,2025-03-04T19:47:00.811Z
2025-03-04,2:30 PM,7,9,11,3,0,30,2025-03-04T20:52:41.171Z
2025-03-04,3:30 PM,7,4,6,1,3,21,2025-03-04T21:34:04.699Z
2025-03-04,4:30 PM,6,4,3,1,1,15,2025-03-04T22:29:37.631Z
2025-03-04,5:30 PM,6,3,4,2,2,17,2025-03-04T23:33:06.105Z
2025-03-04,6:30 PM,2,4,6,0,0,12,2025-03-05T00:34:05.970Z
2025-03-04,8:30 PM,2,2,2,0,0,6,2025-03-05T02:21:14.871Z
2025-03-05,7:30 AM,2,1,3,0,0,6,2025-03-05T14:08:00.858Z
2025-03-05,8:30 AM,5,3,8,1,0,17,2025-03-05T14:51:52.247Z
2025-03-05,9:30 AM,3,2,10,1,0,16,2025-03-05T15:39:47.440Z
2025-03-05,10:30 AM,5,7,18,5,2,37,2025-03-05T16:32:29.131Z
2025-03-05,11:30 AM,9,5,16,8,3,41,2025-03-05T17:33:57.632Z
2025-03-05,12:30 PM,4,6,15,9,3,37,2025-03-05T18:59:06.179Z
2025-03-05,1:30 PM,8,6,13,2,0,29,2025-03-05T19:35:04.972Z
2025-03-05,3:30 PM,11,4,7,1,0,23,2025-03-05T21:52:43.829Z
2025-03-05,4:30 PM,7,6,3,2,0,18,2025-03-05T22:59:57.566Z
2025-03-05,5:30 PM,6,4,2,2,0,14,2025-03-06T00:08:12.867Z
2025-03-05,6:30 PM,5,3,7,1,0,16,2025-03-06T00:41:29.066Z
2025-03-05,7:30 PM,2,1,1,1,0,5,2025-03-06T02:27:15.638Z
2025-03-05,8:30 PM,3,2,3,0,0,8,2025-03-06T02:27:31.453Z
2025-03-06,7:30 AM,3,1,1,0,0,5,2025-03-06T13:42:58.475Z
2025-03-06,8:30 AM,3,2,3,0,0,8,2025-03-06T14:33:05.677Z
2025-03-06,9:30 AM,8,0,9,0,0,17,2025-03-06T15:32:16.385Z
2025-03-06,10:30 AM,6,0,11,2,0,19,2025-03-06T16:34:22.156Z
2025-03-06,11:30 AM,8,6,14,1,2,31,2025-03-06T17:33:36.936Z
2025-03-06,12:30 PM,18,7,20,9,2,56,2025-03-06T18:36:53.043Z
2025-03-06,1:30 PM,11,9,16,6,1,43,2025-03-06T19:43:06.963Z
2025-03-06,2:30 PM,8,8,12,4,1,33,2025-03-06T20:57:33.238Z
2025-03-06,3:30 PM,9,4,11,5,0,29,2025-03-06T21:38:02.044Z
2025-03-06,4:30 PM,7,3,8,1,0,19,2025-03-06T22:37:17.082Z
2025-03-06,5:30 PM,7,1,6,2,1,17,2025-03-06T23:42:40.016Z
2025-03-06,6:30 PM,5,2,5,1,1,14,2025-03-07T00:30:42.258Z
2025-03-06,7:30 PM,3,1,2,1,0,7,2025-03-07T01:23:51.261Z
2025-03-06,8:30 PM,3,1,2,0,1,7,2025-03-07T02:32:54.540Z
2025-03-07,7:30 AM,3,0,2,0,0,5,2025-03-07T18:46:20.930Z
2025-03-07,8:30 AM,5,0,2,0,0,7,2025-03-07T18:47:40.596Z
2025-03-07,9:30 AM,7,2,2,0,0,11,2025-03-07T18:48:11.939Z
2025-03-07,10:30 AM,9,2,3,1,0,15,2025-03-07T18:48:45.611Z
2025-03-07,11:30 AM,3,2,6,2,0,13,2025-03-07T18:50:03.094Z
2025-03-07,12:30 PM,7,2,7,1,0,17,2025-03-07T19:05:33.778Z
2025-03-07,1:30 PM,6,2,2,4,0,14,2025-03-07T19:58:52.263Z
2025-03-07,2:30 PM,4,1,3,2,0,10,2025-03-07T20:39:16.259Z
2025-03-07,3:30 PM,5,0,4,0,1,10,2025-03-07T21:59:21.391Z
2025-03-07,4:30 PM,3,0,4,2,1,10,2025-03-07T22:39:38.146Z
2025-03-07,5:30 PM,2,1,2,2,0,7,2025-03-08T00:18:13.136Z
2025-03-07,6:30 PM,3,1,2,0,0,6,2025-03-08T00:42:48.152Z
2025-03-08,10:30 AM,3,0,1,0,0,4,2025-03-08T16:42:00.741Z
2025-03-08,11:30 AM,2,2,2,1,0,7,2025-03-08T17:30:20.163Z
2025-03-08,12:30 PM,3,2,7,0,1,13,2025-03-08T18:37:31.108Z
2025-03-08,2:30 PM,6,4,2,0,0,12,2025-03-08T20:39:03.587Z
2025-03-08,1:30 PM,3,2,2,1,0,8,2025-03-08T22:23:19.650Z
2025-03-08,4:30 PM,6,5,2,0,0,13,2025-03-08T22:38:02.971Z
2025-03-10,7:30 AM,1,0,1,0,1,3,2025-03-10T12:51:26.685Z
2025-03-10,8:30 AM,8,2,8,2,1,21,2025-03-10T13:34:08.038Z
2025-03-10,9:30 AM,7,4,10,1,0,22,2025-03-10T14:37:47.598Z
2025-03-10,10:30 AM,8,11,12,1,0,32,2025-03-10T15:49:50.752Z
2025-03-10,11:30 AM,12,5,14,4,0,35,2025-03-10T16:38:37.499Z
2025-03-10,12:30 PM,18,4,12,4,2,40,2025-03-10T18:02:58.359Z
2025-03-10,1:30 PM,16,5,22,3,0,46,2025-03-10T18:52:58.633Z
2025-03-10,2:30 PM,8,6,13,2,0,29,2025-03-10T19:40:07.579Z
2025-03-10,3:30 PM,2,5,11,0,0,18,2025-03-10T20:33:00.604Z
2025-03-10,4:30 PM,6,2,12,1,2,23,2025-03-10T21:46:41.367Z
2025-03-10,5:30 PM,6,2,10,0,0,18,2025-03-10T22:44:23.231Z
2025-03-10,6:30 PM,3,2,5,0,1,11,2025-03-10T23:30:13.959Z
2025-03-10,7:30 PM,4,2,3,1,0,10,2025-03-11T00:20:12.501Z
2025-03-10,8:30 PM,3,1,2,1,0,7,2025-03-11T01:24:27.449Z
2025-03-11,7:30 AM,1,2,1,0,0,4,2025-03-11T12:52:01.526Z
2025-03-11,8:30 AM,3,3,4,1,0,11,2025-03-11T13:35:11.553Z
2025-03-11,9:30 AM,2,1,3,0,0,6,2025-03-11T14:32:10.247Z
2025-03-11,10:30 AM,15,4,15,2,1,37,2025-03-11T15:34:51.642Z
2025-03-11,11:30 AM,10,7,17,4,0,38,2025-03-11T16:33:57.107Z
2025-03-11,12:30 PM,17,9,22,5,2,55,2025-03-11T17:41:14.929Z
2025-03-11,1:30 PM,9,8,17,4,1,39,2025-03-11T18:38:23.834Z
2025-03-11,2:30 PM,8,7,9,1,4,29,2025-03-11T19:29:55.230Z
2025-03-11,3:30 PM,10,3,6,0,2,21,2025-03-11T20:56:40.357Z
2025-03-11,4:30 PM,3,4,6,1,1,15,2025-03-11T21:47:34.402Z
2025-03-11,5:30 PM,2,1,10,7,0,20,2025-03-11T22:32:35.405Z
2025-03-11,6:30 PM,4,0,5,2,0,11,2025-03-11T23:36:13.188Z
2025-03-11,7:30 PM,3,5,2,2,0,12,2025-03-12T00:31:25.428Z
2025-03-11,8:30 PM,4,2,3,2,0,11,2025-03-12T01:22:35.452Z
2025-03-12,7:30 AM,2,1,1,0,0,4,2025-03-12T12:59:57.823Z
2025-03-12,8:30 AM,2,1,2,1,0,6,2025-03-12T13:26:45.424Z
2025-03-12,9:30 AM,4,3,9,0,0,16,2025-03-12T14:47:08.136Z
2025-03-12,10:30 AM,11,4,10,11,1,37,2025-03-12T16:02:21.728Z
2025-03-12,11:30 AM,22,5,24,11,3,65,2025-03-12T16:47:01.445Z
2025-03-12,12:30 PM,13,9,23,15,0,60,2025-03-12T17:45:53.788Z
2025-03-12,1:30 PM,12,5,29,6,4,56,2025-03-12T18:36:36.509Z
2025-03-12,2:30 PM,8,6,11,8,2,35,2025-03-12T19:39:40.873Z
2025-03-12,3:30 PM,9,5,13,2,0,29,2025-03-12T20:36:43.868Z
2025-03-12,4:30 PM,7,7,5,1,0,20,2025-03-12T21:44:42.842Z
2025-03-12,7:30 PM,3,2,3,1,0,9,2025-03-13T00:58:01.970Z
2025-03-12,8:30 PM,1,1,2,0,0,4,2025-03-13T01:44:03.476Z
2025-03-13,7:30 AM,0,1,0,0,0,1,2025-03-13T12:37:16.040Z
2025-03-13,8:30 AM,2,1,4,0,0,7,2025-03-13T13:47:00.376Z
2025-03-13,9:30 AM,2,2,3,0,0,7,2025-03-13T14:33:16.637Z
2025-03-13,11:30 AM,18,4,9,6,0,37,2025-03-13T16:48:45.612Z
2025-03-13,12:30 PM,6,7,11,7,1,32,2025-03-13T18:01:13.340Z
2025-03-13,1:30 PM,19,6,11,9,2,47,2025-03-13T18:37:52.018Z
2025-03-13,2:30 PM,5,4,11,1,0,21,2025-03-13T19:39:20.493Z
2025-03-13,3:30 PM,2,3,9,1,1,16,2025-03-13T20:35:32.085Z
2025-03-13,4:30 PM,3,3,8,2,1,17,2025-03-13T22:10:15.476Z
2025-03-13,5:30 PM,2,3,7,1,0,13,2025-03-13T22:46:44.105Z
2025-03-13,6:30 PM,3,4,1,0,2,10,2025-03-13T23:33:25.132Z
2025-03-13,7:30 PM,4,2,3,0,0,9,2025-03-14T01:00:05.556Z
2025-03-13,8:30 PM,1,1,3,0,0,5,2025-03-14T01:00:32.095Z
2025-03-14,7:30 AM,1,1,0,0,0,2,2025-03-14T12:54:52.720Z
2025-03-14,9:30 AM,3,0,0,1,0,4,2025-03-14T14:12:12.795Z
2025-03-14,8:30 AM,3,0,0,1,0,4,2025-03-14T14:12:44.482Z
2025-03-14,10:30 AM,4,0,2,2,0,8,2025-03-14T15:25:54.702Z
2025-03-14,11:30 AM,9,3,5,4,2,23,2025-03-14T16:38:00.602Z
2025-03-14,12:30 PM,6,1,11,2,0,20,2025-03-14T17:31:43.688Z
2025-03-14,1:30 PM,5,2,8,2,0,17,2025-03-14T19:07:18.160Z
2025-03-14,2:30 PM,3,5,11,0,0,19,2025-03-14T19:45:25.219Z
2025-03-14,3:30 PM,4,4,4,3,1,16,2025-03-14T20:37:51.456Z
2025-03-14,4:30 PM,2,4,2,1,0,9,2025-03-14T21:43:42.526Z
2025-03-14,5:30 PM,1,0,0,2,0,3,2025-03-14T22:38:41.572Z
2025-03-14,6:30 PM,2,0,0,0,1,3,2025-03-14T23:51:53.321Z
2025-03-15,10:30 AM,2,1,0,0,0,3,2025-03-15T15:36:54.534Z
2025-03-15,11:30 AM,1,2,1,0,0,4,2025-03-15T16:56:45.452Z
2025-03-15,12:30 PM,3,0,2,0,0,5,2025-03-15T17:33:10.324Z
2025-03-15,1:30 PM,2,1,2,0,0,5,2025-03-15T18:30:04.441Z
2025-03-15,2:30 PM,4,1,2,0,0,7,2025-03-15T19:52:44.625Z
2025-03-17,9:30 AM,1,1,0,0,0,2,2025-03-17T14:40:27.098Z
2025-03-17,10:30 AM,1,1,0,2,0,4,2025-03-17T15:34:57.825Z
2025-03-17,11:30 AM,2,2,3,2,0,9,2025-03-17T16:34:08.826Z
2025-03-17,12:30 PM,3,1,3,2,0,9,2025-03-17T17:47:55.254Z
2025-03-17,1:30 PM,5,2,2,2,0,11,2025-03-17T18:50:39.276Z
2025-03-17,2:30 PM,3,1,1,1,0,6,2025-03-17T19:31:45.978Z
2025-03-17,3:30 PM,0,3,1,0,1,5,2025-03-17T20:32:03.117Z
2025-03-17,4:30 PM,0,3,1,3,0,7,2025-03-17T21:34:51.772Z
2025-03-17,5:30 PM,1,2,1,0,0,4,2025-03-17T22:31:56.557Z
2025-03-18,9:30 AM,1,1,0,0,0,2,2025-03-18T14:32:39.845Z
2025-03-18,10:30 AM,3,1,4,0,0,8,2025-03-18T15:42:26.041Z
2025-03-18,11:30 AM,4,1,5,0,1,11,2025-03-18T16:30:49.178Z
2025-03-18,12:30 PM,4,1,4,0,0,9,2025-03-18T17:32:34.754Z
2025-03-18,1:30 PM,5,1,1,0,2,9,2025-03-18T18:48:18.674Z
2025-03-18,2:30 PM,3,3,2,0,2,10,2025-03-18T19:32:22.727Z
2025-03-18,3:30 PM,1,2,3,3,0,9,2025-03-18T20:36:14.824Z
2025-03-18,4:30 PM,5,2,5,2,0,14,2025-03-18T21:31:59.080Z
2025-03-18,5:30 PM,1,2,3,0,0,6,2025-03-18T22:34:28.520Z
2025-03-18,3:30 PM,3,1,2,0,5,11,2025-03-20T20:30:37.505Z
2025-03-19,9:30 AM,1,1,0,0,0,2,2025-03-19T14:26:43.305Z
2025-03-19,10:30 AM,3,2,0,0,0,5,2025-03-19T15:30:40.648Z
2025-03-19,11:30 AM,3,2,0,0,2,7,2025-03-19T16:45:45.868Z
2025-03-19,12:30 PM,3,2,0,0,2,7,2025-03-19T17:31:17.692Z
2025-03-19,1:30 PM,2,1,1,2,0,6,2025-03-19T18:38:05.990Z
2025-03-19,2:30 PM,2,1,1,2,0,6,2025-03-19T19:36:45.295Z
2025-03-19,3:30 PM,1,1,2,2,0,6,2025-03-19T21:28:49.434Z
2025-03-19,4:30 PM,2,1,5,2,0,10,2025-03-19T21:30:10.460Z
2025-03-19,5:30 PM,2,0,4,0,0,6,2025-03-19T22:30:41.082Z
2025-03-20,9:30 AM,2,1,0,0,0,3,2025-03-20T14:35:10.293Z
2025-03-20,10:30 AM,2,1,2,0,0,5,2025-03-20T15:38:49.002Z
2025-03-20,11:30 AM,2,0,3,0,0,5,2025-03-20T16:29:32.977Z
2025-03-20,12:30 PM,3,0,3,2,3,11,2025-03-20T17:34:50.270Z
2025-03-20,1:30 PM,2,1,2,2,0,7,2025-03-20T19:03:09.079Z
2025-03-20,2:30 PM,3,0,1,2,0,6,2025-03-20T19:31:49.974Z
2025-03-20,4:30 PM,2,1,2,1,0,6,2025-03-20T21:43:43.968Z
2025-03-20,5:30 PM,1,2,0,1,0,4,2025-03-20T22:53:18.388Z
2025-03-21,8:30 AM,0,1,0,0,0,1,2025-03-21T13:37:47.147Z
2025-03-21,9:30 AM,2,0,0,0,0,2,2025-03-21T14:36:30.286Z
2025-03-21,10:30 AM,4,1,0,0,0,5,2025-03-21T15:33:30.721Z
2025-03-21,11:30 AM,4,2,0,0,0,6,2025-03-21T16:28:56.367Z
2025-03-21,12:30 PM,3,1,0,2,0,6,2025-03-21T17:59:39.201Z
2025-03-21,1:30 PM,3,1,3,4,1,12,2025-03-21T18:29:41.527Z
2025-03-21,2:30 PM,0,1,3,2,1,7,2025-03-21T19:31:25.768Z
2025-03-21,3:30 PM,0,0,3,0,0,3,2025-03-21T20:35:19.303Z
2025-03-21,4:30 PM,1,0,3,0,0,4,2025-03-21T21:37:32.395Z
2025-03-24,7:30 AM,7,1,0,0,0,8,2025-03-24T12:45:37.484Z
2025-03-24,8:30 AM,6,1,2,0,0,9,2025-03-24T13:33:23.688Z
2025-03-24,9:30 AM,7,4,7,2,3,23,2025-03-24T14:34:09.846Z
2025-03-24,10:30 AM,4,4,9,1,0,18,2025-03-24T15:34:34.327Z
2025-03-24,11:30 AM,10,3,6,3,0,22,2025-03-24T16:38:07.116Z
2025-03-24,12:30 PM,10,9,15,5,1,40,2025-03-24T17:43:18.993Z
2025-03-24,1:30 PM,7,5,9,1,0,22,2025-03-24T18:48:07.915Z
2025-03-24,2:30 PM,7,5,9,3,0,24,2025-03-24T19:29:29.334Z
2025-03-24,3:30 PM,6,7,6,5,1,25,2025-03-24T20:37:03.696Z
2025-03-24,4:30 PM,4,5,7,6,1,23,2025-03-24T21:32:29.965Z
2025-03-24,5:30 PM,6,4,6,4,1,21,2025-03-24T22:38:43.135Z
2025-03-24,6:30 PM,5,3,6,4,0,18,2025-03-24T23:32:32.904Z
2025-03-24,7:30 PM,4,2,3,4,0,13,2025-03-25T00:35:33.304Z
2025-03-24,8:30 PM,2,2,0,0,0,4,2025-03-25T01:40:54.664Z
2025-03-25,7:30 AM,2,1,0,1,0,4,2025-03-25T12:34:11.718Z
2025-03-25,8:30 AM,5,4,3,0,0,12,2025-03-25T13:39:23.470Z
2025-03-25,10:30 AM,5,4,7,2,1,19,2025-03-25T15:34:57.784Z
2025-03-25,9:30 AM,3,3,7,1,0,14,2025-03-25T15:35:33.616Z
2025-03-25,11:30 AM,4,4,14,3,3,28,2025-03-25T16:34:48.809Z
2025-03-25,12:30 PM,11,10,16,6,5,48,2025-03-25T17:40:18.915Z
2025-03-25,1:30 PM,6,5,14,6,0,31,2025-03-25T18:32:42.912Z
2025-03-25,2:30 PM,6,3,7,1,2,19,2025-03-25T19:51:26.852Z
2025-03-25,3:30 PM,3,3,11,0,1,18,2025-03-25T20:47:49.103Z
2025-03-25,4:30 PM,4,4,5,0,1,14,2025-03-25T21:39:31.276Z
2025-03-25,5:30 PM,5,6,5,2,0,18,2025-03-25T22:41:20.765Z
2025-03-25,6:30 PM,3,2,3,3,0,11,2025-03-25T23:47:49.832Z
2025-03-25,7:30 PM,3,2,2,2,1,10,2025-03-26T00:38:51.432Z
2025-03-25,8:30 PM,4,2,2,2,0,10,2025-03-26T01:40:12.457Z
2025-03-26,7:30 AM,1,0,1,0,0,2,2025-03-26T12:42:19.427Z
2025-03-26,8:30 AM,2,3,9,0,0,14,2025-03-26T13:38:53.300Z
2025-03-26,9:30 AM,2,0,6,1,3,12,2025-03-26T14:29:38.996Z
2025-03-26,10:30 AM,8,6,8,8,0,30,2025-03-26T15:43:56.010Z
2025-03-26,11:30 AM,8,3,12,6,0,29,2025-03-26T16:33:04.573Z
2025-03-26,12:30 PM,17,10,18,10,5,60,2025-03-26T17:33:47.320Z
2025-03-26,1:30 PM,7,6,10,8,3,34,2025-03-26T18:35:23.737Z
2025-03-26,2:30 PM,6,6,8,8,1,29,2025-03-26T19:30:59.471Z
2025-03-26,3:30 PM,7,5,10,4,0,26,2025-03-26T20:58:35.463Z
2025-03-26,4:30 PM,8,3,11,3,0,25,2025-03-26T21:33:19.842Z
2025-03-26,5:30 PM,8,3,9,2,0,22,2025-03-26T22:38:59.168Z
2025-03-26,6:30 PM,5,2,9,2,0,18,2025-03-26T23:55:05.088Z
2025-03-26,7:30 PM,3,1,6,1,1,12,2025-03-27T00:36:17.014Z
2025-03-27,7:30 AM,0,1,0,0,0,1,2025-03-27T12:34:23.207Z
2025-03-27,8:30 AM,0,3,2,0,0,5,2025-03-27T13:23:56.449Z
2025-03-27,9:30 AM,5,3,6,0,1,15,2025-03-27T14:27:13.719Z
2025-03-27,10:30 AM,12,4,9,1,0,26,2025-03-27T15:36:38.693Z
2025-03-27,11:30 AM,8,3,12,4,0,27,2025-03-27T16:34:19.293Z
2025-03-27,12:30 PM,12,8,13,9,2,44,2025-03-27T17:45:29.133Z
2025-03-27,1:30 PM,4,5,11,5,2,27,2025-03-27T18:34:46.862Z
2025-03-27,2:30 PM,7,3,5,3,3,21,2025-03-27T19:36:17.102Z
2025-03-27,3:30 PM,6,4,5,2,5,22,2025-03-27T20:34:46.193Z
2025-03-27,4:30 PM,9,2,0,2,1,14,2025-03-27T21:41:43.061Z
2025-03-27,5:30 PM,11,1,5,0,1,18,2025-03-27T22:51:37.741Z
2025-03-27,6:30 PM,2,0,3,0,0,5,2025-03-27T23:33:59.158Z
2025-03-27,7:30 PM,3,0,4,0,0,7,2025-03-28T00:56:06.821Z
2025-03-27,8:30 PM,3,1,3,0,0,7,2025-03-28T01:53:13.157Z
2025-03-28,7:30 AM,1,0,0,0,0,1,2025-03-28T13:42:01.145Z
2025-03-28,8:30 AM,1,0,1,0,0,2,2025-03-28T13:42:27.169Z
2025-03-28,9:30 AM,4,1,0,0,0,5,2025-03-28T15:04:56.064Z
2025-03-28,10:30 AM,2,2,0,0,0,4,2025-03-28T15:36:07.582Z
2025-03-28,11:30 AM,5,1,2,1,0,9,2025-03-28T16:31:30.493Z
2025-03-28,12:30 PM,3,3,2,0,0,8,2025-03-28T17:39:02.793Z
2025-03-28,1:30 PM,2,1,3,0,0,6,2025-03-28T18:43:05.455Z
2025-03-28,2:30 PM,1,1,6,3,0,11,2025-03-28T19:33:48.550Z
2025-03-28,3:30 PM,4,2,4,2,0,12,2025-03-28T20:48:13.619Z
2025-03-28,4:30 PM,4,0,6,2,0,12,2025-03-28T21:57:28.743Z
2025-03-28,5:30 PM,2,0,7,3,0,12,2025-03-28T22:46:15.136Z
2025-03-28,6:30 PM,3,0,3,2,0,8,2025-03-28T23:49:41.128Z
2025-03-29,10:30 AM,0,1,2,0,0,3,2025-03-29T15:41:03.489Z
2025-03-29,11:30 AM,0,1,2,1,0,4,2025-03-29T16:37:03.804Z
2025-03-29,12:30 PM,1,3,1,1,0,6,2025-03-29T17:35:06.360Z
2025-03-29,2:30 PM,2,1,2,0,0,5,2025-03-29T20:00:20.797Z
2025-03-29,2:30 PM,2,1,0,1,0,4,2025-03-29T20:17:12.712Z
2025-03-29,3:30 PM,5,2,0,0,0,7,2025-03-29T20:39:44.140Z
2025-03-31,7:30 AM,6,1,1,0,0,8,2025-03-31T12:42:55.285Z
2025-03-31,8:30 AM,5,3,5,3,0,16,2025-03-31T13:37:34.028Z
2025-03-31,9:30 AM,8,3,4,0,0,15,2025-03-31T14:32:39.165Z
2025-03-31,10:30 AM,10,3,6,0,0,19,2025-03-31T15:28:33.451Z
2025-03-31,11:30 AM,13,7,21,5,1,47,2025-03-31T16:30:54.816Z
2025-03-31,12:30 PM,16,9,24,8,0,57,2025-03-31T17:41:07.178Z
2025-03-31,1:30 PM,5,6,15,8,0,34,2025-03-31T18:50:44.939Z
2025-03-31,2:30 PM,9,6,3,1,0,19,2025-03-31T19:51:24.478Z
2025-03-31,3:30 PM,13,5,6,3,0,27,2025-03-31T21:05:14.123Z
2025-03-31,4:30 PM,12,3,6,2,1,24,2025-03-31T22:24:37.939Z
2025-03-31,5:30 PM,10,2,9,1,0,22,2025-03-31T22:25:25.923Z
2025-03-31,6:30 PM,9,2,7,4,1,23,2025-03-31T23:35:06.839Z
2025-03-31,7:30 PM,5,3,6,3,1,18,2025-04-01T00:31:33.554Z
2025-03-31,8:30 PM,3,0,0,1,0,4,2025-04-01T01:38:41.188Z
2025-04-01,7:30 AM,3,0,0,0,0,3,2025-04-01T12:39:28.788Z
2025-04-01,8:30 AM,5,1,6,2,0,14,2025-04-01T13:33:15.186Z
2025-04-01,9:30 AM,3,0,8,3,0,14,2025-04-01T14:33:33.937Z
2025-04-01,10:30 AM,6,2,15,4,0,27,2025-04-01T15:32:15.777Z
2025-04-01,11:30 AM,5,0,11,5,0,21,2025-04-01T16:27:18.247Z
2025-04-01,12:30 PM,16,10,26,4,1,57,2025-04-01T17:37:28.945Z
2025-04-01,1:30 PM,7,8,11,7,1,34,2025-04-01T18:37:58.088Z
2025-04-01,2:30 PM,5,6,8,4,4,27,2025-04-01T19:29:09.944Z
2025-04-01,3:30 PM,7,2,9,3,1,22,2025-04-01T20:32:49.704Z
2025-04-01,4:30 PM,11,3,13,5,2,34,2025-04-01T21:52:43.420Z
2025-04-01,5:30 PM,5,1,10,4,1,21,2025-04-01T22:39:02.152Z
2025-04-01,6:30 PM,5,1,7,3,0,16,2025-04-01T23:36:38.217Z
2025-04-01,7:30 PM,4,4,2,3,0,13,2025-04-02T00:29:36.972Z
2025-04-02,7:30 AM,2,1,0,0,0,3,2025-04-02T13:11:12.289Z
2025-04-02,8:30 AM,3,3,4,1,1,12,2025-04-02T13:30:32.610Z
2025-04-02,9:30 AM,2,3,8,1,0,14,2025-04-02T14:33:09.275Z
2025-04-02,10:30 AM,5,8,15,2,1,31,2025-04-02T15:37:01.291Z
2025-04-02,11:30 PM,5,4,16,2,0,27,2025-04-02T17:11:12.408Z
2025-04-02,12:30 PM,8,8,9,5,4,34,2025-04-02T17:49:18.695Z
2025-04-02,1:30 PM,3,6,15,4,1,29,2025-04-02T18:35:51.107Z
2025-04-02,2:30 PM,7,6,12,3,2,30,2025-04-02T19:35:15.920Z
2025-04-02,3:30 PM,8,4,5,1,0,18,2025-04-02T20:41:18.350Z
2025-04-02,4:30 PM,7,3,3,2,0,15,"2/4/2025, 4:59:21 p.m."
2025-04-02,6:30 PM,5,2,2,1,0,10,"2/4/2025, 6:50:23 p.m."
2025-04-02,7:30 PM,3,1,2,1,0,7,"2/4/2025, 7:31:32 p.m."
2025-04-02,8:30 PM,2,1,2,0,0,5,"2/4/2025, 8:56:59 p.m."
2025-04-03,7:30 AM,4,1,0,0,0,5,"3/4/2025, 8:16:39 a.m."
2025-04-03,8:30 AM,5,3,10,2,0,20,"3/4/2025, 8:56:31 a.m."
2025-04-03,9:30 AM,3,4,10,2,0,19,"3/4/2025, 10:13:49 a.m."
2025-04-03,10:30 AM,6,3,10,4,0,23,"3/4/2025, 10:39:38 a.m."
2025-04-03,12:30 PM,10,5,15,3,2,35,"3/4/2025, 12:24:27 p.m."
2025-04-03,12:30 PM,10,6,17,9,1,43,"3/4/2025, 12:49:53 p.m."
2025-04-03,1:30 PM,11,4,9,4,0,28,"3/4/2025, 1:35:47 p.m."
2025-04-03,3:30 PM,5,4,9,0,0,18,2025-04-03T20:47:18.517Z
2025-04-03,4:30 PM,6,4,4,2,0,16,2025-04-03T21:32:38.398Z
2025-04-03,5:30 PM,6,1,6,2,2,17,2025-04-03T22:27:25.062Z
2025-04-03,6:30 PM,7,3,2,1,0,13,2025-04-03T23:26:42.391Z
2025-04-03,7:30 PM,2,3,3,1,0,9,"3/4/2025, 7:51:04 p.m."
2025-04-03,8:30 PM,2,1,2,1,0,6,"3/4/2025, 8:24:45 p.m."
2025-04-04,7:30 AM,1,1,0,0,0,2,"4/4/2025, 7:42:31 a.m."
2025-04-04,8:30 AM,1,0,1,0,0,2,"4/4/2025, 8:35:06 a.m."
2025-04-04,9:30 AM,2,0,3,0,0,5,"4/4/2025, 9:36:21 a.m."
2025-04-04,10:30 AM,4,0,4,0,0,8,"4/4/2025, 10:36:52 a.m."
2025-04-04,11:30 AM,6,1,5,4,0,16,"4/4/2025, 11:35:21 a.m."
2025-04-04,12:30 PM,4,2,7,0,0,13,"4/4/2025, 1:48:44 p.m."
2025-04-04,1:30 PM,5,2,9,0,0,16,"4/4/2025, 1:49:10 p.m."
2025-04-04,2:30 PM,5,1,7,0,1,14,"4/4/2025, 2:33:20 p.m."
2025-04-04,3:30 PM,3,1,6,0,0,10,2025-04-04T20:40:26.915Z
2025-04-04,4:30 PM,4,2,4,2,1,13,2025-04-04T21:27:18.810Z
2025-04-04,5:30 PM,5,3,3,4,0,15,"4/4/2025, 5:44:40 p.m."
2025-04-04,6:30 PM,1,1,1,3,0,6,"4/4/2025, 6:42:39 p.m."
2025-04-05,10:30 AM,2,1,2,0,0,5,"5/4/2025, 10:29:53 a.m."
2025-04-05,11:30 AM,3,2,3,0,0,8,"5/4/2025, 11:59:26 a.m."
2025-04-05,12:30 PM,4,2,3,1,0,10,"5/4/2025, 1:08:01 p.m."
2025-04-05,1:30 PM,1,1,3,2,1,8,"5/4/2025, 1:28:51 p.m."
2025-04-05,3:30 PM,4,2,4,0,0,10,"5/4/2025, 3:37:08 p.m."
2025-04-05,4:30 PM,3,3,2,0,0,8,"5/4/2025, 4:31:17 p.m."
2025-04-07,8:30 AM,6,5,7,0,0,18,"7/4/2025, 9:08:30 a.m."
2025-04-07,9:30 AM,5,4,9,0,2,20,"7/4/2025, 9:24:16 a.m."
2025-04-07,9:30 AM,6,3,4,1,2,16,"7/4/2025, 9:25:43 a.m."
2025-04-07,10:30 AM,9,6,6,1,0,22,"7/4/2025, 10:34:39 a.m."
2025-04-07,11:30 AM,13,6,15,2,0,36,"7/4/2025, 11:42:11 a.m."
2025-04-07,12:30 PM,11,6,17,9,1,44,"7/4/2025, 12:48:45 p.m."
2025-04-07,1:30 PM,4,7,9,0,0,20,"7/4/2025, 1:37:24 p.m."
2025-04-07,2:30 PM,3,4,7,3,0,17,"7/4/2025, 2:41:23 p.m."
2025-04-07,3:30 PM,8,5,7,2,3,25,"7/4/2025, 3:36:30 p.m."
2025-04-07,4:30 PM,9,4,8,2,0,23,"7/4/2025, 4:45:04 p.m."
2025-04-07,5:30 PM,1,2,11,1,0,15,"7/4/2025, 5:33:23 p.m."
2025-04-07,6:30 PM,2,4,9,2,0,17,"7/4/2025, 6:37:21 p.m."
2025-04-07,7:30 PM,3,1,2,2,0,8,"7/4/2025, 7:30:48 p.m."
2025-04-07,8:30 PM,2,1,0,2,0,5,"7/4/2025, 8:37:18 p.m."
2025-04-08,7:30 AM,3,1,2,0,0,6,"8/4/2025, 7:51:57 a.m."
2025-04-08,8:30 AM,2,1,3,1,0,7,"8/4/2025, 8:30:55 a.m."
2025-04-08,9:30 AM,2,0,10,0,0,12,"8/4/2025, 9:45:59 a.m."
2025-04-08,10:30 AM,5,0,11,2,1,19,"8/4/2025, 10:35:20 a.m."
2025-04-08,11:30 AM,11,7,14,1,0,33,"8/4/2025, 11:33:32 a.m."
2025-04-08,12:30 PM,11,9,22,2,1,45,"8/4/2025, 12:37:26 p.m."
2025-04-08,1:30 PM,6,9,17,5,2,39,"8/4/2025, 1:33:32 p.m."
2025-04-08,2:30 PM,9,8,12,1,1,31,"8/4/2025, 2:34:35 p.m."
2025-04-08,3:30 PM,6,5,11,0,1,23,"8/4/2025, 3:37:52 p.m."
2025-04-08,4:30 PM,7,5,5,0,1,18,"8/4/2025, 4:43:10 p.m."
2025-04-08,5:30 PM,5,4,8,0,1,18,"8/4/2025, 5:30:02 p.m."
2025-04-08,6:30 PM,7,2,4,1,0,14,"8/4/2025, 6:37:35 p.m."
2025-04-08,7:30 PM,5,1,4,1,0,11,"8/4/2025, 7:36:19 p.m."
2025-04-08,8:30 PM,5,1,3,1,1,11,"8/4/2025, 8:40:31 p.m."
2025-04-09,7:30 AM,1,1,2,2,0,6,"9/4/2025, 8:04:50 a.m."
2025-04-09,8:30 AM,2,2,2,1,0,7,"9/4/2025, 8:24:35 a.m."
2025-04-09,9:30 AM,6,6,8,0,3,23,"9/4/2025, 9:29:06 a.m."
2025-04-09,10:30 AM,11,7,6,7,0,31,"9/4/2025, 10:27:58 a.m."
2025-04-09,11:30 PM,11,7,14,6,0,38,"9/4/2025, 12:18:39 p.m."
2025-04-09,12:30 PM,11,9,20,12,1,53,"9/4/2025, 12:45:22 p.m."
2025-04-09,1:30 PM,11,7,13,6,2,39,"9/4/2025, 1:37:34 p.m."
2025-04-09,2:30 PM,6,8,17,7,0,38,"9/4/2025, 2:40:25 p.m."
2025-04-09,3:30 PM,7,4,13,4,0,28,"9/4/2025, 3:53:52 p.m."
2025-04-09,4:30 PM,7,4,8,3,0,22,"9/4/2025, 5:12:48 p.m."
2025-04-09,5:30 PM,6,2,7,3,0,18,"9/4/2025, 6:45:52 p.m."
2025-04-09,6:30 PM,5,6,0,4,0,15,"9/4/2025, 6:46:28 p.m."
2025-04-09,7:30 PM,4,2,7,3,0,16,"9/4/2025, 7:32:49 p.m."
2025-04-10,7:30 AM,0,1,3,0,0,4,"10/4/2025, 8:03:51 a.m."
2025-04-10,8:30 AM,7,1,4,0,0,12,"10/4/2025, 8:30:17 a.m."
2025-04-10,10:30 AM,9,5,9,6,2,31,"10/4/2025, 10:46:49 a.m."
2025-04-10,11:30 AM,9,5,15,5,0,34,"10/4/2025, 11:32:35 a.m."
2025-04-10,12:30 PM,12,8,22,4,0,46,"10/4/2025, 12:36:11 p.m."
2025-04-10,1:30 PM,8,7,6,5,0,26,"10/4/2025, 1:34:33 p.m."
2025-04-10,2:30 PM,5,3,8,4,0,20,"10/4/2025, 2:42:08 p.m."
2025-04-10,3:30 PM,5,6,9,3,1,24,"10/4/2025, 3:35:35 p.m."
2025-04-10,4:30 PM,5,3,4,0,1,13,"10/4/2025, 4:35:20 p.m."
2025-04-10,5:30 PM,4,2,7,2,1,16,"10/4/2025, 5:35:11 p.m."
2025-04-10,6:30 PM,4,4,3,1,0,12,"10/4/2025, 6:28:55 p.m."
2025-04-10,7:30 PM,3,1,2,1,0,7,"10/4/2025, 8:26:09 p.m."
2025-04-10,8:30 PM,3,1,1,0,0,5,"10/4/2025, 8:57:15 p.m."
2025-04-11,7:30 AM,0,0,0,0,0,0,"11/4/2025, 7:54:21 a.m."
2025-04-11,8:30 AM,1,0,1,0,0,2,"11/4/2025, 8:39:58 a.m."
2025-04-11,9:30 AM,4,2,3,0,0,9,"11/4/2025, 9:45:14 a.m."
2025-04-11,10:30 AM,1,3,4,0,0,8,"11/4/2025, 10:57:54 a.m."
2025-04-11,11:30 AM,5,3,4,1,0,13,"11/4/2025, 11:39:29 a.m."
2025-04-11,12:30 PM,3,5,5,1,0,14,"11/4/2025, 12:37:00 p.m."
2025-04-11,1:30 PM,3,3,5,1,1,13,"11/4/2025, 1:33:29 p.m."
2025-04-11,2:30 PM,5,3,4,0,0,12,"11/4/2025, 2:35:36 p.m."
2025-04-11,3:30 PM,5,4,4,0,0,13,"11/4/2025, 3:31:08 p.m."
2025-04-11,4:30 PM,1,4,5,0,1,11,"11/4/2025, 4:42:12 p.m."
2025-04-11,5:30 PM,3,3,5,0,0,11,"11/4/2025, 5:44:52 p.m."
2025-04-11,6:30 PM,1,1,3,1,0,6,"11/4/2025, 6:26:23 p.m."
2025-04-12,10:30 AM,1,2,1,0,0,4,"12/4/2025, 10:36:14 a.m."
2025-04-12,11:30 AM,1,3,4,0,0,8,"12/4/2025, 11:47:57 a.m."
2025-04-12,12:30 PM,2,3,6,0,0,11,"12/4/2025, 12:31:54 p.m."
2025-04-12,1:30 PM,2,2,0,0,0,4,"12/4/2025, 1:26:28 p.m."
2025-04-12,2:30 PM,1,1,1,0,0,3,"12/4/2025, 2:36:08 p.m."
2025-04-12,3:30 PM,1,1,1,0,0,3,"12/4/2025, 3:30:52 p.m."
2025-04-12,4:30 PM,2,1,1,0,0,4,"12/4/2025, 5:27:17 p.m."
2025-04-14,7:30 AM,1,1,1,0,0,3,"14/4/2025, 7:47:29 a.m."
2025-04-14,8:30 AM,3,4,4,0,0,11,"14/4/2025, 8:19:51 a.m."
2025-04-14,9:30 AM,5,4,7,1,3,20,"14/4/2025, 9:33:53 a.m."
2025-04-14,10:30 AM,9,6,12,3,2,32,"14/4/2025, 10:33:57 a.m."
2025-04-14,11:30 AM,7,7,15,7,1,37,"14/4/2025, 11:35:48 a.m."
2025-04-14,12:30 PM,14,10,17,8,0,49,"14/4/2025, 12:37:18 p.m."
2025-04-14,1:30 PM,8,6,12,7,0,33,"14/4/2025, 1:31:12 p.m."
2025-04-14,2:30 PM,8,5,10,6,0,29,"14/4/2025, 2:46:00 p.m."
2025-04-14,3:30 PM,4,6,10,7,1,28,"14/4/2025, 3:34:11 p.m."
2025-04-14,4:30 PM,5,6,9,8,1,29,"14/4/2025, 5:01:35 p.m."
2025-04-14,5:30 PM,3,5,11,5,1,25,"14/4/2025, 5:29:46 p.m."
2025-04-14,6:30 PM,2,3,4,5,0,14,"14/4/2025, 6:59:43 p.m."
2025-04-14,7:30 PM,3,5,4,2,0,14,"14/4/2025, 7:36:40 p.m."
2025-04-14,8:30 PM,2,1,4,2,0,9,"14/4/2025, 8:43:11 p.m."
2025-04-15,7:30 AM,1,2,2,0,0,5,"15/4/2025, 7:38:25 a.m."
2025-04-15,8:30 AM,8,3,3,1,1,16,"15/4/2025, 8:30:34 a.m."
2025-04-15,9:30 AM,5,2,2,0,0,9,"15/4/2025, 9:31:28 a.m."
2025-04-15,10:30 AM,9,4,14,1,0,28,"15/4/2025, 10:36:15 a.m."
2025-04-15,11:30 AM,12,5,10,3,0,30,"15/4/2025, 11:40:08 a.m."
2025-04-15,12:30 PM,15,8,16,4,0,43,"15/4/2025, 12:36:26 p.m."
2025-04-15,1:30 PM,7,7,13,5,0,32,"15/4/2025, 1:51:49 p.m."
2025-04-15,2:30 PM,6,5,15,3,1,30,"15/4/2025, 2:32:43 p.m."
2025-04-15,3:30 PM,5,4,9,2,1,21,"15/4/2025, 3:33:37 p.m."
2025-04-15,4:30 PM,1,4,10,3,0,18,"15/4/2025, 4:52:20 p.m."
2025-04-15,5:30 PM,4,1,6,1,0,12,"15/4/2025, 6:40:19 p.m."
2025-04-15,6:30 PM,4,3,8,0,0,15,"15/4/2025, 6:40:41 p.m."
2025-04-15,7:30 PM,5,2,3,2,0,12,"15/4/2025, 7:26:30 p.m."
2025-04-16,7:30 AM,3,0,0,0,0,3,"16/4/2025, 7:33:54 a.m."
2025-04-16,8:30 AM,4,2,4,1,0,11,"16/4/2025, 8:33:08 a.m."
2025-04-16,9:30 AM,1,3,4,1,0,9,"16/4/2025, 9:28:35 a.m."
2025-04-16,10:30 AM,5,8,9,7,0,29,"16/4/2025, 10:37:51 a.m."
2025-04-16,11:30 AM,7,5,14,3,0,29,"16/4/2025, 11:34:23 a.m."
2025-04-16,12:30 PM,14,9,18,9,1,51,"16/4/2025, 12:36:02 p.m."
2025-04-16,1:30 PM,1,5,9,2,0,17,"16/4/2025, 1:35:44 p.m."
2025-04-16,2:30 PM,6,5,9,1,0,21,"16/4/2025, 2:37:17 p.m."
2025-04-16,2:30 PM,3,6,10,2,2,23,"16/4/2025, 2:44:45 p.m."
2025-04-16,3:30 PM,4,6,9,2,0,21,"16/4/2025, 3:38:58 p.m."
2025-04-16,4:30 PM,7,6,6,0,0,19,"16/4/2025, 4:51:34 p.m."
2025-04-16,6:30 PM,7,6,3,0,0,16,"16/4/2025, 6:40:40 p.m."
2025-04-16,7:30 PM,5,3,4,0,2,14,"16/4/2025, 7:32:34 p.m."
2025-04-16,8:30 PM,2,2,3,2,0,9,"16/4/2025, 8:33:57 p.m."
2025-04-17,7:30 AM,4,1,1,0,0,6,"17/4/2025, 7:48:24 a.m."
2025-04-17,8:30 AM,3,3,0,0,0,6,"17/4/2025, 8:34:34 a.m."
2025-04-17,9:30 AM,6,2,7,0,0,15,"17/4/2025, 9:41:06 a.m."
2025-04-17,10:30 AM,9,5,20,3,0,37,"17/4/2025, 10:35:14 a.m."
2025-04-17,11:30 AM,13,6,20,3,1,43,"17/4/2025, 11:49:11 a.m."
2025-04-17,12:30 PM,11,9,20,4,1,45,"17/4/2025, 12:32:50 p.m."
2025-04-17,1:30 PM,11,3,15,1,0,30,"17/4/2025, 1:41:44 p.m."
2025-04-17,2:30 PM,9,6,12,2,0,29,"17/4/2025, 2:36:52 p.m."
2025-04-17,3:30 PM,6,6,9,1,2,24,"17/4/2025, 3:32:43 p.m."
2025-04-17,4:30 PM,5,4,6,0,2,17,"17/4/2025, 4:36:34 p.m."
2025-04-17,5:30 PM,4,2,3,0,0,9,"17/4/2025, 6:06:07 p.m."
2025-04-17,6:30 PM,3,1,7,1,1,13,"17/4/2025, 6:44:17 p.m."
2025-04-17,7:30 PM,4,1,5,1,0,11,"17/4/2025, 7:27:55 p.m."
2025-04-17,8:30 PM,3,1,2,1,0,7,"17/4/2025, 8:48:04 p.m."
2025-04-18,7:30 AM,1,1,0,0,0,2,"18/4/2025, 7:48:27 a.m."
2025-04-18,8:30 AM,2,3,0,0,0,5,"18/4/2025, 8:40:17 a.m."
2025-04-18,9:30 AM,2,3,1,0,0,6,"18/4/2025, 9:21:42 a.m."
2025-04-18,10:30 AM,3,2,4,1,0,10,"18/4/2025, 11:55:44 a.m."
2025-04-18,11:30 AM,3,2,5,0,0,10,"18/4/2025, 11:56:14 a.m."
2025-04-18,12:30 PM,2,5,4,1,0,12,"18/4/2025, 12:34:16 p.m."
2025-04-18,1:30 PM,0,3,5,0,0,8,"18/4/2025, 1:34:49 p.m."
2025-04-18,2:30 PM,4,2,5,0,1,12,"18/4/2025, 2:32:39 p.m."
2025-04-18,3:30 PM,1,1,4,0,0,6,"18/4/2025, 3:47:32 p.m."
2025-04-18,4:30 PM,3,1,6,0,0,10,"18/4/2025, 5:03:27 p.m."
2025-04-18,5:30 PM,1,0,3,0,0,4,"18/4/2025, 5:50:03 p.m."
2025-04-18,6:30 PM,2,1,2,0,2,7,"18/4/2025, 6:49:06 p.m."
2025-04-19,10:30 AM,3,1,0,0,1,5,"19/4/2025, 10:39:59 a.m."
2025-04-19,11:30 PM,2,1,0,0,1,4,"19/4/2025, 1:01:46 p.m."
2025-04-19,12:30 PM,2,1,0,0,1,4,"19/4/2025, 1:02:07 p.m."
2025-04-19,1:30 PM,3,1,0,0,0,4,"19/4/2025, 1:31:20 p.m."
2025-04-19,2:30 PM,2,1,0,2,0,5,"19/4/2025, 2:42:12 p.m."
2025-04-19,3:30 PM,3,1,2,0,0,6,"19/4/2025, 4:37:46 p.m."
2025-04-19,4:30 PM,4,2,2,0,0,8,"19/4/2025, 4:38:02 p.m."
2025-04-21,7:30 AM,1,1,0,0,0,2,"21/4/2025, 7:32:11 a.m."
2025-04-21,8:30 AM,3,6,1,2,0,12,"21/4/2025, 8:36:58 a.m."
2025-04-21,9:30 AM,2,3,5,0,4,14,"21/4/2025, 9:33:34 a.m."
2025-04-21,10:30 AM,11,7,21,2,1,42,"21/4/2025, 10:35:47 a.m."
2025-04-21,11:30 AM,9,5,12,4,1,31,"21/4/2025, 11:46:20 a.m."
2025-04-21,12:30 PM,16,6,23,12,1,58,"21/4/2025, 12:38:19 p.m."
2025-04-21,1:30 PM,15,6,23,5,2,51,"21/4/2025, 1:37:05 p.m."
2025-04-21,2:30 PM,20,5,25,6,3,59,"21/4/2025, 2:36:32 p.m."
2025-04-21,3:30 PM,8,5,22,0,3,38,"21/4/2025, 3:33:23 p.m."
2025-04-21,4:30 PM,4,2,11,4,0,21,"21/4/2025, 4:56:43 p.m."
2025-04-21,5:30 PM,5,1,12,3,0,21,"21/4/2025, 5:34:46 p.m."
2025-04-21,6:30 PM,3,2,5,2,0,12,"21/4/2025, 6:40:57 p.m."
2025-04-21,7:30 PM,4,3,4,0,0,11,"21/4/2025, 7:38:51 p.m."
2025-04-21,8:30 PM,3,3,2,0,1,9,"21/4/2025, 8:31:37 p.m."
2025-04-22,7:30 AM,3,0,0,0,0,3,"22/4/2025, 7:53:09 a.m."
2025-04-22,8:30 AM,3,3,4,0,0,10,"22/4/2025, 8:32:52 a.m."
2025-04-22,9:30 AM,5,2,9,0,0,16,"22/4/2025, 9:27:01 a.m."
2025-04-22,10:30 AM,6,5,7,3,1,22,"22/4/2025, 10:35:39 a.m."
2025-04-22,11:30 AM,12,9,15,1,6,43,"22/4/2025, 11:33:29 a.m."
2025-04-22,12:30 PM,10,15,13,3,0,41,"22/4/2025, 12:32:33 p.m."
2025-04-22,1:30 PM,6,7,10,3,0,26,"22/4/2025, 1:37:39 p.m."
2025-04-22,2:30 PM,7,4,9,3,3,26,"22/4/2025, 2:38:16 p.m."
2025-04-22,3:30 PM,9,6,9,4,0,28,"22/4/2025, 3:34:13 p.m."
2025-04-22,4:30 PM,3,4,6,1,1,15,"22/4/2025, 4:45:57 p.m."
2025-04-22,5:30 PM,2,2,8,1,0,13,"22/4/2025, 5:42:47 p.m."
2025-04-22,6:30 PM,1,1,3,0,1,6,"22/4/2025, 6:33:56 p.m."
2025-04-22,7:30 PM,5,2,3,0,0,10,"22/4/2025, 8:27:36 p.m."
2025-04-22,8:30 PM,4,1,2,0,0,7,"22/4/2025, 8:30:39 p.m."
2025-04-22,8:30 PM,2,2,4,0,0,8,"22/4/2025, 8:32:09 p.m."
2025-04-23,7:30 AM,2,2,0,0,0,4,"23/4/2025, 7:59:05 a.m."
2025-04-23,7:30 AM,1,1,0,0,0,2,"23/4/2025, 8:04:10 a.m."
2025-04-23,8:30 AM,3,2,4,1,0,10,"23/4/2025, 8:50:02 a.m."
2025-04-23,9:30 AM,4,1,4,0,0,9,"23/4/2025, 9:25:39 a.m."
2025-04-23,10:30 AM,10,6,8,4,0,28,"23/4/2025, 10:32:34 a.m."
2025-04-23,11:30 AM,11,6,16,6,0,39,"23/4/2025, 11:39:22 a.m."
2025-04-23,12:30 PM,7,10,14,4,0,35,"23/4/2025, 12:36:10 p.m."
2025-04-23,1:30 PM,9,6,11,4,0,30,"23/4/2025, 1:32:56 p.m."
2025-04-23,2:30 PM,9,7,9,7,0,32,"23/4/2025, 2:36:25 p.m."
2025-04-23,3:30 PM,6,7,9,2,0,24,"23/4/2025, 3:30:02 p.m."
2025-04-23,5:30 PM,7,3,6,2,2,20,"23/4/2025, 5:35:03 p.m."
2025-04-23,6:30 PM,5,2,3,2,1,13,"23/4/2025, 6:28:32 p.m."
2025-04-23,7:30 PM,0,2,1,1,1,5,"23/4/2025, 7:28:32 p.m."
2025-04-23,8:30 PM,2,1,0,1,0,4,"23/4/2025, 8:37:47 p.m."
2025-04-24,7:30 AM,1,1,0,0,0,2,"24/4/2025, 8:37:26 a.m."
2025-04-24,8:30 AM,1,3,3,0,0,7,"24/4/2025, 8:38:49 a.m."
2025-04-24,9:30 AM,4,3,5,0,0,12,"24/4/2025, 9:32:48 a.m."
2025-04-24,10:30 AM,8,2,10,3,0,23,"24/4/2025, 10:40:59 a.m."
2025-04-24,11:30 AM,10,5,15,1,0,31,"24/4/2025, 11:35:53 a.m."
2025-04-24,12:30 PM,13,7,13,8,2,43,"24/4/2025, 12:47:54 p.m."
2025-04-24,1:30 PM,6,3,12,5,3,29,"24/4/2025, 1:37:11 p.m."
2025-04-24,2:30 PM,7,7,20,2,3,39,"24/4/2025, 2:38:59 p.m."
2025-04-24,3:30 PM,6,5,13,2,1,27,"24/4/2025, 3:46:59 p.m."
2025-04-24,4:30 PM,3,4,14,0,0,21,"24/4/2025, 4:30:53 p.m."
2025-04-24,5:30 PM,6,3,11,0,0,20,"24/4/2025, 5:33:20 p.m."
2025-04-24,8:30 PM,4,0,3,0,0,7,"24/4/2025, 8:34:15 p.m."
2025-04-25,7:30 AM,1,0,0,0,0,1,"25/4/2025, 7:33:17 a.m."
2025-04-25,8:30 AM,2,1,0,0,0,3,"25/4/2025, 8:46:21 a.m."
2025-04-25,9:30 AM,2,0,0,0,0,2,"25/4/2025, 9:43:23 a.m."
2025-04-25,10:30 AM,3,2,1,1,0,7,"25/4/2025, 10:39:31 a.m."
2025-04-25,11:30 AM,6,1,3,2,1,13,"25/4/2025, 11:30:34 a.m."
2025-04-25,12:30 PM,5,3,5,4,0,17,"25/4/2025, 12:33:48 p.m."
2025-04-25,1:30 PM,7,5,6,0,0,18,"25/4/2025, 1:48:07 p.m."
2025-04-25,2:30 PM,5,5,6,0,0,16,"25/4/2025, 2:30:25 p.m."
2025-04-25,3:30 PM,6,2,3,0,0,11,"25/4/2025, 3:37:11 p.m."
2025-04-25,4:30 PM,2,3,3,0,1,9,"25/4/2025, 4:29:33 p.m."
2025-04-25,4:30 PM,3,1,6,2,0,12,"25/4/2025, 6:24:25 p.m."
2025-04-25,5:30 PM,3,2,4,2,0,11,"25/4/2025, 6:29:23 p.m."
2025-04-25,6:30 PM,1,1,5,0,0,7,"25/4/2025, 6:40:36 p.m."
2025-04-26,10:30 AM,4,1,1,0,0,6,"26/4/2025, 10:33:55 a.m."
2025-04-26,11:30 AM,5,3,3,0,1,12,"26/4/2025, 11:37:05 a.m."
2025-04-26,12:30 PM,3,3,5,0,0,11,"26/4/2025, 1:02:44 p.m."
2025-04-26,1:30 PM,5,1,2,1,0,9,"26/4/2025, 1:41:41 p.m."
2025-04-26,3:30 PM,3,1,4,1,0,9,"26/4/2025, 3:15:13 p.m."
2025-04-28,7:30 AM,1,1,0,0,0,2,"28/4/2025, 7:44:28 a.m."
2025-04-28,8:30 AM,3,2,3,1,0,9,"28/4/2025, 8:22:45 a.m."
2025-04-28,9:30 AM,5,3,4,4,0,16,"28/4/2025, 9:33:01 a.m."
2025-04-28,10:30 AM,16,11,18,6,1,52,"28/4/2025, 10:43:49 a.m."
2025-04-28,12:30 PM,17,8,15,4,1,45,"28/4/2025, 12:00:56 p.m."
2025-04-28,12:30 PM,15,9,19,7,2,52,"28/4/2025, 12:42:14 p.m."
2025-04-28,1:30 PM,8,5,12,1,1,27,"28/4/2025, 1:32:46 p.m."
2025-04-28,2:30 PM,10,7,10,1,1,29,"28/4/2025, 2:35:37 p.m."
2025-04-28,3:30 PM,6,5,12,5,0,28,"28/4/2025, 3:33:34 p.m."
2025-04-28,4:30 PM,7,2,15,4,6,34,"28/4/2025, 4:48:52 p.m."
2025-04-28,5:30 PM,6,1,15,2,3,27,"28/4/2025, 5:54:07 p.m."
2025-04-28,6:30 PM,5,3,7,3,6,24,"28/4/2025, 6:35:49 p.m."
2025-04-28,7:30 PM,2,2,3,2,0,9,"28/4/2025, 7:33:24 p.m."
2025-04-29,7:30 AM,2,1,0,0,0,3,"29/4/2025, 7:47:42 a.m."
2025-04-29,8:30 AM,1,3,5,2,1,12,"29/4/2025, 8:37:58 a.m."
2025-04-29,9:30 AM,2,2,3,0,1,8,"29/4/2025, 9:30:14 a.m."
2025-04-29,10:30 AM,6,3,16,3,1,29,"29/4/2025, 10:32:48 a.m."
2025-04-29,11:30 AM,8,4,12,2,0,26,"29/4/2025, 11:34:36 a.m."
2025-04-29,12:30 PM,11,5,8,5,1,30,"29/4/2025, 12:33:05 p.m."
2025-04-29,1:30 PM,12,3,6,5,1,27,"29/4/2025, 1:32:12 p.m."
2025-04-29,2:30 PM,12,3,9,2,1,27,"29/4/2025, 2:34:32 p.m."
2025-04-29,3:30 PM,12,7,10,0,3,32,"29/4/2025, 3:31:59 p.m."
2025-04-29,4:30 PM,8,5,6,0,2,21,"29/4/2025, 5:17:14 p.m."
2025-04-29,5:30 PM,5,4,4,0,0,13,"29/4/2025, 6:05:22 p.m."
2025-04-29,7:30 PM,3,1,1,1,0,6,"29/4/2025, 7:52:01 p.m."
2025-04-29,8:30 PM,3,1,1,1,0,6,"29/4/2025, 8:51:05 p.m."
2025-04-30,7:30 AM,0,1,0,0,0,1,"30/4/2025, 8:10:25 a.m."
2025-04-30,8:30 AM,4,5,2,0,1,12,"30/4/2025, 8:43:36 a.m."
2025-04-30,9:30 AM,7,4,6,0,1,18,"30/4/2025, 9:25:35 a.m."
2025-04-30,10:30 AM,7,5,11,2,0,25,"30/4/2025, 10:37:57 a.m."
2025-04-30,11:30 AM,17,8,12,4,1,42,"30/4/2025, 11:42:24 a.m."
2025-04-30,12:30 PM,14,8,13,3,3,41,"30/4/2025, 12:35:14 p.m."
2025-04-30,1:30 PM,13,8,22,2,1,46,"30/4/2025, 1:38:09 p.m."
2025-04-30,2:30 PM,16,5,13,0,2,36,"30/4/2025, 2:54:38 p.m."
2025-04-30,3:30 PM,13,4,7,0,0,24,"30/4/2025, 3:49:40 p.m."
2025-04-30,4:30 PM,4,6,8,6,0,24,"30/4/2025, 5:08:41 p.m."
2025-04-30,5:30 PM,6,3,7,6,0,22,"30/4/2025, 5:29:20 p.m."
2025-04-30,6:30 PM,6,2,9,4,0,21,"30/4/2025, 6:57:05 p.m."
2025-04-30,7:30 PM,3,5,2,2,0,12,"30/4/2025, 7:34:59 p.m."
2025-04-30,8:30 PM,3,1,0,1,0,5,"30/4/2025, 8:44:46 p.m."
2025-05-01,7:30 AM,1,1,0,0,0,2,"1/5/2025, 8:17:34 a.m."
2025-05-01,8:30 AM,2,4,0,2,0,8,"1/5/2025, 8:32:28 a.m."
2025-05-01,9:30 AM,4,4,0,0,0,8,"1/5/2025, 9:31:01 a.m."
2025-05-01,10:30 AM,9,6,9,0,0,24,"1/5/2025, 10:34:03 a.m."
2025-05-01,11:30 AM,10,8,11,6,1,36,"1/5/2025, 11:48:43 a.m."
2025-05-01,12:30 PM,11,10,10,2,2,35,"1/5/2025, 12:33:10 p.m."
2025-05-01,1:30 PM,11,9,11,2,0,33,"1/5/2025, 1:32:32 p.m."
2025-05-01,2:30 PM,9,4,10,4,0,27,"1/5/2025, 2:33:16 p.m."
2025-05-01,3:30 PM,11,8,7,1,0,27,"1/5/2025, 3:33:08 p.m."
2025-05-01,4:30 PM,10,5,4,0,1,20,"1/5/2025, 4:43:07 p.m."
2025-05-01,5:30 PM,4,4,4,3,2,17,"1/5/2025, 5:53:00 p.m."
2025-05-01,6:30 PM,6,4,8,0,0,18,"1/5/2025, 6:56:47 p.m."
2025-05-01,7:30 PM,4,2,2,2,0,10,"1/5/2025, 8:54:48 p.m."
2025-05-01,8:30 PM,3,1,2,2,0,8,"1/5/2025, 8:55:06 p.m."
2025-05-02,7:30 AM,2,0,0,0,0,2,"2/5/2025, 7:59:11 a.m."
2025-05-02,8:30 AM,1,2,1,1,0,5,"2/5/2025, 8:34:55 a.m."
2025-05-02,9:30 AM,1,3,8,2,0,14,"2/5/2025, 9:57:33 a.m."
2025-05-02,10:30 AM,1,5,6,1,1,14,"2/5/2025, 10:44:19 a.m."
2025-05-02,11:30 AM,2,5,8,2,0,17,"2/5/2025, 11:39:02 a.m."
2025-05-02,12:30 PM,2,6,7,1,0,16,"2/5/2025, 12:33:57 p.m."
2025-05-02,1:30 PM,2,3,5,0,0,10,"2/5/2025, 1:36:22 p.m."
2025-05-02,2:30 PM,5,5,2,0,1,13,"2/5/2025, 2:36:52 p.m."
2025-05-02,3:30 PM,4,4,3,0,1,12,"2/5/2025, 3:52:49 p.m."
2025-05-02,4:30 PM,5,1,7,1,0,14,"2/5/2025, 4:42:56 p.m."
2025-05-02,5:30 PM,1,1,3,2,0,7,"2/5/2025, 5:42:33 p.m."
2025-05-02,6:30 PM,0,1,3,0,0,4,"2/5/2025, 6:39:47 p.m."
2025-05-03,10:30 AM,1,1,1,0,0,3,"3/5/2025, 10:36:28 a.m."
2025-05-03,11:30 AM,3,3,4,0,0,10,"3/5/2025, 11:45:29 a.m."
2025-05-03,12:30 PM,3,1,4,1,0,9,"3/5/2025, 12:35:08 p.m."
2025-05-03,2:30 PM,1,2,2,0,0,5,"3/5/2025, 2:38:26 p.m."
2025-05-03,3:30 PM,3,2,2,0,0,7,"3/5/2025, 4:10:05 p.m."
2025-05-03,4:30 PM,2,2,2,0,0,6,"3/5/2025, 4:41:22 p.m."
2025-05-05,7:30 AM,2,2,0,0,0,4,"5/5/2025, 8:06:51 a.m."
2025-05-05,8:30 AM,2,2,2,0,0,6,"5/5/2025, 8:31:01 a.m."
2025-05-05,9:30 AM,8,3,9,0,0,20,"5/5/2025, 9:53:21 a.m."
2025-05-05,10:30 AM,10,7,14,3,0,34,"5/5/2025, 10:35:13 a.m."
2025-05-05,11:30 AM,12,9,14,3,0,38,"5/5/2025, 11:38:16 a.m."
2025-05-05,12:30 PM,10,7,8,2,0,27,"5/5/2025, 12:34:56 p.m."
2025-05-05,1:30 PM,14,4,3,4,0,25,"5/5/2025, 1:34:08 p.m."
2025-05-05,2:30 PM,4,4,6,3,0,17,"5/5/2025, 3:46:23 p.m."
2025-05-05,3:30 PM,6,5,8,1,2,22,"5/5/2025, 3:46:49 p.m."
2025-05-05,4:30 PM,8,6,9,1,0,24,"5/5/2025, 4:41:02 p.m."
2025-05-05,5:30 PM,5,3,6,2,0,16,"5/5/2025, 6:05:23 p.m."
2025-05-05,6:30 PM,3,2,5,3,0,13,"5/5/2025, 7:03:25 p.m."
2025-05-05,7:30 PM,2,3,3,1,1,10,"5/5/2025, 7:32:17 p.m."
2025-05-05,8:30 PM,1,1,2,1,0,5,"5/5/2025, 8:43:16 p.m."
2025-05-06,7:30 AM,1,0,0,0,0,1,"6/5/2025, 7:40:28 a.m."
2025-05-06,8:30 AM,4,1,5,1,0,11,"6/5/2025, 9:02:59 a.m."
2025-05-06,9:30 AM,4,2,6,1,0,13,"6/5/2025, 9:34:50 a.m."
2025-05-06,10:30 AM,12,3,3,0,0,18,"6/5/2025, 10:30:52 a.m."
2025-05-06,11:30 AM,10,6,5,13,0,34,"6/5/2025, 11:54:14 a.m."
2025-05-06,12:30 PM,7,5,7,4,8,31,"6/5/2025, 12:32:17 p.m."
2025-05-06,1:30 PM,7,9,12,7,1,36,"6/5/2025, 1:36:53 p.m."
2025-05-06,2:30 PM,4,7,14,4,0,29,"6/5/2025, 2:31:24 p.m."
2025-05-06,3:30 PM,3,7,13,4,3,30,"6/5/2025, 3:34:41 p.m."
2025-05-06,4:30 PM,5,5,10,4,0,24,"6/5/2025, 4:27:04 p.m."
2025-05-06,5:30 PM,2,7,9,5,3,26,"6/5/2025, 5:48:14 p.m."
2025-05-06,6:30 PM,4,7,6,3,1,21,"6/5/2025, 7:00:57 p.m."
2025-05-06,7:30 PM,3,3,6,3,0,15,"6/5/2025, 7:44:28 p.m."
2025-05-06,8:30 PM,7,0,3,1,0,11,"6/5/2025, 8:32:15 p.m."
2025-05-07,7:30 AM,0,1,2,0,0,3,"7/5/2025, 8:04:21 a.m."
2025-05-07,8:30 AM,1,3,6,0,1,11,"7/5/2025, 8:20:56 a.m."
2025-05-07,9:30 AM,3,1,5,0,0,9,"7/5/2025, 9:31:40 a.m."
2025-05-07,10:30 AM,12,6,10,1,2,31,"7/5/2025, 10:39:02 a.m."
2025-05-07,11:30 AM,6,7,9,1,1,24,"7/5/2025, 11:37:45 a.m."
2025-05-07,12:30 PM,9,5,12,4,1,31,"7/5/2025, 12:39:39 p.m."
2025-05-07,1:30 PM,4,5,8,8,1,26,"7/5/2025, 1:34:27 p.m."
2025-05-07,2:30 PM,9,4,8,6,1,28,"7/5/2025, 2:36:28 p.m."
2025-05-07,3:30 PM,8,4,8,1,0,21,"7/5/2025, 3:33:47 p.m."
2025-05-07,5:30 PM,13,2,7,3,0,25,"7/5/2025, 5:08:44 p.m."
2025-05-07,5:30 PM,13,3,6,4,0,26,"7/5/2025, 5:52:58 p.m."
2025-05-07,6:30 PM,6,2,7,4,0,19,"7/5/2025, 6:45:57 p.m."
2025-05-07,8:30 PM,4,1,3,2,0,10,"7/5/2025, 8:04:46 p.m."
2025-05-07,8:30 PM,6,1,5,1,0,13,"7/5/2025, 8:31:33 p.m."
2025-05-08,7:30 AM,1,1,3,0,0,5,"8/5/2025, 8:18:57 a.m."
2025-05-08,8:30 AM,5,3,4,0,0,12,"8/5/2025, 9:14:02 a.m."
2025-05-08,9:30 AM,4,6,13,1,3,27,"8/5/2025, 9:39:25 a.m."
2025-05-08,10:30 AM,9,8,10,7,3,37,"8/5/2025, 10:38:36 a.m."
2025-05-08,11:30 AM,8,3,11,5,0,27,"8/5/2025, 11:41:26 a.m."
2025-05-08,12:30 PM,14,5,12,5,0,36,"8/5/2025, 12:40:18 p.m."
2025-05-08,1:30 PM,8,6,10,1,0,25,"8/5/2025, 1:48:55 p.m."
2025-05-08,2:30 PM,7,8,4,2,0,21,"8/5/2025, 2:38:19 p.m."
2025-05-08,3:30 PM,5,5,7,4,4,25,"8/5/2025, 3:36:54 p.m."
2025-05-08,4:30 PM,7,3,7,5,0,22,"8/5/2025, 4:34:06 p.m."
2025-05-08,5:30 PM,8,1,6,1,0,16,"8/5/2025, 5:35:40 p.m."
2025-05-08,6:30 PM,3,1,5,2,1,12,"8/5/2025, 7:15:31 p.m."
2025-05-08,7:30 PM,6,2,3,1,1,13,"8/5/2025, 7:33:39 p.m."
2025-05-08,8:30 PM,3,1,4,1,0,9,"8/5/2025, 8:42:40 p.m."
2025-05-08,12:30 PM,6,4,6,2,0,18,"9/5/2025, 12:56:26 p.m."
2025-05-09,7:30 AM,1,0,0,0,0,1,"9/5/2025, 7:38:05 a.m."
2025-05-09,8:30 AM,1,1,0,0,0,2,"9/5/2025, 8:51:37 a.m."
2025-05-09,9:30 AM,2,2,2,0,0,6,"9/5/2025, 11:52:56 a.m."
2025-05-09,10:30 AM,3,2,2,1,0,8,"9/5/2025, 11:53:31 a.m."
2025-05-09,11:30 AM,7,3,5,2,0,17,"9/5/2025, 11:54:08 a.m."
2025-05-09,1:30 PM,5,3,8,2,0,18,"9/5/2025, 1:38:04 p.m."
2025-05-09,2:30 PM,5,2,7,2,4,20,"9/5/2025, 2:38:19 p.m."
2025-05-09,3:30 PM,5,4,5,0,0,14,"9/5/2025, 3:33:23 p.m."
2025-05-09,4:30 PM,1,3,1,0,0,5,"9/5/2025, 5:34:40 p.m."
2025-05-09,5:30 PM,4,4,4,0,0,12,"9/5/2025, 5:36:47 p.m."
2025-05-09,6:30 PM,2,2,1,2,0,7,"9/5/2025, 6:43:48 p.m."
2025-05-10,10:30 AM,1,1,0,0,0,2,"10/5/2025, 10:32:42 a.m."
2025-05-10,11:30 AM,0,1,2,0,0,3,"10/5/2025, 11:42:50 a.m."
2025-05-10,12:30 PM,0,2,2,0,0,4,"10/5/2025, 1:12:47 p.m."
2025-05-10,1:30 PM,1,2,1,0,0,4,"10/5/2025, 1:29:02 p.m."
2025-05-10,2:30 PM,2,2,0,1,0,5,"10/5/2025, 2:37:36 p.m."
2025-05-10,3:30 PM,3,1,0,0,1,5,"10/5/2025, 3:34:55 p.m."
2025-05-10,4:30 PM,2,2,0,0,1,5,"10/5/2025, 4:36:54 p.m."
2025-05-10,5:30 PM,0,1,0,0,0,1,"10/5/2025, 5:30:51 p.m."
2025-05-12,7:30 AM,1,0,0,0,0,1,"12/5/2025, 8:03:54 a.m."
2025-05-12,8:30 AM,1,1,0,0,0,2,"12/5/2025, 8:33:39 a.m."
2025-05-12,9:30 AM,2,1,0,0,0,3,"12/5/2025, 9:42:02 a.m."
2025-05-12,10:30 AM,3,2,2,0,0,7,"12/5/2025, 10:52:56 a.m."
2025-05-12,11:30 AM,4,2,2,0,0,8,"12/5/2025, 11:38:55 a.m."
2025-05-12,1:30 PM,1,3,0,1,0,5,"12/5/2025, 1:25:33 p.m."
2025-05-12,2:30 PM,1,4,0,1,1,7,"12/5/2025, 2:30:13 p.m."
2025-05-12,3:30 PM,0,2,1,0,0,3,"12/5/2025, 4:05:34 p.m."
2025-05-12,4:30 PM,1,1,1,0,0,3,"12/5/2025, 5:00:33 p.m."
2025-05-12,5:30 PM,2,0,1,0,0,3,"12/5/2025, 5:49:44 p.m."
2025-05-13,7:30 AM,1,0,0,0,0,1,"13/5/2025, 7:56:23 a.m."
2025-05-13,8:30 AM,0,0,0,0,0,0,"13/5/2025, 8:31:34 a.m."
2025-05-13,9:30 AM,0,1,0,0,0,1,"13/5/2025, 9:45:59 a.m."
2025-05-13,11:30 AM,2,1,0,2,0,5,"13/5/2025, 11:32:39 a.m."
2025-05-13,12:30 PM,1,2,0,2,0,5,"13/5/2025, 12:47:58 p.m."
2025-05-13,2:30 PM,0,0,1,0,0,1,"13/5/2025, 3:04:45 p.m."
2025-05-13,3:30 PM,2,2,2,1,0,7,"13/5/2025, 3:31:49 p.m."
2025-05-13,4:30 PM,0,3,0,0,0,3,"13/5/2025, 4:46:51 p.m."
2025-05-13,5:30 PM,1,2,0,0,0,3,"13/5/2025, 5:58:52 p.m."
2025-05-14,7:30 AM,0,1,0,0,0,1,"14/5/2025, 8:31:19 a.m."
2025-05-14,8:30 AM,1,2,0,0,0,3,"14/5/2025, 8:32:56 a.m."
2025-05-14,7:30 AM,1,1,0,0,0,2,"14/5/2025, 9:04:02 a.m."
2025-05-14,9:30 AM,2,2,0,0,0,4,"14/5/2025, 9:35:56 a.m."
2025-05-14,10:30 AM,3,3,2,0,0,8,"14/5/2025, 10:51:45 a.m."
2025-05-14,11:30 AM,2,2,2,0,0,6,"14/5/2025, 11:30:17 a.m."
2025-05-14,12:30 PM,3,5,2,0,0,10,"14/5/2025, 12:34:38 p.m."
2025-05-14,1:30 PM,5,5,2,0,0,12,"14/5/2025, 1:43:22 p.m."
2025-05-14,2:30 PM,1,3,0,0,0,4,"14/5/2025, 2:39:03 p.m."
2025-05-14,3:30 PM,0,2,0,0,0,2,"14/5/2025, 3:35:50 p.m."
2025-05-14,4:30 PM,1,3,0,0,1,5,"14/5/2025, 4:35:00 p.m."
2025-05-14,5:30 PM,0,0,0,1,0,1,"14/5/2025, 5:52:29 p.m."
2025-05-15,7:30 AM,0,0,0,0,1,1,"15/5/2025, 7:45:27 a.m."
2025-05-15,8:30 AM,0,1,1,0,0,2,"15/5/2025, 8:33:36 a.m."
2025-05-15,9:30 AM,1,2,1,0,0,4,"15/5/2025, 9:33:26 a.m."
2025-05-15,10:30 AM,1,2,1,0,0,4,"15/5/2025, 10:47:38 a.m."
2025-05-15,11:30 AM,2,2,2,0,0,6,"15/5/2025, 11:36:54 a.m."
2025-05-15,2:30 PM,1,2,0,0,0,3,"15/5/2025, 3:03:26 p.m."
2025-05-15,3:30 PM,1,3,0,0,0,4,"15/5/2025, 3:42:00 p.m."
2025-05-15,4:30 PM,1,3,1,0,0,5,"15/5/2025, 4:54:12 p.m."
2025-05-15,5:30 PM,2,3,1,0,0,6,"15/5/2025, 5:59:46 p.m."
2025-05-16,7:30 AM,1,1,2,0,0,4,"16/5/2025, 7:48:28 a.m."
2025-05-16,8:30 AM,1,1,1,0,0,3,"16/5/2025, 9:10:00 a.m."
2025-05-16,9:30 AM,2,1,1,0,0,4,"16/5/2025, 9:27:02 a.m."
2025-05-16,11:30 AM,2,2,1,0,0,5,"16/5/2025, 11:42:17 a.m."
2025-05-16,12:30 PM,2,1,0,0,0,3,"16/5/2025, 12:59:31 p.m."
2025-05-16,1:30 PM,0,1,0,0,0,1,"16/5/2025, 1:39:55 p.m."
2025-05-16,2:30 PM,1,0,0,0,0,1,"16/5/2025, 3:08:07 p.m."
2025-05-16,3:30 PM,1,1,0,0,0,2,"16/5/2025, 4:17:28 p.m."
2025-05-16,4:30 PM,1,1,0,0,0,2,"16/5/2025, 5:02:06 p.m."
2025-05-16,5:30 PM,0,1,0,0,0,1,"16/5/2025, 5:45:34 p.m."
2025-05-19,7:30 AM,0,1,0,0,0,1,"19/5/2025, 7:59:07 a.m."
2025-05-19,8:30 AM,0,1,0,0,0,1,"19/5/2025, 9:15:20 a.m."
2025-05-19,9:30 AM,1,2,0,0,0,3,"19/5/2025, 9:40:51 a.m."
2025-05-19,10:30 AM,1,3,0,0,0,4,"19/5/2025, 10:34:48 a.m."
2025-05-19,11:30 AM,1,4,0,1,0,6,"19/5/2025, 11:35:29 a.m."
2025-05-19,12:30 PM,2,2,0,0,0,4,"19/5/2025, 12:38:55 p.m."
2025-05-19,2:30 PM,1,1,0,0,2,4,"19/5/2025, 2:49:00 p.m."
2025-05-19,3:30 PM,0,1,0,1,0,2,"19/5/2025, 4:08:29 p.m."
2025-05-19,4:30 PM,1,1,0,0,0,2,"19/5/2025, 4:48:26 p.m."
2025-05-19,5:30 PM,0,1,0,0,0,1,"19/5/2025, 5:53:31 p.m."
2025-05-20,7:30 AM,1,0,0,0,0,1,"20/5/2025, 8:05:23 a.m."
2025-05-20,8:30 AM,0,1,0,0,0,1,"20/5/2025, 8:41:23 a.m."
2025-05-20,9:30 AM,3,1,0,0,0,4,"20/5/2025, 9:29:54 a.m."
2025-05-20,10:30 AM,2,1,0,0,0,3,"20/5/2025, 10:29:57 a.m."
2025-05-20,11:30 AM,3,1,1,0,0,5,"20/5/2025, 11:48:10 a.m."
2025-05-20,12:30 PM,2,1,3,0,0,6,"20/5/2025, 12:38:22 p.m."
2025-05-20,1:30 PM,2,1,2,0,0,5,"20/5/2025, 1:34:30 p.m."
2025-05-20,2:30 PM,1,2,2,0,0,5,"20/5/2025, 4:41:45 p.m."
2025-05-20,4:30 PM,1,2,0,0,0,3,"20/5/2025, 4:42:05 p.m."
2025-05-20,3:30 PM,0,2,2,0,0,4,"20/5/2025, 4:42:32 p.m."
2025-05-20,5:30 PM,1,1,0,2,0,4,"20/5/2025, 5:56:38 p.m."
2025-05-21,7:30 AM,2,0,0,0,0,2,"21/5/2025, 7:34:41 a.m."
2025-05-21,8:30 AM,1,1,1,0,0,3,"21/5/2025, 9:12:22 a.m."
2025-05-21,9:30 AM,2,1,1,0,0,4,"21/5/2025, 9:20:23 a.m."
2025-05-21,10:30 AM,2,3,3,0,0,8,"21/5/2025, 10:35:37 a.m."
2025-05-21,11:30 AM,2,4,1,0,0,7,"21/5/2025, 11:44:32 a.m."
2025-05-21,12:30 PM,2,2,1,0,0,5,"21/5/2025, 12:52:46 p.m."
2025-05-21,1:30 PM,2,2,2,0,0,6,"21/5/2025, 1:31:54 p.m."
2025-05-21,2:30 PM,1,1,0,0,0,2,"21/5/2025, 2:33:35 p.m."
2025-05-21,3:30 PM,2,1,1,0,0,4,"21/5/2025, 3:37:48 p.m."
2025-05-21,4:30 PM,0,1,2,0,0,3,"21/5/2025, 4:53:21 p.m."
2025-05-21,5:30 PM,2,0,2,0,0,4,"21/5/2025, 5:50:09 p.m."
2025-05-22,7:30 AM,0,1,0,0,0,1,"22/5/2025, 8:24:16 a.m."
2025-05-22,8:30 AM,0,2,0,0,0,2,"22/5/2025, 8:51:22 a.m."
2025-05-22,9:30 AM,0,2,0,0,0,2,"22/5/2025, 9:44:04 a.m."
2025-05-22,10:30 AM,1,2,0,0,0,3,"22/5/2025, 10:34:45 a.m."
2025-05-22,11:30 AM,0,2,1,0,0,3,"22/5/2025, 11:40:23 a.m."
2025-05-22,12:30 PM,1,1,3,0,0,5,"22/5/2025, 12:45:51 p.m."
2025-05-22,1:30 PM,0,1,2,0,0,3,"22/5/2025, 1:33:13 p.m."
2025-05-22,2:30 PM,1,2,2,0,0,5,"22/5/2025, 2:48:38 p.m."
2025-05-22,3:30 PM,0,2,3,0,0,5,"22/5/2025, 3:36:01 p.m."
2025-05-22,4:30 PM,0,2,2,0,0,4,"22/5/2025, 4:33:04 p.m."
2025-05-22,5:30 PM,1,1,0,0,0,2,"22/5/2025, 5:37:15 p.m."
2025-05-23,7:30 AM,1,1,0,0,0,2,"23/5/2025, 8:02:22 a.m."
2025-05-23,8:30 AM,2,1,0,0,0,3,"23/5/2025, 10:33:11 a.m."
2025-05-23,9:30 AM,2,1,1,0,0,4,"23/5/2025, 10:33:44 a.m."
2025-05-23,10:30 AM,3,1,1,0,0,5,"23/5/2025, 10:34:36 a.m."
2025-05-23,11:30 AM,2,1,1,0,0,4,"23/5/2025, 12:00:53 p.m."
2025-05-23,12:30 PM,2,1,2,0,0,5,"23/5/2025, 12:52:18 p.m."
2025-05-23,1:30 PM,4,2,0,0,0,6,"23/5/2025, 1:54:22 p.m."
2025-05-23,2:30 PM,0,0,0,0,0,0,"23/5/2025, 2:46:05 p.m."
2025-05-23,3:30 PM,0,0,1,0,0,1,"23/5/2025, 3:56:17 p.m."
2025-05-23,4:30 PM,0,0,1,0,0,1,"23/5/2025, 4:29:47 p.m."
2025-05-23,5:30 PM,1,1,1,0,0,3,"23/5/2025, 5:28:19 p.m."
2025-05-27,7:30 AM,1,1,0,0,0,2,"27/5/2025, 8:08:34 a.m."
2025-05-27,8:30 AM,0,1,0,0,0,1,"27/5/2025, 8:43:28 a.m."
2025-05-27,9:30 AM,0,1,0,0,0,1,"27/5/2025, 9:27:37 a.m."
2025-05-27,11:30 AM,2,2,1,0,0,5,"27/5/2025, 11:36:47 a.m."
2025-05-27,1:30 PM,3,1,1,0,0,5,"27/5/2025, 1:53:39 p.m."
2025-05-27,2:30 PM,1,1,2,0,0,4,"27/5/2025, 2:31:47 p.m."
2025-05-27,3:30 PM,0,1,1,0,1,3,"27/5/2025, 3:30:56 p.m."
2025-05-27,4:30 PM,0,1,1,0,0,2,"27/5/2025, 4:51:16 p.m."
2025-05-27,5:30 PM,1,2,0,0,1,4,"27/5/2025, 5:29:09 p.m."
2025-05-28,8:30 AM,2,1,0,0,0,3,"28/5/2025, 8:23:30 a.m."
2025-05-28,7:30 AM,1,1,0,0,0,2,"28/5/2025, 8:23:53 a.m."
2025-05-28,9:30 AM,1,1,1,0,0,3,"28/5/2025, 9:39:56 a.m."
2025-05-28,11:30 AM,3,1,1,0,0,5,"28/5/2025, 11:58:30 a.m."
2025-05-28,1:30 PM,3,1,1,2,0,7,"28/5/2025, 1:58:29 p.m."
2025-05-28,2:30 PM,3,0,0,1,2,6,"28/5/2025, 2:49:39 p.m."
2025-05-28,3:30 PM,2,0,1,0,0,3,"28/5/2025, 3:57:55 p.m."
2025-05-28,4:30 PM,1,0,2,0,0,3,"28/5/2025, 4:31:38 p.m."
2025-05-28,5:30 PM,0,0,1,0,0,1,"28/5/2025, 5:41:17 p.m."
2025-05-29,7:30 AM,0,1,0,1,0,2,"29/5/2025, 7:53:18 a.m."
2025-05-29,8:30 AM,0,1,1,1,0,3,"29/5/2025, 9:58:42 a.m."
2025-05-29,9:30 AM,2,1,0,1,0,4,"29/5/2025, 9:59:08 a.m."
2025-05-29,10:30 AM,2,2,1,0,0,5,"29/5/2025, 11:07:52 a.m."
2025-05-29,11:30 AM,1,1,0,1,0,3,"29/5/2025, 12:00:11 p.m."
2025-05-29,12:30 PM,0,1,1,1,0,3,"29/5/2025, 12:35:56 p.m."
2025-05-29,1:30 PM,0,2,1,1,0,4,"29/5/2025, 1:47:10 p.m."
2025-05-29,2:30 PM,0,2,0,1,0,3,"29/5/2025, 2:48:19 p.m."
2025-05-29,3:30 PM,1,1,0,1,0,3,"29/5/2025, 4:05:22 p.m."
2025-05-29,4:30 PM,2,1,0,0,0,3,"29/5/2025, 4:38:40 p.m."
2025-05-29,5:30 PM,2,0,1,0,0,3,"29/5/2025, 5:32:38 p.m."
2025-05-30,11:30 AM,4,2,1,0,0,7,"30/5/2025, 11:56:56 a.m."
2025-05-30,12:30 PM,3,1,3,0,0,7,"30/5/2025, 12:39:16 p.m."
2025-05-30,2:30 PM,2,1,1,0,0,4,"30/5/2025, 2:35:08 p.m."
2025-05-30,3:30 PM,3,1,2,0,0,6,"30/5/2025, 4:52:45 p.m."
2025-05-30,4:30 PM,0,1,1,0,0,2,"30/5/2025, 4:55:41 p.m."
2025-05-30,5:30 PM,1,0,2,0,0,3,"30/5/2025, 5:56:09 p.m."
2025-06-02,7:30 AM,3,0,0,0,0,3,"2/6/2025, 8:25:51 a.m."
2025-06-02,8:30 AM,5,2,1,1,0,9,"2/6/2025, 8:41:31 a.m."
2025-06-02,9:30 AM,4,0,2,0,0,6,"2/6/2025, 9:31:48 a.m."
2025-06-02,10:30 AM,6,3,3,0,0,12,"2/6/2025, 10:38:47 a.m."
2025-06-02,11:30 AM,12,5,6,0,0,23,"2/6/2025, 11:59:48 a.m."
2025-06-02,12:30 PM,10,4,6,0,0,20,"2/6/2025, 12:46:59 p.m."
2025-06-02,1:30 PM,4,5,6,0,0,15,"2/6/2025, 1:46:03 p.m."
2025-06-02,2:30 PM,4,4,3,0,1,12,"2/6/2025, 3:00:57 p.m."
2025-06-02,3:30 PM,3,0,2,0,2,7,"2/6/2025, 3:52:41 p.m."
2025-06-02,4:30 PM,2,2,1,0,0,5,"2/6/2025, 5:01:56 p.m."
2025-06-02,5:30 PM,2,1,2,0,2,7,"2/6/2025, 5:33:02 p.m."
2025-06-02,6:30 PM,0,1,3,0,0,4,"2/6/2025, 6:38:52 p.m."
2025-06-02,7:30 PM,0,1,0,1,0,2,"2/6/2025, 7:43:31 p.m."
2025-06-03,7:30 AM,1,1,1,0,0,3,"3/6/2025, 7:59:03 a.m."
2025-06-03,8:30 AM,2,1,1,0,0,4,"3/6/2025, 8:27:36 a.m."
2025-06-03,9:30 AM,5,3,4,1,0,13,"3/6/2025, 10:30:26 a.m."
2025-06-03,10:30 AM,0,3,5,0,0,8,"3/6/2025, 10:39:18 a.m."
2025-06-03,11:30 AM,4,4,10,3,0,21,"3/6/2025, 11:39:54 a.m."
2025-06-03,12:30 PM,5,4,8,2,0,19,"3/6/2025, 12:41:31 p.m."
2025-06-03,1:30 PM,5,7,10,2,1,25,"3/6/2025, 1:38:48 p.m."
2025-06-03,2:30 PM,5,4,7,2,0,18,"3/6/2025, 2:34:09 p.m."
2025-06-03,3:30 PM,4,2,4,1,1,12,"3/6/2025, 4:04:39 p.m."
2025-06-03,4:30 PM,5,1,3,1,1,11,"3/6/2025, 4:41:42 p.m."
2025-06-03,5:30 PM,5,1,1,1,0,8,"3/6/2025, 5:45:58 p.m."
2025-06-03,6:30 PM,3,2,2,1,0,8,"3/6/2025, 6:33:04 p.m."
2025-06-03,7:30 PM,1,1,1,0,0,3,"3/6/2025, 8:52:12 p.m."
2025-06-03,8:30 PM,2,0,0,0,1,3,"3/6/2025, 8:52:35 p.m."
2025-06-04,8:30 AM,4,1,1,0,0,6,"4/6/2025, 8:30:11 a.m."
2025-06-04,7:30 AM,1,1,0,0,0,2,"4/6/2025, 8:30:40 a.m."
2025-06-04,9:30 AM,3,1,0,0,0,4,"4/6/2025, 9:34:06 a.m."
2025-06-04,10:30 AM,5,3,2,0,0,10,"4/6/2025, 10:35:41 a.m."
2025-06-04,11:30 AM,3,4,7,1,0,15,"4/6/2025, 11:58:45 a.m."
2025-06-04,11:30 PM,4,2,3,1,0,10,"4/6/2025, 12:01:59 p.m."
2025-06-04,12:30 PM,6,3,5,1,0,15,"4/6/2025, 12:28:56 p.m."
2025-06-04,1:30 PM,2,1,4,2,1,10,"4/6/2025, 1:54:14 p.m."
2025-06-04,2:30 PM,2,2,2,3,1,10,"4/6/2025, 3:28:25 p.m."
2025-06-04,3:30 PM,3,1,2,3,3,12,"4/6/2025, 3:28:43 p.m."
2025-06-04,4:30 PM,3,2,4,2,0,11,"4/6/2025, 4:50:52 p.m."
2025-06-04,5:30 PM,3,2,0,2,0,7,"4/6/2025, 5:35:18 p.m."
2025-06-04,6:30 PM,0,2,1,2,0,5,"4/6/2025, 6:34:15 p.m."
2025-06-04,7:30 PM,3,1,1,2,0,7,"4/6/2025, 8:23:32 p.m."
2025-06-04,8:30 PM,2,0,0,0,2,4,"4/6/2025, 8:58:20 p.m."
2025-06-05,7:30 AM,2,0,0,0,0,2,"5/6/2025, 7:52:10 a.m."
2025-06-05,8:30 AM,1,1,0,0,0,2,"5/6/2025, 8:22:44 a.m."
2025-06-05,9:30 AM,1,1,0,0,0,2,"5/6/2025, 9:57:09 a.m."
2025-06-05,10:30 AM,2,1,2,0,0,5,"5/6/2025, 10:38:53 a.m."
2025-06-05,11:30 AM,4,2,3,0,0,9,"5/6/2025, 11:35:19 a.m."
2025-06-05,12:30 PM,3,2,4,0,0,9,"5/6/2025, 12:31:00 p.m."
2025-06-05,1:30 PM,5,2,5,0,1,13,"5/6/2025, 1:35:30 p.m."
2025-06-05,2:30 PM,5,2,5,1,2,15,"5/6/2025, 2:42:17 p.m."
2025-06-05,3:30 PM,3,1,7,0,0,11,"5/6/2025, 3:44:30 p.m."
2025-06-05,4:30 PM,2,1,2,0,1,6,"5/6/2025, 4:39:11 p.m."
2025-06-05,5:30 PM,3,0,0,0,0,3,"5/6/2025, 5:31:57 p.m."
2025-06-05,6:30 PM,1,0,2,0,0,3,"5/6/2025, 6:34:21 p.m."
2025-06-05,7:30 PM,2,1,0,0,0,3,"5/6/2025, 8:57:17 p.m."
2025-06-05,8:30 PM,2,0,0,0,0,2,"5/6/2025, 8:57:34 p.m."
2025-06-06,7:30 AM,1,0,0,0,0,1,"6/6/2025, 7:44:08 a.m."
2025-06-06,9:30 AM,2,1,1,0,0,4,"6/6/2025, 9:26:52 a.m."
2025-06-06,10:30 AM,4,2,1,0,0,7,"6/6/2025, 10:47:17 a.m."
2025-06-06,11:30 AM,5,2,2,0,0,9,"6/6/2025, 11:36:17 a.m."
2025-06-06,12:30 PM,4,2,2,0,0,8,"6/6/2025, 1:03:21 p.m."
2025-06-06,1:30 PM,6,2,2,0,1,11,"6/6/2025, 1:30:21 p.m."
2025-06-06,2:30 PM,1,1,0,0,1,3,"6/6/2025, 3:01:46 p.m."
2025-06-06,3:30 PM,3,0,2,0,1,6,"6/6/2025, 3:41:43 p.m."
2025-06-06,4:30 PM,1,1,4,0,0,6,"6/6/2025, 4:35:20 p.m."
2025-06-09,7:30 AM,1,0,0,0,0,1,"9/6/2025, 7:39:54 a.m."
2025-06-09,8:30 AM,3,1,1,1,0,6,"9/6/2025, 8:32:07 a.m."
2025-06-09,9:30 AM,3,1,1,0,1,6,"9/6/2025, 9:37:21 a.m."
2025-06-09,10:30 AM,6,3,3,1,0,13,"9/6/2025, 10:43:47 a.m."
2025-06-09,11:30 AM,3,3,5,1,0,12,"9/6/2025, 11:39:34 a.m."
2025-06-09,12:30 PM,8,2,4,1,1,16,"9/6/2025, 12:39:30 p.m."
2025-06-09,1:30 PM,4,1,4,2,0,11,"9/6/2025, 1:34:36 p.m."
2025-06-09,2:30 PM,7,3,6,2,0,18,"9/6/2025, 2:41:49 p.m."
2025-06-09,3:30 PM,2,2,2,2,1,9,"9/6/2025, 3:32:40 p.m."
2025-06-09,4:30 PM,2,2,3,2,0,9,"9/6/2025, 4:34:53 p.m."
2025-06-09,5:30 PM,2,1,3,2,0,8,"9/6/2025, 6:03:16 p.m."
2025-06-09,6:30 PM,1,1,3,1,1,7,"9/6/2025, 6:41:17 p.m."
2025-06-09,7:30 PM,1,2,1,1,0,5,"9/6/2025, 7:36:03 p.m."
2025-06-09,8:30 PM,3,0,0,2,0,5,"9/6/2025, 8:57:00 p.m."
2025-06-10,7:30 AM,1,1,0,0,0,2,"10/6/2025, 8:32:20 a.m."
2025-06-10,8:30 AM,3,1,3,0,0,7,"10/6/2025, 8:32:50 a.m."
2025-06-10,9:30 AM,5,3,6,1,0,15,"10/6/2025, 9:51:29 a.m."
2025-06-10,10:30 AM,2,2,3,3,0,10,"10/6/2025, 10:31:51 a.m."
2025-06-10,11:30 AM,1,1,5,1,0,8,"10/6/2025, 11:47:52 a.m."
2025-06-10,12:30 PM,4,1,6,1,0,12,"10/6/2025, 12:36:28 p.m."
2025-06-10,1:30 PM,3,1,6,0,0,10,"10/6/2025, 1:39:48 p.m."
2025-06-10,2:30 PM,4,1,5,0,1,11,"10/6/2025, 2:30:35 p.m."
2025-06-10,3:30 PM,2,1,3,1,0,7,"10/6/2025, 4:27:40 p.m."
2025-06-10,4:30 PM,2,1,2,2,0,7,"10/6/2025, 4:30:32 p.m."
2025-06-10,5:30 PM,4,2,5,2,0,13,"10/6/2025, 5:33:23 p.m."
2025-06-10,6:30 PM,1,2,1,2,0,6,"10/6/2025, 6:31:50 p.m."
2025-06-10,7:30 PM,2,2,2,3,0,9,"10/6/2025, 7:49:16 p.m."
2025-06-11,7:30 AM,1,1,0,0,0,2,"11/6/2025, 7:46:25 a.m."
2025-06-11,8:30 AM,2,1,2,1,0,6,"11/6/2025, 8:48:44 a.m."
2025-06-11,9:30 AM,2,2,3,0,0,7,"11/6/2025, 9:27:51 a.m."
2025-06-11,9:30 AM,2,1,2,0,0,5,"11/6/2025, 9:32:11 a.m."
2025-06-11,10:30 AM,3,3,2,1,0,9,"11/6/2025, 10:34:13 a.m."
2025-06-11,11:30 AM,4,5,4,1,0,14,"11/6/2025, 11:35:24 a.m."
2025-06-11,12:30 PM,2,3,4,1,1,11,"11/6/2025, 12:58:30 p.m."
2025-06-11,1:30 PM,3,3,4,2,1,13,"11/6/2025, 1:39:24 p.m."
2025-06-11,2:30 PM,1,2,4,0,0,7,"11/6/2025, 2:31:23 p.m."
2025-06-11,3:30 PM,6,1,5,4,0,16,"11/6/2025, 3:33:33 p.m."
2025-06-11,4:30 PM,4,1,5,1,0,11,"11/6/2025, 4:33:26 p.m."
2025-06-11,5:30 PM,4,2,3,1,0,10,"11/6/2025, 5:33:05 p.m."
2025-06-11,6:30 PM,0,1,0,0,1,2,"11/6/2025, 6:34:10 p.m."
2025-06-11,7:30 PM,1,1,0,2,0,4,"11/6/2025, 7:42:45 p.m."
2025-06-11,8:30 PM,1,0,0,2,0,3,"11/6/2025, 8:52:10 p.m."
2025-06-12,7:30 AM,1,0,0,0,0,1,"12/6/2025, 7:33:12 a.m."
2025-06-12,8:30 AM,1,1,0,0,0,2,"12/6/2025, 8:29:50 a.m."
2025-06-12,9:30 AM,3,2,4,1,0,10,"12/6/2025, 10:05:37 a.m."
2025-06-12,10:30 AM,1,3,1,1,0,6,"12/6/2025, 10:39:21 a.m."
2025-06-12,11:30 AM,5,2,5,1,0,13,"12/6/2025, 12:03:54 p.m."
2025-06-12,12:30 PM,4,4,6,0,0,14,"12/6/2025, 12:51:01 p.m."
2025-06-12,1:30 PM,5,4,4,0,0,13,"12/6/2025, 1:45:21 p.m."
2025-06-12,2:30 PM,3,3,2,0,0,8,"12/6/2025, 2:33:31 p.m."
2025-06-12,3:30 PM,3,1,3,0,1,8,"12/6/2025, 3:35:31 p.m."
2025-06-12,4:30 PM,3,1,2,1,0,7,"12/6/2025, 4:55:38 p.m."
2025-06-12,5:30 PM,3,1,0,0,0,4,"12/6/2025, 5:33:32 p.m."
2025-06-12,6:30 PM,0,2,0,0,0,2,"12/6/2025, 6:44:02 p.m."
2025-06-12,7:30 PM,2,1,2,0,0,5,"12/6/2025, 7:52:37 p.m."
2025-06-13,7:30 AM,1,0,0,0,0,1,"13/6/2025, 7:43:10 a.m."
2025-06-13,8:30 AM,2,1,0,1,0,4,"13/6/2025, 8:59:40 a.m."
2025-06-13,9:30 AM,2,2,1,1,0,6,"13/6/2025, 9:34:20 a.m."
2025-06-13,10:30 AM,2,4,3,0,0,9,"13/6/2025, 10:53:57 a.m."
2025-06-13,11:30 AM,3,4,3,1,0,11,"13/6/2025, 11:48:34 a.m."
2025-06-13,12:30 PM,2,5,4,0,0,11,"13/6/2025, 1:12:59 p.m."
2025-06-13,1:30 PM,5,3,2,0,0,10,"13/6/2025, 1:50:32 p.m."
2025-06-13,2:30 PM,4,1,3,1,0,9,"13/6/2025, 2:46:20 p.m."
2025-06-13,3:30 PM,7,2,2,0,0,11,"13/6/2025, 3:54:43 p.m."
2025-06-13,4:30 PM,5,1,2,0,0,8,"13/6/2025, 4:39:50 p.m."
2025-06-16,7:30 AM,1,0,0,0,0,1,"16/6/2025, 7:39:37 a.m."
2025-06-16,8:30 AM,2,1,0,0,0,3,"16/6/2025, 8:30:36 a.m."
2025-06-16,9:30 AM,4,1,1,0,0,6,"16/6/2025, 9:22:17 a.m."
2025-06-16,10:30 AM,4,2,4,0,0,10,"16/6/2025, 10:39:43 a.m."
2025-06-16,11:30 AM,6,3,2,2,0,13,"16/6/2025, 11:47:54 a.m."
2025-06-16,12:30 PM,4,3,2,3,0,12,"16/6/2025, 1:08:32 p.m."
2025-06-16,1:30 PM,3,2,2,3,0,10,"16/6/2025, 1:27:50 p.m."
2025-06-16,2:30 PM,2,1,2,2,2,9,"16/6/2025, 2:36:14 p.m."
2025-06-16,3:30 PM,2,2,5,4,0,13,"16/6/2025, 3:28:39 p.m."
2025-06-16,4:30 PM,5,2,3,1,0,11,"16/6/2025, 4:55:45 p.m."
2025-06-16,5:30 PM,3,0,4,0,1,8,"16/6/2025, 6:30:48 p.m."
2025-06-16,6:30 PM,5,0,2,1,1,9,"16/6/2025, 7:06:48 p.m."
2025-06-16,7:30 PM,4,2,1,1,0,8,"16/6/2025, 8:19:55 p.m."
2025-06-16,8:30 PM,1,1,2,0,0,4,"16/6/2025, 8:21:59 p.m."
2025-06-17,7:30 AM,1,1,1,0,0,3,"17/6/2025, 7:41:08 a.m."
2025-06-17,8:30 AM,2,1,3,0,0,6,"17/6/2025, 8:28:52 a.m."
2025-06-17,9:30 AM,2,1,4,0,0,7,"17/6/2025, 9:28:32 a.m."
2025-06-17,10:30 AM,2,3,3,1,0,9,"17/6/2025, 11:11:11 a.m."
2025-06-17,11:30 PM,4,4,2,1,0,11,"17/6/2025, 12:27:35 p.m."
2025-06-17,12:30 PM,3,4,2,1,0,10,"17/6/2025, 12:28:11 p.m."
2025-06-17,1:30 PM,4,3,3,1,1,12,"17/6/2025, 1:43:30 p.m."
2025-06-17,2:30 PM,4,4,3,1,0,12,"17/6/2025, 2:39:50 p.m."
2025-06-17,3:30 PM,3,3,2,1,0,9,"17/6/2025, 3:42:36 p.m."
2025-06-17,4:30 PM,3,2,4,1,1,11,"17/6/2025, 4:29:32 p.m."
2025-06-17,5:30 PM,6,2,3,1,0,12,"17/6/2025, 5:51:44 p.m."
2025-06-17,6:30 PM,5,2,4,1,0,12,"17/6/2025, 6:31:33 p.m."
2025-06-17,7:30 PM,4,1,2,1,0,8,"17/6/2025, 7:33:09 p.m."
2025-06-18,7:30 AM,1,0,0,0,0,1,"18/6/2025, 8:33:30 a.m."
2025-06-18,8:30 AM,2,1,1,0,0,4,"18/6/2025, 8:34:20 a.m."
2025-06-18,9:30 AM,2,1,0,0,2,5,"18/6/2025, 9:20:00 a.m."
2025-06-18,10:30 AM,3,3,0,3,0,9,"18/6/2025, 10:38:33 a.m."
2025-06-18,11:30 AM,5,4,2,3,1,15,"18/6/2025, 11:41:10 a.m."
2025-06-18,12:30 PM,5,3,1,4,0,13,"18/6/2025, 12:44:39 p.m."
2025-06-18,1:30 PM,5,4,4,4,0,17,"18/6/2025, 1:32:49 p.m."
2025-06-18,2:30 PM,2,2,5,1,1,11,"18/6/2025, 2:46:23 p.m."
2025-06-18,3:30 PM,3,3,4,1,1,12,"18/6/2025, 3:39:53 p.m."
2025-06-18,4:30 PM,3,3,2,1,0,9,"18/6/2025, 4:36:03 p.m."
2025-06-18,5:30 PM,2,4,2,2,0,10,"18/6/2025, 5:32:09 p.m."
2025-06-18,6:30 PM,0,2,0,0,0,2,"18/6/2025, 6:35:26 p.m."
2025-06-18,7:30 PM,2,2,0,0,2,6,"18/6/2025, 7:38:05 p.m."
2025-06-18,8:30 PM,2,0,0,0,0,2,"18/6/2025, 8:48:45 p.m."
2025-06-20,7:30 AM,1,0,1,0,0,2,"20/6/2025, 7:34:07 a.m."
2025-06-20,8:30 AM,2,1,0,0,0,3,"20/6/2025, 8:36:32 a.m."
2025-06-20,9:30 AM,2,1,2,0,0,5,"20/6/2025, 9:32:08 a.m."
2025-06-20,10:30 AM,4,5,3,0,0,12,"20/6/2025, 10:47:42 a.m."
2025-06-20,11:30 AM,2,6,2,0,0,10,"20/6/2025, 11:45:30 a.m."
2025-06-20,12:30 PM,3,6,1,0,0,10,"20/6/2025, 12:44:16 p.m."
2025-06-20,1:30 PM,1,4,2,0,1,8,"20/6/2025, 1:39:23 p.m."
2025-06-20,2:30 PM,5,1,2,0,2,10,"20/6/2025, 2:46:39 p.m."
2025-06-20,3:30 PM,2,0,1,0,1,4,"20/6/2025, 3:56:19 p.m."
2025-06-20,4:30 PM,2,0,1,0,0,3,"20/6/2025, 4:49:46 p.m."
2025-06-23,7:30 AM,1,0,0,0,0,1,"23/6/2025, 7:56:49 a.m."
2025-06-23,8:30 AM,3,1,1,0,0,5,"23/6/2025, 8:47:04 a.m."
2025-06-23,9:30 AM,3,1,0,0,0,4,"23/6/2025, 9:21:30 a.m."
2025-06-23,10:30 AM,4,1,0,0,0,5,"23/6/2025, 10:31:36 a.m."
2025-06-23,11:30 AM,4,2,3,0,0,9,"23/6/2025, 11:49:19 a.m."
2025-06-23,12:30 PM,5,3,3,0,0,11,"23/6/2025, 1:48:42 p.m."
2025-06-23,1:30 PM,7,3,3,0,0,13,"23/6/2025, 1:49:12 p.m."
2025-06-23,2:30 PM,4,4,3,1,1,13,"23/6/2025, 2:37:19 p.m."
2025-06-23,3:30 PM,0,4,3,4,0,11,"23/6/2025, 3:39:53 p.m."
2025-06-23,4:30 PM,1,3,5,10,0,19,"23/6/2025, 4:36:45 p.m."
2025-06-23,5:30 PM,2,3,7,1,2,15,"23/6/2025, 5:51:53 p.m."
2025-06-23,5:30 PM,3,5,5,3,1,17,"23/6/2025, 5:53:16 p.m."
2025-06-23,6:30 PM,2,2,2,1,2,9,"23/6/2025, 6:35:04 p.m."
2025-06-23,7:30 PM,1,2,3,0,0,6,"23/6/2025, 7:41:03 p.m."
2025-06-24,7:30 AM,0,0,1,0,0,1,"24/6/2025, 7:46:10 a.m."
2025-06-24,8:30 AM,1,0,1,1,0,3,"24/6/2025, 8:26:31 a.m."
2025-06-24,9:30 AM,0,1,2,0,1,4,"24/6/2025, 9:37:37 a.m."
2025-06-24,10:30 AM,1,4,2,0,0,7,"24/6/2025, 10:36:58 a.m."
2025-06-24,11:30 AM,1,3,3,0,0,7,"24/6/2025, 11:35:57 a.m."
2025-06-24,12:30 PM,3,5,3,1,0,12,"24/6/2025, 12:45:44 p.m."
2025-06-24,1:30 PM,4,3,4,0,0,11,"24/6/2025, 1:34:31 p.m."
2025-06-24,2:30 PM,4,2,3,0,3,12,"24/6/2025, 2:34:59 p.m."
2025-06-24,3:30 PM,2,3,2,0,0,7,"24/6/2025, 3:35:59 p.m."
2025-06-24,4:30 PM,3,2,2,1,0,8,"24/6/2025, 5:02:33 p.m."
2025-06-24,5:30 PM,1,1,0,0,0,2,"24/6/2025, 5:45:07 p.m."
2025-06-24,6:30 PM,3,1,1,0,0,5,"24/6/2025, 6:31:29 p.m."
2025-06-24,7:30 PM,1,2,0,0,0,3,"24/6/2025, 7:38:55 p.m."
2025-06-24,8:30 PM,1,1,0,0,0,2,"24/6/2025, 8:31:53 p.m."
2025-06-25,7:30 AM,1,1,1,0,0,3,"25/6/2025, 7:47:02 a.m."
2025-06-25,8:30 AM,2,1,2,1,0,6,"25/6/2025, 8:29:49 a.m."
2025-06-25,9:30 AM,4,2,2,0,0,8,"25/6/2025, 9:37:28 a.m."
2025-06-25,10:30 AM,4,2,3,0,0,9,"25/6/2025, 10:41:28 a.m."
2025-06-25,11:30 AM,5,3,3,1,0,12,"25/6/2025, 11:33:30 a.m."
2025-06-25,12:30 PM,7,4,4,2,0,17,"25/6/2025, 12:32:05 p.m."
2025-06-25,1:30 PM,3,5,5,2,0,15,"25/6/2025, 1:37:36 p.m."
2025-06-25,2:30 PM,1,2,7,3,0,13,"25/6/2025, 2:40:50 p.m."
2025-06-25,3:30 PM,2,2,3,4,0,11,"25/6/2025, 3:34:15 p.m."
2025-06-25,4:30 PM,4,4,0,0,0,8,"25/6/2025, 4:43:25 p.m."
2025-06-25,5:30 PM,2,2,2,0,0,6,"25/6/2025, 5:30:47 p.m."
2025-06-25,6:30 PM,5,1,1,0,0,7,"25/6/2025, 6:38:37 p.m."
2025-06-25,7:30 PM,4,1,1,1,0,7,"25/6/2025, 7:30:06 p.m."
2025-06-25,8:30 PM,1,1,0,0,0,2,"25/6/2025, 8:50:38 p.m."
2025-06-26,7:30 AM,3,1,1,0,0,5,"26/6/2025, 8:03:02 a.m."
2025-06-26,8:30 AM,4,1,2,0,0,7,"26/6/2025, 8:47:03 a.m."
2025-06-26,9:30 AM,4,1,1,0,0,6,"26/6/2025, 9:36:50 a.m."
2025-06-26,10:30 AM,3,3,2,0,1,9,"26/6/2025, 10:42:49 a.m."
2025-06-26,11:30 AM,7,3,1,1,2,14,"26/6/2025, 11:37:15 a.m."
2025-06-26,12:30 PM,4,4,3,1,0,12,"26/6/2025, 12:53:45 p.m."
2025-06-26,1:30 PM,6,4,1,3,0,14,"26/6/2025, 1:44:58 p.m."
2025-06-26,2:30 PM,4,3,1,0,0,8,"26/6/2025, 2:46:45 p.m."
2025-06-26,3:30 PM,4,4,2,1,0,11,"26/6/2025, 3:29:00 p.m."
2025-06-26,4:30 PM,3,1,1,2,1,8,"26/6/2025, 6:17:04 p.m."
2025-06-26,5:30 PM,1,1,0,2,1,5,"26/6/2025, 6:18:12 p.m."
2025-06-26,6:30 PM,1,1,0,2,0,4,"26/6/2025, 6:31:16 p.m."
2025-06-26,7:30 PM,0,1,0,0,0,1,"26/6/2025, 7:37:21 p.m."
2025-06-26,8:30 PM,0,1,0,0,0,1,"26/6/2025, 8:47:10 p.m."
2025-06-27,7:30 AM,1,0,1,0,0,2,"27/6/2025, 7:47:29 a.m."
2025-06-27,8:30 AM,3,1,0,0,0,4,"27/6/2025, 8:28:13 a.m."
2025-06-27,9:30 AM,5,1,3,0,0,9,"27/6/2025, 9:49:35 a.m."
2025-06-27,10:30 AM,4,4,2,0,0,10,"27/6/2025, 10:36:20 a.m."
2025-06-27,11:30 AM,3,3,2,0,0,8,"27/6/2025, 12:03:25 p.m."
2025-06-27,12:30 PM,5,3,3,0,0,11,"27/6/2025, 12:53:42 p.m."
2025-06-27,1:30 PM,4,2,4,0,1,11,"27/6/2025, 1:36:02 p.m."
2025-06-27,2:30 PM,4,2,3,0,1,10,"27/6/2025, 2:58:52 p.m."
2025-06-30,7:30 AM,2,1,1,0,0,4,"30/6/2025, 8:10:42 a.m."
2025-06-30,8:30 AM,2,1,2,1,0,6,"30/6/2025, 8:37:22 a.m."
2025-06-30,9:30 AM,5,1,1,0,1,8,"30/6/2025, 9:34:56 a.m."
2025-06-30,10:30 AM,6,1,2,0,0,9,"30/6/2025, 10:38:38 a.m."
2025-06-30,11:30 AM,7,1,2,0,0,10,"30/6/2025, 11:26:45 a.m."
2025-06-30,12:30 PM,7,1,5,2,0,15,"30/6/2025, 12:31:24 p.m."
2025-06-30,1:30 PM,6,2,3,5,0,16,"30/6/2025, 1:44:30 p.m."
2025-06-30,2:30 PM,4,3,5,3,1,16,"30/6/2025, 2:39:09 p.m."
2025-06-30,3:30 PM,5,1,6,4,0,16,"30/6/2025, 3:32:31 p.m."
2025-06-30,4:30 PM,2,2,4,4,0,12,"30/6/2025, 4:33:41 p.m."
2025-06-30,5:30 PM,2,4,2,2,0,10,"30/6/2025, 5:40:20 p.m."
2025-06-30,6:30 PM,2,0,3,1,0,6,"30/6/2025, 6:34:16 p.m."
2025-06-30,7:30 PM,4,1,0,0,1,6,"30/6/2025, 7:36:41 p.m."
2025-06-30,8:30 PM,1,1,0,0,0,2,"30/6/2025, 8:58:22 p.m."
2025-07-01,7:30 AM,0,0,0,0,0,0,"1/7/2025, 7:50:37 a.m."
2025-07-01,8:30 AM,0,1,0,0,0,1,"1/7/2025, 8:48:16 a.m."
2025-07-01,9:30 AM,1,1,2,0,0,4,"1/7/2025, 9:34:13 a.m."
2025-07-01,10:30 AM,1,2,3,0,0,6,"1/7/2025, 10:43:20 a.m."
2025-07-01,11:30 AM,4,2,3,0,0,9,"1/7/2025, 11:41:04 a.m."
2025-07-01,12:30 PM,7,5,5,0,0,17,"1/7/2025, 12:33:02 p.m."
2025-07-01,1:30 PM,7,4,3,0,0,14,"1/7/2025, 1:35:36 p.m."
2025-07-01,2:30 PM,3,3,2,0,1,9,"1/7/2025, 2:51:27 p.m."
2025-07-01,3:30 PM,7,3,2,0,0,12,"1/7/2025, 3:38:09 p.m."
2025-07-01,4:30 PM,2,3,2,0,0,7,"1/7/2025, 5:43:10 p.m."
2025-07-01,5:30 PM,5,4,5,1,0,15,"1/7/2025, 5:43:35 p.m."
2025-07-01,6:30 PM,4,4,3,0,1,12,"1/7/2025, 6:36:12 p.m."
2025-07-01,7:30 PM,3,1,2,1,1,8,"1/7/2025, 7:40:42 p.m."
2025-07-01,8:30 PM,1,1,0,1,0,3,"1/7/2025, 8:45:28 p.m."
2025-07-02,7:30 AM,1,0,1,0,0,2,"2/7/2025, 7:39:07 a.m."
2025-07-02,8:30 AM,2,1,1,1,0,5,"2/7/2025, 8:34:49 a.m."