Date,DayOfWeek,Time,Computers,Tables,StudySpaces,QuietArea,Alcove,Total,timestamp
2019-08-19,Monday,8:30 AM,4,0,0,2,3,9,8/19/2019
2019-08-19,Monday,9:30 AM,13,8,1,6,2,30,8/19/2019
2019-08-19,Monday,10:30 AM,30,12,1,12,10,65,8/19/2019
2019-08-19,Monday,11:30 AM,10,6,7,6,3,32,8/19/2019
2019-08-19,Monday,12:30 PM,26,16,1,8,3,54,8/19/2019
2019-08-19,Monday,1:30 PM,9,6,0,6,2,23,8/19/2019
2019-08-19,Monday,2:30 PM,25,10,6,8,0,49,8/19/2019
2019-08-19,Monday,3:30 PM,24,4,3,4,2,37,8/19/2019
2019-08-19,Monday,4:30 PM,21,3,3,8,3,38,8/19/2019
2019-08-19,Monday,5:30 PM,13,5,4,3,4,29,8/19/2019
2019-08-19,Monday,6:30 PM,13,1,4,6,2,26,8/19/2019
2019-08-20,Tuesday,1:30 PM,17,6,9,8,2,42,8/20/2019
2019-08-20,Tuesday,2:30 PM,18,7,3,6,7,41,8/20/2019
2019-08-20,Tuesday,3:30 PM,25,6,4,7,6,48,8/20/2019
2019-08-20,Tuesday,4:30 PM,13,4,4,9,5,35,8/20/2019
2019-08-20,Tuesday,5:30 PM,19,1,3,3,6,32,8/20/2019
2019-08-20,Tuesday,6:30 PM,6,1,2,1,3,13,8/20/2019
2019-08-20,Tuesday,7:30 PM,12,2,0,0,1,15,8/20/2019
2019-08-20,Tuesday,8:30 PM,8,2,0,1,0,11,8/20/2019
2019-08-21,Wednesday,8:30 AM,18,6,4,6,3,37,8/21/2019
2019-08-21,Wednesday,9:30 AM,13,5,5,7,3,33,8/21/2019
2019-08-21,Wednesday,10:30 AM,27,6,7,8,3,51,8/21/2019
2019-08-21,Wednesday,1:30 PM,22,7,2,10,4,45,8/21/2019
2019-08-21,Wednesday,2:30 PM,30,3,6,5,1,45,8/21/2019
2019-08-21,Wednesday,3:30 PM,21,9,13,10,2,55,8/21/2019
2019-08-21,Wednesday,3:30 PM,22,4,8,9,4,47,8/21/2019
2019-08-21,Wednesday,5:30 PM,13,3,1,6,5,28,8/21/2019
2019-08-21,Wednesday,6:30 PM,6,0,2,1,2,11,8/21/2019
2019-08-21,Wednesday,7:30 PM,7,2,2,2,3,16,8/21/2019
2019-08-21,Wednesday,8:30 PM,10,2,3,2,1,18,8/21/2019
2019-08-22,Thursday,8:30 AM,15,3,0,5,5,28,8/22/2019
2019-08-22,Thursday,9:30 AM,30,2,2,8,8,50,8/22/2019
2019-08-22,Thursday,10:30 AM,14,9,5,11,8,47,8/22/2019
2019-08-22,Thursday,12:30 PM,33,16,4,14,9,76,8/22/2019
2019-08-22,Thursday,1:30 PM,9,4,1,8,2,24,8/22/2019
2019-08-22,Thursday,2:30 PM,17,6,5,6,2,36,8/22/2019
2019-08-22,Thursday,3:30 PM,26,8,9,5,5,53,8/22/2019
2019-08-22,Thursday,4:30 PM,12,8,3,7,3,33,8/22/2019
2019-08-22,Thursday,5:30 PM,14,3,0,6,5,28,8/22/2019
2019-08-22,Thursday,6:30 PM,6,2,1,4,0,13,8/22/2019
2019-08-22,Thursday,7:30 PM,14,3,2,4,0,23,8/22/2019
2019-08-22,Thursday,8:30 PM,5,0,1,3,0,9,8/22/2019
2019-08-23,Friday,8:30 AM,1,1,0,1,1,4,8/23/2019
2019-08-23,Friday,9:30 AM,6,1,0,2,0,9,8/23/2019
2019-08-23,Friday,10:30 AM,8,0,0,2,3,13,8/23/2019
2019-08-23,Friday,11:30 AM,11,1,2,2,1,17,8/23/2019
2019-08-23,Friday,12:30 PM,16,3,4,3,2,28,8/23/2019
2019-08-23,Friday,1:30 PM,19,3,2,2,0,26,8/23/2019
2019-08-23,Friday,2:30 PM,11,2,2,2,1,18,8/23/2019
2019-08-23,Friday,3:30 PM,7,2,3,0,1,13,8/23/2019
2019-08-23,Friday,4:30 PM,10,1,0,2,0,13,8/23/2019
2019-08-24,Saturday,10:30 AM,3,0,0,3,0,6,8/24/2019
2019-08-24,Saturday,11:30 AM,9,1,0,4,0,14,8/24/2019
2019-08-24,Saturday,12:30 PM,11,0,23,3,1,38,8/24/2019
2019-08-24,Saturday,1:30 PM,4,0,23,0,0,27,8/24/2019
2019-08-26,Monday,10:30 AM,38,10,0,11,4,63,8/26/2019
2019-08-26,Monday,11:30 AM,13,8,13,17,8,59,8/26/2019
2019-08-26,Monday,1:30 PM,20,4,3,7,5,39,8/26/2019
2019-08-26,Monday,2:30 PM,35,5,4,8,3,55,8/26/2019
2019-08-26,Monday,3:30 PM,20,4,11,7,4,46,8/26/2019
2019-08-26,Monday,4:30 PM,11,7,3,9,6,36,8/26/2019
2019-08-26,Monday,5:30 PM,12,8,4,4,2,30,8/26/2019
2019-08-26,Monday,6:30 PM,10,1,11,2,1,25,8/26/2019
2019-08-26,Monday,7:30 PM,6,1,7,2,2,18,8/26/2019
2019-08-26,Monday,8:30 PM,7,0,0,1,1,9,8/26/2019
2019-08-27,Tuesday,9:30 AM,22,2,2,5,1,32,8/27/2019
2019-08-27,Tuesday,10:30 AM,18,5,10,9,5,47,8/27/2019
2019-08-27,Tuesday,11:30 AM,18,11,15,16,4,64,8/27/2019
2019-08-27,Tuesday,1:30 PM,23,6,4,12,6,51,8/27/2019
2019-08-27,Tuesday,2:30 PM,29,6,10,10,3,58,8/27/2019
2019-08-27,Tuesday,3:30 PM,22,5,17,6,2,52,8/27/2019
2019-08-27,Tuesday,3:30 PM,19,8,3,5,3,38,8/27/2019
2019-08-27,Tuesday,5:30 PM,13,6,2,9,3,33,8/27/2019
2019-08-27,Tuesday,6:30 PM,5,1,0,2,0,8,8/27/2019
2019-08-28,Wednesday,8:30 AM,17,6,1,6,1,31,8/28/2019
2019-08-28,Wednesday,9:30 AM,15,5,0,8,0,28,8/28/2019
2019-08-28,Wednesday,10:30 AM,15,11,6,11,9,52,8/28/2019
2019-08-28,Wednesday,12:30 PM,30,19,11,22,11,93,8/28/2019
2019-08-28,Wednesday,1:30 PM,15,5,9,7,7,43,8/28/2019
2019-08-28,Wednesday,2:30 PM,13,6,7,7,1,34,8/28/2019
2019-08-28,Wednesday,3:30 PM,17,3,3,6,3,32,8/28/2019
2019-08-28,Wednesday,4:30 PM,19,5,3,8,4,39,8/28/2019
2019-08-28,Wednesday,5:30 PM,19,4,0,9,4,36,8/28/2019
2019-08-28,Wednesday,6:30 PM,5,1,0,2,0,8,8/28/2019
2019-08-28,Wednesday,7:30 PM,9,1,0,1,1,12,8/28/2019
2019-08-28,Wednesday,8:30 PM,7,2,1,2,2,14,8/28/2019
2019-08-29,Thursday,8:30 AM,10,4,3,7,2,26,8/29/2019
2019-08-29,Thursday,9:30 AM,14,7,6,9,5,41,8/29/2019
2019-08-29,Thursday,10:30 AM,21,4,5,9,3,42,8/29/2019
2019-08-29,Thursday,12:30 PM,25,9,4,20,10,68,8/29/2019
2019-08-29,Thursday,12:30 PM,13,9,12,9,3,46,8/29/2019
2019-08-29,Thursday,3:30 PM,22,6,13,7,2,50,8/29/2019
2019-08-29,Thursday,4:30 PM,17,7,6,5,4,39,8/29/2019
2019-08-29,Thursday,5:30 PM,13,9,3,3,6,34,8/29/2019
2019-08-29,Thursday,6:30 PM,1,0,2,1,1,5,8/29/2019
2019-08-29,Thursday,7:30 PM,5,2,1,0,2,10,8/29/2019
2019-08-29,Thursday,8:30 PM,5,1,1,1,0,8,8/29/2019
2019-08-30,Friday,8:30 AM,10,0,5,5,1,21,8/30/2019
2019-08-30,Friday,9:30 AM,8,1,1,4,0,14,8/30/2019
2019-08-30,Friday,10:30 AM,6,1,6,6,0,19,8/30/2019
2019-08-30,Friday,11:30 AM,17,1,17,3,3,41,8/30/2019
2019-08-30,Friday,12:30 PM,12,4,3,3,1,23,8/30/2019
2019-08-30,Friday,1:30 PM,10,3,3,3,2,21,8/30/2019
2019-08-30,Friday,2:30 PM,9,3,1,2,2,17,8/30/2019
2019-08-30,Friday,4:30 PM,5,1,7,1,0,14,8/30/2019
2019-08-31,Saturday,10:30 AM,6,0,0,1,0,7,8/31/2019
2019-08-31,Saturday,11:30 AM,6,3,1,1,0,11,8/31/2019
2019-08-31,Saturday,12:30 PM,5,0,1,1,0,7,8/31/2019
2019-08-31,Saturday,1:30 PM,1,0,0,0,0,1,8/31/2019
2019-09-04,Wednesday,8:30 AM,12,5,1,10,5,33,9/4/2019
2019-09-04,Wednesday,9:30 AM,16,11,1,6,6,40,9/4/2019
2019-09-04,Wednesday,10:30 AM,16,6,1,13,7,43,9/4/2019
2019-09-04,Wednesday,12:30 PM,30,8,10,15,4,67,9/4/2019
2019-09-04,Wednesday,1:30 PM,15,5,11,11,6,48,9/4/2019
2019-09-04,Wednesday,2:30 PM,21,5,13,11,2,52,9/4/2019
2019-09-04,Wednesday,4:30 PM,22,5,2,11,3,43,9/4/2019
2019-09-04,Wednesday,5:30 PM,19,7,1,7,6,40,9/4/2019
2019-09-04,Wednesday,7:30 PM,6,2,0,2,0,10,9/4/2019
2019-09-04,Wednesday,7:30 PM,5,1,0,1,3,10,9/4/2019
2019-09-04,Wednesday,8:30 PM,8,1,0,2,1,12,9/4/2019
2019-09-05,Thursday,8:30 AM,20,2,6,9,2,39,9/5/2019
2019-09-05,Thursday,9:30 AM,23,6,20,20,6,75,9/5/2019
2019-09-05,Thursday,10:30 AM,17,11,7,13,8,56,9/5/2019
2019-09-05,Thursday,11:30 AM,20,12,23,16,6,77,9/5/2019
2019-09-05,Thursday,1:30 PM,17,7,22,10,6,62,9/5/2019
2019-09-05,Thursday,2:30 PM,32,10,6,3,7,58,9/5/2019
2019-09-05,Thursday,3:30 PM,18,6,8,8,1,41,9/5/2019
2019-09-05,Thursday,4:30 PM,21,9,5,10,4,49,9/5/2019
2019-09-05,Thursday,5:30 PM,18,6,4,6,5,39,9/5/2019
2019-09-05,Thursday,6:30 PM,3,1,5,1,0,10,9/5/2019
2019-09-05,Thursday,7:30 PM,2,2,2,2,0,8,9/5/2019
2019-09-05,Thursday,8:30 PM,3,1,2,1,0,7,9/5/2019
2019-09-06,Friday,8:30 AM,4,0,1,4,0,9,9/6/2019
2019-09-06,Friday,9:30 AM,10,1,1,6,1,19,9/6/2019
2019-09-06,Friday,10:30 AM,8,2,3,6,1,20,9/6/2019
2019-09-06,Friday,12:30 PM,10,2,5,1,0,18,9/6/2019
2019-09-06,Friday,1:30 PM,7,2,6,2,1,18,9/6/2019
2019-09-06,Friday,2:30 PM,7,0,6,4,0,17,9/6/2019
2019-09-06,Friday,3:30 PM,6,0,2,3,4,15,9/6/2019
2019-09-07,Saturday,10:30 AM,4,0,0,0,1,5,9/7/2019
2019-09-07,Saturday,11:30 AM,5,0,1,0,1,7,9/7/2019
2019-09-07,Saturday,12:30 PM,7,0,3,0,0,10,9/7/2019
2019-09-07,Saturday,1:30 PM,5,0,0,1,0,6,9/7/2019
2019-09-09,Monday,8:30 AM,7,1,2,8,3,21,9/9/2019
2019-09-09,Monday,9:30 AM,22,6,4,4,12,48,9/9/2019
2019-09-09,Monday,10:30 AM,28,8,4,12,6,58,9/9/2019
2019-09-09,Monday,12:30 PM,32,20,10,15,11,88,9/9/2019
2019-09-09,Monday,2:30 PM,32,13,10,9,3,67,9/9/2019
2019-09-09,Monday,1:30 PM,32,13,10,9,3,67,9/9/2019
2019-09-09,Monday,3:30 PM,19,7,7,8,2,43,9/9/2019
2019-09-09,Monday,4:30 PM,18,1,4,10,2,35,9/9/2019
2019-09-09,Monday,5:30 PM,12,2,1,8,5,28,9/9/2019
2019-09-09,Monday,6:30 PM,3,3,4,3,0,13,9/9/2019
2019-09-09,Monday,7:30 PM,5,3,0,2,0,10,9/9/2019
2019-09-09,Monday,8:30 PM,3,3,2,1,0,9,9/9/2019
2019-09-10,Tuesday,8:30 AM,10,2,3,8,3,26,9/10/2019
2019-09-10,Tuesday,9:30 AM,21,10,8,6,6,51,9/10/2019
2019-09-10,Tuesday,10:30 AM,24,4,5,12,8,53,9/10/2019
2019-09-10,Tuesday,12:30 PM,23,13,26,15,9,86,9/10/2019
2019-09-10,Tuesday,1:30 PM,12,5,8,13,2,40,9/10/2019
2019-09-10,Tuesday,2:30 PM,28,8,9,21,2,68,9/10/2019
2019-09-10,Tuesday,3:30 PM,30,3,24,9,4,70,9/10/2019
2019-09-10,Tuesday,4:30 PM,10,10,7,10,2,39,9/10/2019
2019-09-10,Tuesday,5:30 PM,16,6,1,7,4,34,9/10/2019
2019-09-10,Tuesday,6:30 PM,1,1,1,4,0,7,9/10/2019
2019-09-10,Tuesday,7:30 PM,3,0,5,3,2,13,9/10/2019
2019-09-10,Tuesday,8:30 PM,3,0,0,0,2,5,9/10/2019
2019-09-11,Wednesday,8:30 AM,12,12,4,8,5,41,9/11/2019
2019-09-11,Wednesday,9:30 AM,18,12,6,10,5,51,9/11/2019
2019-09-11,Wednesday,10:30 AM,22,10,8,12,5,57,9/11/2019
2019-09-11,Wednesday,12:30 PM,38,18,39,15,11,121,9/11/2019
2019-09-11,Wednesday,1:30 PM,11,12,11,7,3,44,9/11/2019
2019-09-11,Wednesday,3:30 PM,27,9,9,3,7,55,9/11/2019
2019-09-11,Wednesday,4:30 PM,19,4,4,8,4,39,9/11/2019
2019-09-11,Wednesday,5:30 PM,20,7,3,8,5,43,9/11/2019
2019-09-11,Wednesday,6:30 PM,8,3,0,5,2,18,9/11/2019
2019-09-11,Wednesday,7:30 PM,4,1,1,4,4,14,9/11/2019
2019-09-11,Wednesday,8:30 PM,4,3,0,1,4,12,9/11/2019
2019-09-12,Thursday,8:30 AM,13,6,8,5,4,36,9/12/2019
2019-09-12,Thursday,9:30 AM,10,8,12,8,5,43,9/12/2019
2019-09-12,Thursday,10:30 AM,15,10,10,12,6,53,9/12/2019
2019-09-12,Thursday,12:30 PM,30,12,31,16,5,94,9/12/2019
2019-09-12,Thursday,2:30 PM,20,2,6,5,4,37,9/12/2019
2019-09-12,Thursday,5:30 PM,17,6,3,5,5,36,9/12/2019
2019-09-12,Thursday,6:30 PM,6,0,1,2,1,10,9/12/2019
2019-09-12,Thursday,7:30 PM,5,0,2,2,0,9,9/12/2019
2019-09-12,Thursday,8:30 PM,4,1,1,2,0,8,9/12/2019
2019-09-13,Friday,9:30 AM,1,2,2,1,0,6,9/13/2019
2019-09-13,Friday,10:30 AM,12,2,2,4,2,22,9/13/2019
2019-09-13,Friday,11:30 AM,12,3,3,4,3,25,9/13/2019
2019-09-13,Friday,1:30 PM,7,2,4,4,1,18,9/13/2019
2019-09-13,Friday,2:30 PM,8,0,1,4,1,14,9/13/2019
2019-09-13,Friday,3:30 PM,5,1,1,3,1,11,9/13/2019
2019-09-14,Saturday,10:30 AM,3,1,2,2,1,9,9/14/2019
2019-09-14,Saturday,11:30 AM,6,0,2,2,0,10,9/14/2019
2019-09-14,Saturday,12:30 PM,10,0,2,2,3,17,9/14/2019
2019-09-14,Saturday,1:30 PM,8,0,1,0,1,10,9/14/2019
2019-09-16,Monday,8:30 AM,12,4,5,7,4,32,9/16/2019
2019-09-16,Monday,9:30 AM,17,9,5,11,9,51,9/16/2019
2019-09-16,Monday,10:30 AM,30,9,6,12,12,69,9/16/2019
2019-09-16,Monday,11:30 AM,20,11,6,11,4,52,9/16/2019
2019-09-16,Monday,12:30 PM,35,18,12,16,6,87,9/16/2019
2019-09-16,Monday,1:30 PM,11,5,7,9,3,35,9/16/2019
2019-09-16,Monday,2:30 PM,21,5,5,11,3,45,9/16/2019
2019-09-16,Monday,3:30 PM,14,6,11,11,3,45,9/16/2019
2019-09-16,Monday,4:30 PM,15,4,12,8,4,43,9/16/2019
2019-09-16,Monday,5:30 PM,22,4,2,6,4,38,9/16/2019
2019-09-16,Monday,6:30 PM,5,3,6,3,1,18,9/16/2019
2019-09-16,Monday,7:30 PM,4,1,5,4,0,14,9/16/2019
2019-09-16,Monday,8:30 PM,0,1,0,0,0,1,9/16/2019
2019-09-17,Tuesday,9:30 AM,21,4,6,11,3,45,9/17/2019
2019-09-17,Tuesday,9:30 AM,19,6,3,11,7,46,9/17/2019
2019-09-17,Tuesday,10:30 AM,24,6,6,12,6,54,9/17/2019
2019-09-17,Tuesday,11:30 AM,22,10,4,9,9,54,9/17/2019
2019-09-17,Tuesday,2:30 PM,12,6,22,8,6,54,9/17/2019
2019-09-17,Tuesday,3:30 PM,11,7,29,9,1,57,9/17/2019
2019-09-17,Tuesday,4:30 PM,16,4,7,9,4,40,9/17/2019
2019-09-17,Tuesday,5:30 PM,16,6,3,7,5,37,9/17/2019
2019-09-17,Tuesday,6:30 PM,4,0,6,4,1,15,9/17/2019
2019-09-17,Tuesday,7:30 PM,6,1,4,5,0,16,9/17/2019
2019-09-17,Tuesday,8:30 PM,8,0,1,3,0,12,9/17/2019
2019-09-18,Wednesday,8:30 AM,21,9,7,8,3,48,9/18/2019
2019-09-18,Wednesday,9:30 AM,17,10,7,8,3,45,9/18/2019
2019-09-18,Wednesday,10:30 AM,30,10,7,10,8,65,9/18/2019
2019-09-18,Wednesday,12:30 PM,33,17,10,11,19,90,9/18/2019
2019-09-18,Wednesday,1:30 PM,17,6,7,9,3,42,9/18/2019
2019-09-18,Wednesday,2:30 PM,17,0,5,11,2,35,9/18/2019
2019-09-18,Wednesday,4:30 PM,19,5,6,6,3,39,9/18/2019
2019-09-18,Wednesday,5:30 PM,25,11,2,10,3,51,9/18/2019
2019-09-18,Wednesday,6:30 PM,6,3,2,3,0,14,9/18/2019
2019-09-18,Wednesday,7:30 PM,10,3,1,6,1,21,9/18/2019
2019-09-18,Wednesday,8:30 PM,8,0,1,3,0,12,9/18/2019
2019-09-19,Thursday,8:30 AM,11,6,0,9,7,33,9/19/2019
2019-09-19,Thursday,9:30 AM,15,4,3,9,9,40,9/19/2019
2019-09-19,Thursday,10:30 AM,23,6,7,12,9,57,9/19/2019
2019-09-19,Thursday,11:30 AM,22,10,6,12,4,54,9/19/2019
2019-09-19,Thursday,12:30 PM,33,21,14,19,3,90,9/19/2019
2019-09-19,Thursday,1:30 PM,16,8,5,10,5,44,9/19/2019
2019-09-19,Thursday,1:30 PM,22,4,10,7,1,44,9/19/2019
2019-09-19,Thursday,2:30 PM,19,7,15,9,1,51,9/19/2019
2019-09-19,Thursday,4:30 PM,11,9,3,7,3,33,9/19/2019
2019-09-19,Thursday,5:30 PM,10,11,2,9,6,38,9/19/2019
2019-09-19,Thursday,6:30 PM,5,3,1,1,1,11,9/19/2019
2019-09-19,Thursday,7:30 PM,5,2,7,2,1,17,9/19/2019
2019-09-19,Thursday,8:30 PM,4,1,2,2,1,10,9/19/2019
2019-09-20,Friday,8:30 AM,4,3,2,2,1,12,9/20/2019
2019-09-20,Friday,9:30 AM,3,0,0,4,0,7,9/20/2019
2019-09-20,Friday,10:30 AM,7,4,2,3,0,16,9/20/2019
2019-09-20,Friday,12:30 PM,13,5,9,4,3,34,9/20/2019
2019-09-20,Friday,1:30 PM,8,1,11,3,2,25,9/20/2019
2019-09-20,Friday,2:30 PM,10,1,6,1,0,18,9/20/2019
2019-09-20,Friday,4:30 PM,7,1,1,2,1,12,9/20/2019
2019-09-21,Saturday,10:30 AM,0,0,1,2,1,4,9/21/2019
2019-09-21,Saturday,11:30 AM,2,0,1,1,2,6,9/21/2019
2019-09-21,Saturday,12:30 PM,3,0,2,2,2,9,9/21/2019
2019-09-21,Saturday,1:30 PM,3,0,1,0,3,7,9/21/2019
2019-09-23,Monday,8:30 AM,12,4,6,11,3,36,9/23/2019
2019-09-23,Monday,9:30 AM,22,6,6,12,2,48,9/23/2019
2019-09-23,Monday,10:30 AM,30,12,12,12,6,72,9/23/2019
2019-09-23,Monday,11:30 AM,22,33,31,15,5,106,9/23/2019
2019-09-23,Monday,5:30 PM,19,4,3,2,4,32,9/23/2019
2019-09-23,Monday,6:30 PM,6,1,6,2,2,17,9/23/2019
2019-09-23,Monday,7:30 PM,6,0,0,3,0,9,9/23/2019
2019-09-23,Monday,8:30 PM,4,2,0,2,0,8,9/23/2019
2019-09-24,Tuesday,8:30 AM,12,3,1,6,2,24,9/24/2019
2019-09-24,Tuesday,9:30 AM,20,5,2,6,7,40,9/24/2019
2019-09-24,Tuesday,10:30 AM,25,8,4,12,10,59,9/24/2019
2019-09-24,Tuesday,11:30 AM,22,12,25,15,9,83,9/24/2019
2019-09-24,Tuesday,1:30 PM,17,10,6,11,4,48,9/24/2019
2019-09-24,Tuesday,3:30 PM,17,5,15,10,3,50,9/24/2019
2019-09-24,Tuesday,4:30 PM,17,3,3,12,3,38,9/24/2019
2019-09-24,Tuesday,5:30 PM,15,2,5,4,4,30,9/24/2019
2019-09-24,Tuesday,6:30 PM,7,2,18,0,1,28,9/24/2019
2019-09-24,Tuesday,7:30 PM,8,1,18,3,3,33,9/24/2019
2019-09-24,Tuesday,8:30 PM,6,0,5,1,2,14,9/24/2019
2019-09-25,Wednesday,9:30 AM,12,6,10,8,8,44,9/25/2019
2019-09-25,Wednesday,10:30 AM,20,10,8,12,6,56,9/25/2019
2019-09-25,Wednesday,11:30 AM,15,16,8,12,3,54,9/25/2019
2019-09-25,Wednesday,12:30 PM,34,20,12,14,6,86,9/25/2019
2019-09-25,Wednesday,1:30 PM,17,23,12,11,5,68,9/25/2019
2019-09-25,Wednesday,2:30 PM,29,5,11,9,3,57,9/25/2019
2019-09-25,Wednesday,3:30 PM,20,15,15,11,3,64,9/25/2019
2019-09-25,Wednesday,4:30 PM,16,5,3,10,3,37,9/25/2019
2019-09-25,Wednesday,5:30 PM,18,10,5,10,2,45,9/25/2019
2019-09-25,Wednesday,6:30 PM,7,1,23,4,1,36,9/25/2019
2019-09-25,Wednesday,7:30 PM,6,1,22,2,1,32,9/25/2019
2019-09-25,Wednesday,8:30 PM,5,0,1,3,0,9,9/25/2019
2019-09-26,Thursday,8:30 AM,12,7,2,7,6,34,9/26/2019
2019-09-26,Thursday,9:30 AM,20,9,9,9,6,53,9/26/2019
2019-09-26,Thursday,10:30 AM,26,9,12,14,3,64,9/26/2019
2019-09-26,Thursday,11:30 AM,30,12,22,15,6,85,9/26/2019
2019-09-26,Thursday,12:30 PM,43,22,22,15,9,111,9/26/2019
2019-09-26,Thursday,1:30 PM,6,3,39,8,6,62,9/26/2019
2019-09-26,Thursday,2:30 PM,20,2,9,9,4,44,9/26/2019
2019-09-26,Thursday,3:30 PM,12,3,5,13,3,36,9/26/2019
2019-09-26,Thursday,4:30 PM,10,9,7,10,4,40,9/26/2019
2019-09-26,Thursday,5:30 PM,11,7,4,7,3,32,9/26/2019
2019-09-26,Thursday,6:30 PM,8,3,4,1,1,17,9/26/2019
2019-09-26,Thursday,7:30 PM,8,1,1,1,0,11,9/26/2019
2019-09-27,Friday,8:30 AM,3,0,1,3,1,8,9/27/2019
2019-09-27,Friday,9:30 AM,11,1,1,1,1,15,9/27/2019
2019-09-27,Friday,10:30 AM,11,2,2,3,2,20,9/27/2019
2019-09-27,Friday,11:30 AM,7,2,2,0,3,14,9/27/2019
2019-09-28,Saturday,12:30 PM,10,1,1,3,1,16,9/28/2019
2019-09-28,Saturday,1:30 PM,4,1,1,1,0,7,9/28/2019
2019-09-30,Monday,8:30 AM,6,4,3,6,4,23,9/30/2019
2019-09-30,Monday,10:30 AM,34,9,9,12,9,73,9/30/2019
2019-09-30,Monday,12:30 PM,31,26,21,14,6,98,9/30/2019
2019-09-30,Monday,1:30 PM,17,7,12,9,7,52,9/30/2019
2019-09-30,Monday,2:30 PM,17,10,9,13,4,53,9/30/2019
2019-09-30,Monday,1:30 PM,21,8,11,8,4,52,9/30/2019
2019-09-30,Monday,3:30 PM,21,8,11,8,4,52,9/30/2019
2019-09-30,Monday,4:30 PM,10,6,11,9,2,38,9/30/2019
2019-09-30,Monday,5:30 PM,15,3,7,9,2,36,9/30/2019
2019-09-30,Monday,6:30 PM,3,2,9,3,0,17,9/30/2019
2019-09-30,Monday,7:30 PM,7,0,7,1,2,17,9/30/2019
2019-09-30,Monday,8:30 PM,6,0,0,0,0,6,9/30/2019
2019-10-01,Tuesday,12:30 PM,26,12,5,34,12,89,10/1/2019
2019-10-01,Tuesday,1:30 PM,14,6,26,12,6,64,10/1/2019
2019-10-01,Tuesday,2:30 PM,15,4,20,10,5,54,10/1/2019
2019-10-01,Tuesday,5:30 PM,11,3,8,5,5,32,10/1/2019
2019-10-01,Tuesday,6:30 PM,10,0,5,0,2,17,10/1/2019
2019-10-01,Tuesday,7:30 PM,5,0,10,1,2,18,10/1/2019
2019-10-01,Tuesday,8:30 PM,3,0,7,0,0,10,10/1/2019
2019-10-02,Wednesday,8:30 AM,12,8,2,8,6,36,10/2/2019
2019-10-02,Wednesday,9:30 AM,22,6,6,6,6,46,10/2/2019
2019-10-02,Wednesday,10:30 AM,26,8,10,16,11,71,10/2/2019
2019-10-02,Wednesday,4:30 PM,16,7,7,11,4,45,10/2/2019
2019-10-02,Wednesday,5:30 PM,20,4,3,11,2,40,10/2/2019
2019-10-02,Wednesday,7:30 PM,5,2,3,4,0,14,10/2/2019
2019-10-02,Wednesday,8:30 PM,2,2,1,1,0,6,10/2/2019
2019-10-03,Thursday,8:30 AM,18,4,2,11,6,41,10/3/2019
2019-10-03,Thursday,9:30 AM,32,8,10,12,8,70,10/3/2019
2019-10-03,Thursday,10:30 AM,18,7,13,12,3,53,10/3/2019
2019-10-03,Thursday,11:30 AM,19,11,37,6,4,77,10/3/2019
2019-10-03,Thursday,12:30 PM,23,8,17,5,3,56,10/3/2019
2019-10-03,Thursday,1:30 PM,11,4,12,7,4,38,10/3/2019
2019-10-03,Thursday,2:30 PM,11,4,12,10,4,41,10/3/2019
2019-10-03,Thursday,3:30 PM,11,6,3,4,2,26,10/3/2019
2019-10-03,Thursday,4:30 PM,15,3,2,9,3,32,10/3/2019
2019-10-03,Thursday,5:30 PM,14,5,2,8,4,33,10/3/2019
2019-10-03,Thursday,6:30 PM,7,2,0,0,0,9,10/3/2019
2019-10-03,Thursday,7:30 PM,9,5,2,3,1,20,10/3/2019
2019-10-03,Thursday,8:30 PM,1,3,3,0,0,7,10/3/2019
2019-10-04,Friday,8:30 AM,3,0,1,6,2,12,10/4/2019
2019-10-04,Friday,9:30 AM,7,0,2,2,0,11,10/4/2019
2019-10-04,Friday,10:30 AM,3,0,3,0,2,8,10/4/2019
2019-10-05,Saturday,11:30 AM,3,0,1,0,1,5,10/5/2019
2019-10-05,Saturday,12:30 PM,4,0,0,0,0,4,10/5/2019
2019-10-07,Monday,8:30 AM,22,4,6,8,2,42,10/7/2019
2019-10-07,Monday,9:30 AM,18,9,8,10,3,48,10/7/2019
2019-10-07,Monday,10:30 AM,32,15,10,14,3,74,10/7/2019
2019-10-07,Monday,4:30 PM,12,3,5,7,5,32,10/7/2019
2019-10-07,Monday,5:30 PM,14,11,9,10,3,47,10/7/2019
2019-10-07,Monday,6:30 PM,6,2,8,5,1,22,10/7/2019
2019-10-07,Monday,7:30 PM,2,3,8,5,0,18,10/7/2019
2019-10-07,Monday,8:30 PM,3,0,4,1,0,8,10/7/2019
2019-10-08,Tuesday,8:30 AM,11,10,3,6,4,34,10/8/2019
2019-10-08,Tuesday,9:30 AM,23,14,6,9,5,57,10/8/2019
2019-10-08,Tuesday,11:30 AM,13,8,10,15,4,50,10/8/2019
2019-10-08,Tuesday,12:30 PM,32,21,11,19,10,93,10/8/2019
2019-10-08,Tuesday,1:30 PM,16,7,9,15,4,51,10/8/2019
2019-10-08,Tuesday,2:30 PM,20,10,9,10,3,52,10/8/2019
2019-10-08,Tuesday,3:30 PM,10,4,21,6,2,43,10/8/2019
2019-10-08,Tuesday,5:30 PM,11,4,15,6,3,39,10/8/2019
2019-10-08,Tuesday,6:30 PM,9,4,6,2,2,23,10/8/2019
2019-10-08,Tuesday,7:30 PM,5,1,5,0,2,13,10/8/2019
2019-10-08,Tuesday,8:30 PM,6,1,18,1,2,28,10/8/2019
2019-10-09,Wednesday,8:30 AM,10,4,2,6,3,25,10/9/2019
2019-10-09,Wednesday,9:30 AM,36,8,8,6,7,65,10/9/2019
2019-10-09,Wednesday,10:30 AM,27,13,6,6,4,56,10/9/2019
2019-10-09,Wednesday,5:30 PM,22,10,7,6,3,48,10/9/2019
2019-10-09,Wednesday,6:30 PM,2,3,5,2,1,13,10/9/2019
2019-10-09,Wednesday,7:30 PM,6,1,2,4,0,13,10/9/2019
2019-10-09,Wednesday,8:30 PM,1,3,22,5,1,32,10/9/2019
2019-10-10,Thursday,8:30 AM,13,4,8,4,4,33,10/10/2019
2019-10-10,Thursday,9:30 AM,7,4,12,7,8,38,10/10/2019
2019-10-10,Thursday,10:30 AM,19,4,10,5,8,46,10/10/2019
2019-10-10,Thursday,5:30 PM,10,4,2,7,6,29,10/10/2019
2019-10-10,Thursday,6:30 PM,6,3,4,2,4,19,10/10/2019
2019-10-10,Thursday,7:30 PM,7,4,1,0,2,14,10/10/2019
2019-10-10,Thursday,8:30 PM,1,2,3,0,0,6,10/10/2019
2019-10-11,Friday,8:30 AM,5,3,2,4,1,15,10/11/2019
2019-10-11,Friday,9:30 AM,5,2,3,2,0,12,10/11/2019
2019-10-11,Friday,2:30 PM,13,0,1,1,1,16,10/11/2019
2019-10-11,Friday,3:30 PM,13,1,3,2,0,19,10/11/2019
2019-10-11,Friday,4:30 PM,4,1,3,1,0,9,10/11/2019
2019-10-12,Saturday,12:30 PM,5,4,0,0,2,11,10/12/2019
2019-10-12,Saturday,1:30 PM,4,2,1,0,1,8,10/12/2019
2019-10-14,Monday,8:30 AM,12,2,6,3,2,25,10/14/2019
2019-10-14,Monday,9:30 AM,25,14,16,12,4,71,10/14/2019
2019-10-14,Monday,10:30 AM,35,24,14,13,4,90,10/14/2019
2019-10-14,Monday,11:30 AM,35,16,7,18,10,86,10/14/2019
2019-10-14,Monday,12:30 PM,34,22,7,17,4,84,10/14/2019
2019-10-14,Monday,2:30 PM,35,5,7,7,4,58,10/14/2019
2019-10-14,Monday,3:30 PM,14,7,8,7,3,39,10/14/2019
2019-10-14,Monday,4:30 PM,12,11,4,10,3,40,10/14/2019
2019-10-14,Monday,5:30 PM,15,6,5,7,4,37,10/14/2019
2019-10-14,Monday,6:30 PM,3,2,10,3,1,19,10/14/2019
2019-10-14,Monday,7:30 PM,5,3,6,2,1,17,10/14/2019
2019-10-14,Monday,8:30 PM,6,3,1,0,1,11,10/14/2019
2019-10-15,Tuesday,8:30 AM,30,13,12,10,3,68,10/15/2019
2019-10-15,Tuesday,9:30 AM,13,6,10,9,3,41,10/15/2019
2019-10-15,Tuesday,10:30 AM,25,6,12,12,4,59,10/15/2019
2019-10-15,Tuesday,11:30 AM,25,13,10,13,3,64,10/15/2019
2019-10-15,Tuesday,12:30 PM,27,22,15,20,3,87,10/15/2019
2019-10-15,Tuesday,1:30 PM,13,1,14,9,6,43,10/15/2019
2019-10-15,Tuesday,1:30 PM,19,6,13,11,1,50,10/15/2019
2019-10-15,Tuesday,3:30 PM,20,6,8,4,10,48,10/15/2019
2019-10-15,Tuesday,4:30 PM,14,7,2,8,5,36,10/15/2019
2019-10-15,Tuesday,5:30 PM,11,2,6,6,0,25,10/15/2019
2019-10-15,Tuesday,6:30 PM,9,2,12,3,1,27,10/15/2019
2019-10-15,Tuesday,7:30 PM,5,0,8,3,1,17,10/15/2019
2019-10-15,Tuesday,8:30 PM,5,0,1,1,0,7,10/15/2019
2019-10-16,Wednesday,8:30 AM,20,7,3,13,4,47,10/16/2019
2019-10-16,Wednesday,9:30 AM,16,5,6,7,3,37,10/16/2019
2019-10-16,Wednesday,10:30 AM,20,20,11,15,6,72,10/16/2019
2019-10-16,Wednesday,10:30 AM,39,6,8,5,12,70,10/16/2019
2019-10-16,Wednesday,11:30 AM,12,11,6,13,6,48,10/16/2019
2019-10-16,Wednesday,12:30 PM,23,28,14,20,7,92,10/16/2019
2019-10-16,Wednesday,5:30 PM,21,7,3,6,5,42,10/16/2019
2019-10-16,Wednesday,6:30 PM,12,2,2,3,2,21,10/16/2019
2019-10-16,Wednesday,7:30 PM,5,1,8,2,3,19,10/16/2019
2019-10-16,Wednesday,8:30 PM,6,1,0,0,3,10,10/16/2019
2019-10-17,Thursday,9:30 AM,17,9,10,7,4,47,10/17/2019
2019-10-17,Thursday,10:30 AM,31,7,11,6,5,60,10/17/2019
2019-10-17,Thursday,11:30 AM,20,5,13,9,5,52,10/17/2019
2019-10-17,Thursday,1:30 PM,22,5,5,7,2,41,10/17/2019
2019-10-17,Thursday,2:30 PM,19,9,7,4,2,41,10/17/2019
2019-10-17,Thursday,3:30 PM,8,5,11,4,3,31,10/17/2019
2019-10-17,Thursday,4:30 PM,10,6,7,9,2,34,10/17/2019
2019-10-17,Thursday,5:30 PM,11,10,6,6,3,36,10/17/2019
2019-10-17,Thursday,6:30 PM,4,3,1,7,2,17,10/17/2019
2019-10-17,Thursday,7:30 PM,3,2,1,2,0,8,10/17/2019
2019-10-17,Thursday,8:30 PM,6,2,1,0,0,9,10/17/2019
2019-10-18,Friday,8:30 AM,5,0,3,2,3,13,10/18/2019
2019-10-18,Friday,9:30 AM,5,0,0,1,0,6,10/18/2019
2019-10-18,Friday,10:30 AM,5,0,2,2,0,9,10/18/2019
2019-10-18,Friday,11:30 PM,7,1,0,0,0,8,10/18/2019
2019-10-18,Friday,12:30 AM,7,1,2,0,4,14,10/18/2019
2019-10-18,Friday,1:30 AM,8,0,4,4,0,16,10/18/2019
2019-10-18,Friday,2:30 AM,9,2,10,2,1,24,10/18/2019
2019-10-18,Friday,3:30 PM,4,1,6,1,1,13,10/18/2019
2019-10-18,Friday,4:30 PM,5,0,3,0,0,8,10/18/2019
2019-10-19,Saturday,10:30 AM,1,1,0,0,0,2,10/19/2019
2019-10-19,Saturday,11:30 AM,2,1,2,1,0,6,10/19/2019
2019-10-19,Saturday,11:30 AM,3,1,2,0,0,6,10/19/2019
2019-10-19,Saturday,12:30 PM,4,1,2,0,1,8,10/19/2019
2019-10-19,Saturday,12:30 PM,5,0,3,1,1,10,10/19/2019
2019-10-19,Saturday,1:30 PM,6,0,3,0,1,10,10/19/2019
2019-10-21,Monday,8:30 AM,14,6,2,3,12,37,10/21/2019
2019-10-21,Monday,9:30 AM,13,5,2,11,2,33,10/21/2019
2019-10-21,Monday,10:30 AM,36,12,6,10,5,69,10/21/2019
2019-10-21,Monday,11:30 AM,20,9,23,20,5,77,10/21/2019
2019-10-21,Monday,12:30 PM,31,22,9,22,11,95,10/21/2019
2019-10-21,Monday,1:30 PM,21,10,13,14,7,65,10/21/2019
2019-10-21,Monday,2:30 PM,21,11,14,15,3,64,10/21/2019
2019-10-21,Monday,5:30 PM,17,4,8,7,5,41,10/21/2019
2019-10-21,Monday,6:30 PM,5,0,15,3,1,24,10/21/2019
2019-10-21,Monday,7:30 PM,5,1,9,1,2,18,10/21/2019
2019-10-21,Monday,8:30 PM,4,3,5,0,0,12,10/21/2019
2019-10-22,Tuesday,8:30 AM,10,4,6,3,4,27,10/22/2019
2019-10-22,Tuesday,9:30 AM,24,5,6,5,3,43,10/22/2019
2019-10-22,Tuesday,10:30 AM,25,5,8,11,6,55,10/22/2019
2019-10-22,Tuesday,12:30 PM,39,19,5,17,2,82,10/22/2019
2019-10-22,Tuesday,1:30 PM,19,7,5,15,7,53,10/22/2019
2019-10-22,Tuesday,1:30 PM,29,9,10,7,1,56,10/22/2019
2019-10-22,Tuesday,3:30 PM,12,7,22,6,5,52,10/22/2019
2019-10-22,Tuesday,4:30 PM,16,5,12,11,3,47,10/22/2019
2019-10-22,Tuesday,5:30 PM,16,9,2,12,4,43,10/22/2019
2019-10-22,Tuesday,6:30 PM,8,1,25,8,4,46,10/22/2019
2019-10-22,Tuesday,7:30 PM,9,1,6,4,2,22,10/22/2019
2019-10-22,Tuesday,8:30 PM,5,0,0,1,0,6,10/22/2019
2019-10-23,Wednesday,8:30 AM,14,4,6,12,3,39,10/23/2019
2019-10-23,Wednesday,9:30 AM,27,2,3,12,2,46,10/23/2019
2019-10-23,Wednesday,10:30 AM,23,4,4,11,2,44,10/23/2019
2019-10-23,Wednesday,11:30 AM,22,16,7,15,5,65,10/23/2019
2019-10-23,Wednesday,12:30 PM,26,18,8,20,10,82,10/23/2019
2019-10-23,Wednesday,1:30 PM,15,6,5,15,3,44,10/23/2019
2019-10-23,Wednesday,2:30 PM,19,9,6,9,2,45,10/23/2019
2019-10-23,Wednesday,3:30 PM,19,7,4,9,4,43,10/23/2019
2019-10-23,Wednesday,4:30 PM,12,3,5,11,2,33,10/23/2019
2019-10-23,Wednesday,5:30 PM,23,5,6,12,3,49,10/23/2019
2019-10-23,Wednesday,6:30 PM,7,2,2,2,0,13,10/23/2019
2019-10-23,Wednesday,7:30 PM,6,2,2,2,0,12,10/23/2019
2019-10-23,Wednesday,8:30 PM,4,1,2,1,0,8,10/23/2019
2019-10-24,Thursday,8:30 AM,10,4,4,4,4,26,10/24/2019
2019-10-24,Thursday,9:30 AM,19,4,6,9,5,43,10/24/2019
2019-10-24,Thursday,10:30 AM,20,6,8,11,4,49,10/24/2019
2019-10-24,Thursday,11:30 AM,14,7,20,15,5,61,10/24/2019
2019-10-24,Thursday,12:30 PM,26,7,13,16,5,67,10/24/2019
2019-10-24,Thursday,1:30 PM,16,5,2,11,3,37,10/24/2019
2019-10-24,Thursday,2:30 PM,20,3,2,7,4,36,10/24/2019
2019-10-24,Thursday,3:30 PM,10,7,5,7,4,33,10/24/2019
2019-10-24,Thursday,4:30 PM,13,9,3,7,3,35,10/24/2019
2019-10-24,Thursday,5:30 PM,16,4,3,6,4,33,10/24/2019
2019-10-24,Thursday,6:30 PM,10,6,0,0,2,18,10/24/2019
2019-10-24,Thursday,7:30 PM,11,1,0,3,1,16,10/24/2019
2019-10-24,Thursday,8:30 PM,3,1,0,1,1,6,10/24/2019
2019-10-25,Friday,9:30 AM,4,4,2,1,2,13,10/25/2019
2019-10-25,Friday,10:30 AM,5,2,3,0,1,11,10/25/2019
2019-10-25,Friday,12:30 PM,8,5,1,4,0,18,10/25/2019
2019-10-25,Friday,1:30 PM,9,3,0,1,1,14,10/25/2019
2019-10-25,Friday,2:30 PM,5,1,3,0,1,10,10/25/2019
2019-10-25,Friday,3:30 PM,2,0,3,0,1,6,10/25/2019
2019-10-26,Saturday,12:30 PM,1,1,1,0,0,3,10/26/2019
2019-10-26,Saturday,1:30 PM,2,0,0,0,0,2,10/26/2019
2019-10-28,Monday,8:30 AM,8,4,2,3,1,18,10/28/2019
2019-10-28,Monday,9:30 AM,17,4,6,8,7,42,10/28/2019
2019-10-28,Monday,10:30 AM,37,22,8,9,5,81,10/28/2019
2019-10-28,Monday,11:30 AM,30,8,10,6,12,66,10/28/2019
2019-10-28,Monday,12:30 PM,32,21,13,8,6,80,10/28/2019
2019-10-28,Monday,1:30 PM,18,6,8,11,4,47,10/28/2019
2019-10-28,Monday,2:30 PM,22,8,6,9,3,48,10/28/2019
2019-10-28,Monday,3:30 PM,10,6,5,6,3,30,10/28/2019
2019-10-28,Monday,11:30 AM,15,3,7,11,2,38,10/28/2019
2019-10-28,Monday,5:30 PM,11,3,7,11,2,34,10/28/2019
2019-10-28,Monday,6:30 PM,8,2,10,5,3,28,10/28/2019
2019-10-28,Monday,8:30 PM,4,0,3,0,0,7,10/28/2019
2019-10-29,Tuesday,8:30 AM,12,6,5,5,4,32,10/29/2019
2019-10-29,Tuesday,9:30 AM,22,9,8,13,3,55,10/29/2019
2019-10-29,Tuesday,10:30 AM,22,14,11,13,2,62,10/29/2019
2019-10-29,Tuesday,11:30 AM,19,7,13,14,2,55,10/29/2019
2019-10-29,Tuesday,12:30 PM,37,15,12,9,3,76,10/29/2019
2019-10-29,Tuesday,2:30 PM,19,11,9,7,2,48,10/29/2019
2019-10-29,Tuesday,3:30 PM,11,9,8,7,2,37,10/29/2019
2019-10-29,Tuesday,4:30 PM,10,8,6,6,2,32,10/29/2019
2019-10-29,Tuesday,5:30 PM,10,6,4,8,3,31,10/29/2019
2019-10-29,Tuesday,6:30 PM,7,0,1,3,2,13,10/29/2019
2019-10-29,Tuesday,7:30 PM,6,4,1,3,1,15,10/29/2019
2019-10-29,Tuesday,8:30 PM,4,0,0,2,0,6,10/29/2019
2019-10-30,Wednesday,8:30 AM,9,9,4,9,4,35,10/30/2019
2019-10-30,Wednesday,9:30 AM,18,4,8,12,6,48,10/30/2019
2019-10-30,Wednesday,10:30 AM,24,7,9,16,8,64,10/30/2019
2019-10-30,Wednesday,11:30 AM,25,20,16,16,5,82,10/30/2019
2019-10-30,Wednesday,12:30 PM,35,32,11,16,5,99,10/30/2019
2019-10-30,Wednesday,1:30 PM,23,10,14,7,4,58,10/30/2019
2019-10-30,Wednesday,2:30 PM,18,8,3,7,4,40,10/30/2019
2019-10-30,Wednesday,3:30 PM,19,5,5,3,2,34,10/30/2019
2019-10-30,Wednesday,4:30 PM,18,4,5,11,3,41,10/30/2019
2019-10-30,Wednesday,5:30 PM,22,1,8,7,3,41,10/30/2019
2019-10-30,Wednesday,6:30 PM,4,0,11,3,0,18,10/30/2019
2019-10-30,Wednesday,7:30 PM,8,0,10,3,1,22,10/30/2019
2019-10-30,Wednesday,8:30 PM,5,2,0,1,2,10,10/30/2019
2019-10-30,Wednesday,8:30 PM,5,2,0,2,1,10,10/30/2019
2019-10-31,Thursday,8:30 AM,8,2,8,3,1,22,10/31/2019
2019-10-31,Thursday,9:30 AM,15,4,8,9,3,39,10/31/2019
2019-10-31,Thursday,12:30 PM,19,14,13,11,4,61,10/31/2019
2019-10-31,Thursday,1:30 PM,16,6,5,11,3,41,10/31/2019
2019-10-31,Thursday,4:30 PM,6,7,3,10,4,30,10/31/2019
2019-10-31,Thursday,5:30 PM,12,6,4,5,5,32,10/31/2019
2019-10-31,Thursday,6:30 PM,4,1,7,1,2,15,10/31/2019
2019-10-31,Thursday,8:30 PM,2,1,2,0,0,5,10/31/2019
2019-11-02,Saturday,10:30 AM,2,1,0,0,0,3,11/2/2019
2019-11-02,Saturday,11:30 AM,5,0,1,0,0,6,11/2/2019
2019-11-02,Saturday,11:30 AM,5,0,1,0,0,6,11/2/2019
2019-11-02,Saturday,12:30 PM,4,0,1,1,1,7,11/2/2019
2019-11-02,Saturday,1:30 PM,5,0,1,1,0,7,11/2/2019
2019-11-04,Monday,8:30 AM,17,5,2,10,2,36,11/4/2019
2019-11-04,Monday,9:30 AM,15,8,6,7,5,41,11/4/2019
2019-11-04,Monday,10:30 AM,28,22,15,20,6,91,11/4/2019
2019-11-04,Monday,11:30 PM,25,15,8,10,3,61,11/4/2019
2019-11-04,Monday,12:30 AM,22,21,10,14,5,72,11/4/2019
2019-11-04,Monday,1:30 AM,17,8,5,7,2,39,11/4/2019
2019-11-04,Monday,2:30 AM,17,6,6,8,3,40,11/4/2019
2019-11-04,Monday,3:30 AM,12,6,5,7,2,32,11/4/2019
2019-11-04,Monday,4:30 PM,18,3,7,8,7,43,11/4/2019
2019-11-04,Monday,5:30 PM,15,3,7,3,4,32,11/4/2019
2019-11-04,Monday,6:30 PM,9,1,8,4,0,22,11/4/2019
2019-11-04,Monday,7:30 PM,7,1,10,3,1,22,11/4/2019
2019-11-04,Monday,8:30 PM,3,1,0,1,0,5,11/4/2019
2019-11-05,Tuesday,8:30 AM,9,8,2,5,5,29,11/5/2019
2019-11-05,Tuesday,9:30 AM,22,8,3,11,2,46,11/5/2019
2019-11-05,Tuesday,9:30 AM,22,8,3,11,2,46,11/5/2019
2019-11-05,Tuesday,10:30 AM,26,4,10,13,6,59,11/5/2019
2019-11-05,Tuesday,11:30 AM,28,7,19,14,5,73,11/5/2019
2019-11-05,Tuesday,2:30 PM,12,10,8,11,3,44,11/5/2019
2019-11-05,Tuesday,4:30 PM,12,14,7,12,3,48,11/5/2019
2019-11-05,Tuesday,5:30 PM,10,12,6,12,3,43,11/5/2019
2019-11-05,Tuesday,6:30 PM,7,2,4,4,1,18,11/5/2019
2019-11-05,Tuesday,7:30 PM,7,0,4,3,2,16,11/5/2019
2019-11-05,Tuesday,8:30 PM,7,0,2,1,1,11,11/5/2019
2019-11-06,Wednesday,8:30 AM,8,6,4,12,3,33,11/6/2019
2019-11-06,Wednesday,9:30 AM,20,5,4,9,7,45,11/6/2019
2019-11-06,Wednesday,11:30 AM,19,16,7,13,4,59,11/6/2019
2019-11-06,Wednesday,12:30 PM,31,26,9,17,5,88,11/6/2019
2019-11-06,Wednesday,1:30 PM,18,10,5,8,41,82,11/6/2019
2019-11-06,Wednesday,2:30 PM,14,4,18,9,4,49,11/6/2019
2019-11-06,Wednesday,3:30 PM,19,5,9,9,4,46,11/6/2019
2019-11-06,Wednesday,4:30 PM,20,8,5,7,2,42,11/6/2019
2019-11-06,Wednesday,5:30 PM,15,5,3,10,3,36,11/6/2019
2019-11-06,Wednesday,6:30 PM,5,2,4,6,2,19,11/6/2019
2019-11-06,Wednesday,7:30 PM,6,0,4,1,1,12,11/6/2019
2019-11-06,Wednesday,8:30 PM,4,0,2,2,1,9,11/6/2019
2019-11-07,Thursday,8:30 AM,9,4,6,5,5,29,11/7/2019
2019-11-07,Thursday,9:30 AM,17,13,7,8,7,52,11/7/2019
2019-11-07,Thursday,1:30 PM,10,4,10,8,6,38,11/7/2019
2019-11-07,Thursday,3:30 PM,12,5,6,15,4,42,11/7/2019
2019-11-07,Thursday,5:30 PM,17,9,7,8,5,46,11/7/2019
2019-11-07,Thursday,6:30 PM,6,1,2,2,4,15,11/7/2019
2019-11-07,Thursday,7:30 PM,8,2,2,2,1,15,11/7/2019
2019-11-07,Thursday,8:30 PM,8,2,2,1,0,13,11/7/2019
2019-11-08,Friday,8:30 AM,3,2,0,2,2,9,11/8/2019
2019-11-08,Friday,9:30 AM,6,4,0,2,0,12,11/8/2019
2019-11-08,Friday,10:30 AM,1,1,1,1,1,5,11/8/2019
2019-11-08,Friday,11:30 AM,6,1,1,2,0,10,11/8/2019
2019-11-08,Friday,12:30 PM,11,6,1,4,1,23,11/8/2019
2019-11-08,Friday,2:30 PM,2,1,2,2,1,8,11/8/2019
2019-11-08,Friday,3:30 PM,5,3,2,3,2,15,11/8/2019
2019-11-08,Friday,4:30 PM,9,0,2,0,0,11,11/8/2019
2019-11-09,Saturday,11:30 AM,3,1,0,0,0,4,11/9/2019
2019-11-09,Saturday,12:30 PM,3,0,2,1,0,6,11/9/2019
2019-11-09,Saturday,12:30 PM,4,2,0,1,0,7,11/9/2019
2019-11-11,Monday,8:30 AM,12,4,4,14,5,39,11/11/2019
2019-11-11,Monday,9:30 AM,14,8,4,8,8,42,11/11/2019
2019-11-11,Monday,10:30 AM,33,13,4,9,7,66,11/11/2019
2019-11-11,Monday,11:30 AM,34,17,14,16,6,87,11/11/2019
2019-11-11,Monday,12:30 PM,34,17,8,17,6,82,11/11/2019
2019-11-11,Monday,12:30 PM,31,14,12,22,13,92,11/11/2019
2019-11-11,Monday,1:30 PM,11,4,17,10,5,47,11/11/2019
2019-11-11,Monday,2:30 PM,18,6,31,9,5,69,11/11/2019
2019-11-11,Monday,3:30 PM,16,5,29,12,4,66,11/11/2019
2019-11-11,Monday,2:30 PM,15,7,26,10,4,62,11/11/2019
2019-11-11,Monday,6:30 PM,6,2,2,3,1,14,11/11/2019
2019-11-11,Monday,8:30 PM,1,1,2,2,3,9,11/11/2019
2019-11-12,Tuesday,8:30 AM,11,0,2,7,2,22,11/12/2019
2019-11-12,Tuesday,9:30 AM,14,5,5,3,7,34,11/12/2019
2019-11-12,Tuesday,10:30 AM,18,10,8,11,7,54,11/12/2019
2019-11-12,Tuesday,1:30 PM,21,7,31,17,3,79,11/12/2019
2019-11-12,Tuesday,2:30 PM,25,17,29,13,2,86,11/12/2019
2019-11-12,Tuesday,3:30 PM,12,8,10,8,2,40,11/12/2019
2019-11-12,Tuesday,4:30 PM,13,4,6,11,4,38,11/12/2019
2019-11-12,Tuesday,5:30 PM,12,7,6,9,6,40,11/12/2019
2019-11-12,Tuesday,6:30 PM,2,3,13,1,3,22,11/12/2019
2019-11-12,Tuesday,7:30 PM,5,4,4,2,1,16,11/12/2019
2019-11-12,Tuesday,8:30 PM,5,1,2,1,1,10,11/12/2019
2019-11-13,Wednesday,8:30 AM,11,2,0,10,4,27,11/13/2019
2019-11-13,Wednesday,9:30 AM,11,7,5,11,8,42,11/13/2019
2019-11-13,Wednesday,10:30 AM,28,10,10,12,9,69,11/13/2019
2019-11-13,Wednesday,12:30 PM,40,28,13,17,6,104,11/13/2019
2019-11-13,Wednesday,5:30 PM,10,9,9,7,3,38,11/13/2019
2019-11-13,Wednesday,6:30 PM,2,1,3,2,1,9,11/13/2019
2019-11-13,Wednesday,6:30 PM,5,2,4,1,1,13,11/13/2019
2019-11-13,Wednesday,7:30 PM,4,7,0,2,0,13,11/13/2019
2019-11-14,Thursday,8:30 AM,19,8,1,10,5,43,11/14/2019
2019-11-14,Thursday,9:30 AM,15,10,4,7,7,43,11/14/2019
2019-11-14,Thursday,10:30 AM,15,11,4,10,8,48,11/14/2019
2019-11-14,Thursday,5:30 PM,21,5,7,9,6,48,11/14/2019
2019-11-14,Thursday,5:30 PM,12,5,8,7,5,37,11/14/2019
2019-11-14,Thursday,6:30 PM,10,0,4,1,3,18,11/14/2019
2019-11-14,Thursday,7:30 PM,8,1,3,3,1,16,11/14/2019
2019-11-14,Thursday,8:30 PM,6,0,5,3,0,14,11/14/2019
2019-11-15,Friday,8:30 AM,9,0,3,5,3,20,11/15/2019
2019-11-15,Friday,9:30 AM,8,2,4,2,6,22,11/15/2019
2019-11-15,Friday,10:30 AM,8,3,4,5,1,21,11/15/2019
2019-11-15,Friday,10:30 AM,12,4,7,3,2,28,11/15/2019
2019-11-15,Friday,11:30 AM,10,3,8,3,2,26,11/15/2019
2019-11-16,Saturday,11:30 AM,3,0,8,2,0,13,11/16/2019
2019-11-16,Saturday,12:30 PM,3,0,8,1,0,12,11/16/2019
2019-11-16,Saturday,1:30 PM,3,0,5,0,1,9,11/16/2019
2019-11-18,Monday,8:30 AM,12,4,6,3,1,26,11/18/2019
2019-11-18,Monday,9:30 AM,19,9,8,10,5,51,11/18/2019
2019-11-18,Monday,10:30 AM,33,10,6,16,8,73,11/18/2019
2019-11-18,Monday,5:30 PM,14,5,5,8,4,36,11/18/2019
2019-11-18,Monday,6:30 PM,4,2,2,2,2,12,11/18/2019
2019-11-18,Monday,7:30 PM,6,0,0,1,1,8,11/18/2019
2019-11-18,Monday,8:30 PM,1,1,1,2,0,5,11/18/2019
2019-11-19,Tuesday,8:30 AM,23,3,3,3,3,35,11/19/2019
2019-11-19,Tuesday,9:30 AM,14,11,6,5,3,39,11/19/2019
2019-11-19,Tuesday,10:30 AM,20,6,8,11,6,51,11/19/2019
2019-11-19,Tuesday,5:30 PM,21,5,6,4,3,39,11/19/2019
2019-11-19,Tuesday,6:30 PM,7,1,11,0,0,19,11/19/2019
2019-11-19,Tuesday,7:30 PM,7,1,11,0,0,19,11/19/2019
2019-11-19,Tuesday,8:30 PM,6,0,3,2,0,11,11/19/2019
2019-11-20,Wednesday,8:30 AM,10,6,8,15,5,44,11/20/2019
2019-11-20,Wednesday,9:30 AM,14,5,8,7,6,40,11/20/2019
2019-11-20,Wednesday,12:30 PM,26,18,10,17,8,79,11/20/2019
2019-11-20,Wednesday,5:30 PM,16,5,4,8,5,38,11/20/2019
2019-11-20,Wednesday,6:30 PM,10,1,17,3,0,31,11/20/2019
2019-11-20,Wednesday,7:30 PM,14,0,2,0,0,16,11/20/2019
2019-11-20,Wednesday,8:30 PM,9,1,2,0,0,12,11/20/2019
2019-11-21,Thursday,8:30 AM,11,4,3,8,3,29,11/21/2019
2019-11-21,Thursday,9:30 AM,14,6,8,10,4,42,11/21/2019
2019-11-21,Thursday,10:30 AM,26,6,10,3,16,61,11/21/2019
2019-11-21,Thursday,11:30 AM,21,14,16,5,5,61,11/21/2019
2019-11-21,Thursday,12:30 PM,27,17,35,16,4,99,11/21/2019
2019-11-21,Thursday,1:30 PM,14,6,16,16,3,55,11/21/2019
2019-11-21,Thursday,2:30 PM,15,3,16,8,2,44,11/21/2019
2019-11-21,Thursday,3:30 PM,10,7,19,8,2,46,11/21/2019
2019-11-21,Thursday,2:30 PM,12,5,8,7,2,34,11/21/2019
2019-11-21,Thursday,5:30 PM,14,6,11,4,5,40,11/21/2019
2019-11-21,Thursday,6:30 PM,5,0,20,3,0,28,11/21/2019
2019-11-21,Thursday,7:30 PM,6,1,3,1,0,11,11/21/2019
2019-11-22,Friday,8:30 AM,5,2,0,3,1,11,11/22/2019
2019-11-22,Friday,9:30 AM,7,1,7,1,1,17,11/22/2019
2019-11-22,Friday,10:30 AM,4,2,7,3,1,17,11/22/2019
2019-11-22,Friday,3:30 PM,1,3,3,3,1,11,11/22/2019
2019-11-22,Friday,4:30 PM,5,2,5,2,0,14,11/22/2019
2019-11-23,Saturday,10:30 AM,1,2,1,0,0,4,11/23/2019
2019-11-23,Saturday,11:30 AM,6,5,3,0,0,14,11/23/2019
2019-11-23,Saturday,12:30 PM,10,4,3,0,0,17,11/23/2019
2019-11-23,Saturday,1:30 PM,9,1,0,0,1,11,11/23/2019
2019-11-25,Monday,8:30 AM,16,12,2,11,7,48,11/25/2019
2019-11-25,Monday,8:30 AM,16,12,2,11,7,48,11/25/2019
2019-11-25,Monday,9:30 AM,24,10,3,8,4,49,11/25/2019
2019-11-25,Monday,10:30 AM,38,20,14,20,9,101,11/25/2019
2019-11-25,Monday,11:30 AM,20,24,22,17,5,88,11/25/2019
2019-11-25,Monday,12:30 PM,23,14,10,21,3,71,11/25/2019
2019-11-25,Monday,1:30 PM,17,5,17,7,6,52,11/25/2019
2019-11-25,Monday,2:30 PM,15,8,8,5,9,45,11/25/2019
2019-11-25,Monday,3:30 PM,23,9,20,12,2,66,11/25/2019
2019-11-25,Monday,4:30 PM,7,1,10,8,3,29,11/25/2019
2019-11-25,Monday,5:30 PM,13,5,8,4,3,33,11/25/2019
2019-11-25,Monday,6:30 PM,5,2,8,3,0,18,11/25/2019
2019-11-25,Monday,7:30 PM,6,0,6,1,2,15,11/25/2019
2019-11-25,Monday,8:30 PM,4,0,0,0,1,5,11/25/2019
2019-11-26,Tuesday,8:30 AM,10,4,5,3,1,23,11/26/2019
2019-11-26,Tuesday,9:30 AM,19,9,5,10,3,46,11/26/2019
2019-11-26,Tuesday,10:30 AM,27,10,6,13,6,62,11/26/2019
2019-11-26,Tuesday,11:30 AM,21,7,11,6,5,50,11/26/2019
2019-11-26,Tuesday,1:30 PM,15,5,18,8,3,49,11/26/2019
2019-11-26,Tuesday,2:30 PM,17,5,11,5,1,39,11/26/2019
2019-11-26,Tuesday,3:30 PM,8,7,9,7,1,32,11/26/2019
2019-11-26,Tuesday,4:30 PM,12,0,6,10,0,28,11/26/2019
2019-11-26,Tuesday,5:30 PM,9,2,7,5,1,24,11/26/2019
2019-11-26,Tuesday,6:30 PM,6,5,5,6,0,22,11/26/2019
2019-11-26,Tuesday,7:30 PM,4,0,5,3,0,12,11/26/2019
2019-11-26,Tuesday,8:30 PM,5,0,0,2,0,7,11/26/2019
2019-12-02,Monday,8:30 AM,24,2,4,3,2,35,12/2/2019
2019-12-02,Monday,9:30 AM,30,7,7,7,5,56,12/2/2019
2019-12-02,Monday,10:30 AM,35,16,10,12,14,87,12/2/2019
2019-12-02,Monday,4:30 PM,21,4,8,6,2,41,12/2/2019
2019-12-02,Monday,5:30 PM,16,5,8,4,3,36,12/2/2019
2019-12-02,Monday,6:30 PM,10,2,14,3,0,29,12/2/2019
2019-12-02,Monday,7:30 PM,9,0,5,2,0,16,12/2/2019
2019-12-02,Monday,8:30 PM,6,1,4,0,0,11,12/2/2019
2019-12-03,Tuesday,8:30 AM,9,5,4,7,7,32,12/3/2019
2019-12-03,Tuesday,9:30 AM,28,8,6,8,9,59,12/3/2019
2019-12-03,Tuesday,10:30 AM,15,3,8,13,8,47,12/3/2019
2019-12-03,Tuesday,11:30 AM,19,4,2,7,2,34,12/3/2019
2019-12-03,Tuesday,12:30 PM,25,12,3,9,7,56,12/3/2019
2019-12-03,Tuesday,1:30 PM,12,11,3,7,4,37,12/3/2019
2019-12-03,Tuesday,4:30 PM,14,6,17,8,2,47,12/3/2019
2019-12-03,Tuesday,3:30 PM,14,6,17,8,2,47,12/3/2019
2019-12-03,Tuesday,5:30 PM,24,5,16,7,1,53,12/3/2019
2019-12-03,Tuesday,7:30 PM,13,2,8,1,1,25,12/3/2019
2019-12-03,Tuesday,8:30 PM,3,0,3,1,0,7,12/3/2019
2019-12-04,Wednesday,8:30 AM,24,4,3,4,4,39,12/4/2019
2019-12-04,Wednesday,9:30 AM,18,4,6,5,3,36,12/4/2019
2019-12-04,Wednesday,10:30 AM,22,11,6,5,6,50,12/4/2019
2019-12-04,Wednesday,11:30 AM,26,14,6,18,8,72,12/4/2019
2019-12-04,Wednesday,12:30 PM,20,13,8,16,4,61,12/4/2019
2019-12-04,Wednesday,1:30 PM,17,5,13,10,8,53,12/4/2019
2019-12-04,Wednesday,1:30 PM,15,5,20,7,3,50,12/4/2019
2019-12-04,Wednesday,4:30 PM,17,11,15,9,3,55,12/4/2019
2019-12-04,Wednesday,5:30 PM,21,9,6,3,4,43,12/4/2019
2019-12-04,Wednesday,6:30 PM,3,3,2,1,0,9,12/4/2019
2019-12-04,Wednesday,7:30 PM,10,2,4,1,2,19,12/4/2019
2019-12-04,Wednesday,8:30 PM,7,1,1,3,1,13,12/4/2019
2019-12-05,Thursday,8:30 AM,12,4,4,3,1,24,12/5/2019
2019-12-05,Thursday,9:30 AM,28,8,6,10,5,57,12/5/2019
2019-12-05,Thursday,10:30 AM,28,15,12,16,4,75,12/5/2019
2019-12-05,Thursday,11:30 AM,19,9,11,12,3,54,12/5/2019
2019-12-05,Thursday,12:30 PM,23,16,15,17,10,81,12/5/2019
2019-12-05,Thursday,1:30 PM,16,9,18,4,4,51,12/5/2019
2019-12-05,Thursday,2:30 PM,23,5,14,13,0,55,12/5/2019
2019-12-05,Thursday,3:30 PM,19,7,11,13,2,52,12/5/2019
2019-12-05,Thursday,4:30 PM,20,4,5,9,1,39,12/5/2019
2019-12-05,Thursday,5:30 PM,15,5,22,5,3,50,12/5/2019
2019-12-05,Thursday,6:30 PM,4,1,5,5,3,18,12/5/2019
2019-12-05,Thursday,7:30 PM,8,1,9,8,2,28,12/5/2019
2019-12-05,Thursday,8:30 PM,6,0,2,0,0,8,12/5/2019
2019-12-06,Friday,8:30 AM,9,9,2,1,1,22,12/6/2019
2019-12-06,Friday,9:30 AM,5,8,3,3,2,21,12/6/2019
2019-12-06,Friday,10:30 AM,10,1,4,2,1,18,12/6/2019
2019-12-06,Friday,3:30 PM,5,1,6,1,1,14,12/6/2019
2019-12-06,Friday,4:30 PM,5,3,6,0,0,14,12/6/2019
2019-12-07,Saturday,11:30 AM,1,0,5,2,0,8,12/7/2019
2019-12-07,Saturday,12:30 PM,2,1,10,1,1,15,12/7/2019
2019-12-07,Saturday,1:30 PM,2,0,10,0,1,13,12/7/2019
2019-12-09,Monday,8:30 AM,14,4,6,5,2,31,12/9/2019
2019-12-09,Monday,9:30 AM,15,4,8,4,5,36,12/9/2019
2019-12-09,Monday,10:30 AM,20,4,8,5,4,41,12/9/2019
2019-12-09,Monday,11:30 AM,30,8,10,6,12,66,12/9/2019
2019-12-09,Monday,5:30 PM,9,3,9,5,1,27,12/9/2019
2019-12-09,Monday,6:30 PM,7,1,10,5,2,25,12/9/2019
2019-12-09,Monday,7:30 PM,10,2,10,4,2,28,12/9/2019
2019-12-09,Monday,8:30 PM,4,2,2,2,1,11,12/9/2019
2019-12-10,Tuesday,8:30 AM,10,5,5,5,3,28,12/10/2019
2019-12-10,Tuesday,9:30 AM,16,3,6,10,5,40,12/10/2019
2019-12-10,Tuesday,10:30 AM,18,6,5,13,6,48,12/10/2019
2019-12-10,Tuesday,5:30 PM,13,5,15,2,2,37,12/10/2019
2019-12-10,Tuesday,6:30 PM,11,3,15,2,1,32,12/10/2019
2019-12-10,Tuesday,7:30 PM,6,0,10,5,3,24,12/10/2019
2019-12-10,Tuesday,8:30 PM,10,2,5,3,0,20,12/10/2019
2019-12-11,Wednesday,8:30 AM,18,4,6,4,3,35,12/11/2019
2019-12-11,Wednesday,9:30 AM,15,10,6,11,7,49,12/11/2019
2019-12-11,Wednesday,10:30 AM,34,21,8,12,8,83,12/11/2019
2019-12-11,Wednesday,11:30 AM,17,12,10,11,4,54,12/11/2019
2019-12-11,Wednesday,12:30 PM,21,6,7,9,10,53,12/11/2019
2019-12-11,Wednesday,1:30 PM,19,5,11,11,4,50,12/11/2019
2019-12-11,Wednesday,4:30 PM,19,6,12,9,3,49,12/11/2019
2019-12-11,Wednesday,5:30 PM,23,9,4,7,8,51,12/11/2019
2019-12-11,Wednesday,6:30 PM,7,0,25,8,1,41,12/11/2019
2019-12-11,Wednesday,7:30 PM,6,1,6,4,1,18,12/11/2019
2019-12-12,Thursday,9:30 AM,15,4,8,3,1,31,12/12/2019
2019-12-12,Thursday,9:30 AM,19,5,10,6,2,42,12/12/2019
2019-12-12,Thursday,10:30 AM,30,20,8,16,8,82,12/12/2019
2019-12-12,Thursday,11:30 AM,15,8,10,9,5,47,12/12/2019
2019-12-12,Thursday,12:30 PM,30,15,10,19,5,79,12/12/2019
2019-12-12,Thursday,1:30 PM,19,6,10,9,3,47,12/12/2019
2019-12-12,Thursday,2:30 PM,15,6,6,6,3,36,12/12/2019
2019-12-12,Thursday,5:30 PM,9,4,9,9,4,35,12/12/2019
2019-12-12,Thursday,7:30 PM,4,1,6,2,0,13,12/12/2019
2019-12-13,Friday,8:30 AM,4,2,4,3,1,14,12/13/2019
2019-12-13,Friday,9:30 AM,5,3,7,3,0,18,12/13/2019
2019-12-13,Friday,11:30 AM,9,2,3,4,0,18,12/13/2019
2019-12-13,Friday,12:30 PM,11,4,7,5,1,28,12/13/2019
2019-12-13,Friday,1:30 PM,6,3,2,3,0,14,12/13/2019
2019-12-13,Friday,2:30 PM,5,0,2,1,1,9,12/13/2019
2019-12-13,Friday,3:30 PM,2,2,0,1,0,5,12/13/2019
2019-12-13,Friday,4:30 PM,2,2,0,0,0,4,12/13/2019
2019-12-16,Monday,8:30 AM,1,0,0,1,0,2,12/16/2019
2019-12-16,Monday,9:30 AM,1,1,0,0,0,2,12/16/2019
2019-12-17,Tuesday,8:30 AM,0,0,0,0,0,0,12/17/2019
2020-01-16,Thursday,8:30 AM,11,2,1,7,7,28,1/16/2020
2020-01-16,Thursday,9:30 AM,15,2,1,5,5,28,1/16/2020
2020-01-16,Thursday,10:30 AM,25,5,3,7,7,47,1/16/2020
2020-01-16,Thursday,11:30 AM,22,12,6,12,4,56,1/16/2020
2020-01-16,Thursday,12:30 PM,35,13,6,17,14,85,1/16/2020
2020-01-16,Thursday,5:30 PM,16,4,1,6,4,31,1/16/2020
2020-01-16,Thursday,7:30 PM,8,2,0,3,1,14,1/16/2020
2020-01-16,Thursday,8:30 PM,5,2,0,1,0,8,1/16/2020
2020-01-17,Friday,8:30 AM,4,1,1,2,1,9,1/17/2020
2020-01-17,Friday,9:30 AM,6,2,1,2,1,12,1/17/2020
2020-01-17,Friday,10:30 AM,8,0,2,2,1,13,1/17/2020
2020-01-17,Friday,11:30 AM,15,4,15,1,5,40,1/17/2020
2020-01-17,Friday,3:30 PM,12,4,2,1,1,20,1/17/2020
2020-01-17,Friday,4:30 PM,5,2,1,0,0,8,1/17/2020
2020-01-18,Saturday,10:30 AM,2,0,0,0,0,2,1/18/2020
2020-01-18,Saturday,11:30 AM,2,0,0,1,0,3,1/18/2020
2020-01-18,Saturday,12:30 PM,4,0,0,2,0,6,1/18/2020
2020-01-18,Saturday,1:30 PM,7,0,1,3,0,11,1/18/2020
2020-01-21,Tuesday,8:30 AM,8,4,1,3,5,21,1/21/2020
2020-01-21,Tuesday,9:30 AM,12,4,5,4,2,27,1/21/2020
2020-01-21,Tuesday,10:30 AM,22,9,5,6,5,47,1/21/2020
2020-01-21,Tuesday,4:30 PM,10,9,20,12,4,55,1/21/2020
2020-01-21,Tuesday,5:30 PM,18,6,6,8,4,42,1/21/2020
2020-01-21,Tuesday,6:30 PM,5,1,0,3,0,9,1/21/2020
2020-01-21,Tuesday,8:30 PM,4,2,0,2,2,10,1/21/2020
2020-01-22,Wednesday,8:30 AM,6,2,1,2,1,12,1/22/2020
2020-01-22,Wednesday,9:30 AM,11,6,2,10,8,37,1/22/2020
2020-01-22,Wednesday,10:30 AM,30,12,6,10,8,66,1/22/2020
2020-01-22,Wednesday,11:30 AM,18,10,11,15,7,61,1/22/2020
2020-01-22,Wednesday,12:30 PM,37,18,8,18,6,87,1/22/2020
2020-01-22,Wednesday,1:30 PM,13,3,41,11,4,72,1/22/2020
2020-01-22,Wednesday,2:30 PM,18,1,21,10,2,52,1/22/2020
2020-01-22,Wednesday,3:30 PM,18,8,22,9,4,61,1/22/2020
2020-01-22,Wednesday,5:30 PM,14,4,7,4,3,32,1/22/2020
2020-01-22,Wednesday,6:30 PM,4,3,7,5,3,22,1/22/2020
2020-01-22,Wednesday,7:30 PM,5,4,1,4,3,17,1/22/2020
2020-01-22,Wednesday,8:30 PM,2,2,1,1,1,7,1/22/2020
2020-01-23,Thursday,9:30 AM,10,6,6,6,6,34,1/23/2020
2020-01-23,Thursday,8:30 AM,12,4,4,12,12,44,1/23/2020
2020-01-23,Thursday,11:30 AM,14,8,3,10,4,39,1/23/2020
2020-01-23,Thursday,12:30 PM,26,10,10,19,12,77,1/23/2020
2020-01-23,Thursday,1:30 PM,6,8,29,5,4,52,1/23/2020
2020-01-23,Thursday,2:30 PM,19,10,15,14,2,60,1/23/2020
2020-01-23,Thursday,3:30 PM,17,5,22,8,3,55,1/23/2020
2020-01-23,Thursday,5:30 PM,12,6,6,8,6,38,1/23/2020
2020-01-23,Thursday,6:30 PM,10,0,3,4,2,19,1/23/2020
2020-01-23,Thursday,7:30 PM,10,0,1,5,0,16,1/23/2020
2020-01-23,Thursday,8:30 PM,9,2,1,1,0,13,1/23/2020
2020-01-24,Friday,8:30 AM,5,2,4,2,3,16,1/24/2020
2020-01-24,Friday,9:30 AM,6,1,3,3,0,13,1/24/2020
2020-01-24,Friday,10:30 AM,8,2,8,4,0,22,1/24/2020
2020-01-24,Friday,11:30 AM,13,0,7,4,1,25,1/24/2020
2020-01-24,Friday,12:30 PM,25,3,10,5,2,45,1/24/2020
2020-01-24,Friday,1:30 PM,10,3,8,3,1,25,1/24/2020
2020-01-24,Friday,1:30 PM,10,2,5,5,1,23,1/24/2020
2020-01-24,Friday,2:30 PM,10,2,5,5,1,23,1/24/2020
2020-01-25,Saturday,10:30 AM,0,0,0,2,0,2,1/25/2020
2020-01-25,Saturday,11:30 AM,3,0,0,0,0,3,1/25/2020
2020-01-25,Saturday,12:30 PM,6,0,20,0,1,27,1/25/2020
2020-01-25,Saturday,12:30 PM,4,0,12,0,0,16,1/25/2020
2020-01-25,Saturday,1:30 PM,5,0,20,0,1,26,1/25/2020
2020-01-27,Monday,8:30 AM,20,4,2,3,8,37,1/27/2020
2020-01-27,Monday,9:30 AM,22,6,6,6,6,46,1/27/2020
2020-01-27,Monday,10:30 AM,28,6,6,6,8,54,1/27/2020
2020-01-27,Monday,12:30 PM,34,18,9,22,6,89,1/27/2020
2020-01-27,Monday,1:30 PM,10,3,36,7,3,59,1/27/2020
2020-01-27,Monday,2:30 PM,21,8,7,8,3,47,1/27/2020
2020-01-27,Monday,3:30 PM,17,3,10,7,1,38,1/27/2020
2020-01-27,Monday,5:30 PM,12,1,4,7,4,28,1/27/2020
2020-01-27,Monday,6:30 PM,3,1,4,2,2,12,1/27/2020
2020-01-27,Monday,7:30 PM,5,0,3,2,0,10,1/27/2020
2020-01-28,Tuesday,8:30 AM,6,2,3,2,5,18,1/28/2020
2020-01-28,Tuesday,9:30 AM,18,6,6,6,6,42,1/28/2020
2020-01-28,Tuesday,10:30 AM,12,6,6,12,6,42,1/28/2020
2020-01-28,Tuesday,5:30 PM,12,7,2,10,4,35,1/28/2020
2020-01-28,Tuesday,6:30 PM,3,1,8,3,0,15,1/28/2020
2020-01-28,Tuesday,7:30 PM,2,1,0,1,0,4,1/28/2020
2020-01-28,Tuesday,8:30 PM,4,0,1,4,1,10,1/28/2020
2020-01-29,Wednesday,8:30 AM,7,2,2,7,2,20,1/29/2020
2020-01-29,Wednesday,9:30 AM,10,6,4,6,2,28,1/29/2020
2020-01-29,Wednesday,10:30 AM,15,6,6,11,6,44,1/29/2020
2020-01-29,Wednesday,11:30 AM,28,6,11,9,3,57,1/29/2020
2020-01-29,Wednesday,12:30 PM,35,20,10,20,5,90,1/29/2020
2020-01-29,Wednesday,3:30 PM,29,14,8,10,4,65,1/29/2020
2020-01-29,Wednesday,5:30 PM,20,7,9,9,6,51,1/29/2020
2020-01-29,Wednesday,6:30 PM,10,2,9,5,1,27,1/29/2020
2020-01-29,Wednesday,7:30 PM,7,0,9,6,1,23,1/29/2020
2020-01-29,Wednesday,8:30 PM,4,0,3,4,0,11,1/29/2020
2020-01-30,Thursday,8:30 AM,15,4,4,6,2,31,1/30/2020
2020-01-30,Thursday,9:30 AM,15,4,4,6,6,35,1/30/2020
2020-01-30,Thursday,10:30 AM,15,8,8,9,9,49,1/30/2020
2020-01-30,Thursday,4:30 PM,21,5,8,11,1,46,1/30/2020
2020-01-30,Thursday,5:30 PM,15,3,6,7,3,34,1/30/2020
2020-01-30,Thursday,6:30 PM,10,1,3,3,2,19,1/30/2020
2020-01-30,Thursday,7:30 PM,8,0,3,4,1,16,1/30/2020
2020-01-30,Thursday,8:30 PM,6,1,0,2,1,10,1/30/2020
2020-01-31,Friday,8:30 AM,21,4,0,6,1,32,1/31/2020
2020-02-01,Saturday,11:30 AM,6,0,3,0,0,9,2/1/2020
2020-02-01,Saturday,12:30 PM,6,1,4,0,1,12,2/1/2020
2020-02-01,Saturday,1:30 PM,3,0,0,1,0,4,2/1/2020
2020-02-03,Monday,8:30 AM,18,4,4,8,3,37,2/3/2020
2020-02-03,Monday,9:30 AM,18,8,3,2,6,37,2/3/2020
2020-02-03,Monday,10:30 AM,20,10,4,8,10,52,2/3/2020
2020-02-03,Monday,12:30 PM,29,22,16,15,4,86,2/3/2020
2020-02-03,Monday,1:30 PM,15,6,33,12,2,68,2/3/2020
2020-02-03,Monday,2:30 PM,14,3,2,9,2,30,2/3/2020
2020-02-03,Monday,3:30 PM,14,3,6,10,4,37,2/3/2020
2020-02-03,Monday,4:30 PM,23,3,5,11,2,44,2/3/2020
2020-02-03,Monday,5:30 PM,21,5,3,4,3,36,2/3/2020
2020-02-03,Monday,6:30 PM,14,1,2,2,1,20,2/3/2020
2020-02-03,Monday,7:30 PM,10,0,2,2,1,15,2/3/2020
2020-02-03,Monday,8:30 PM,6,1,0,1,0,8,2/3/2020
2020-02-04,Tuesday,8:30 AM,14,2,0,7,6,29,2/4/2020
2020-02-04,Tuesday,9:30 AM,12,4,1,6,3,26,2/4/2020
2020-02-04,Tuesday,10:30 AM,20,4,3,6,8,41,2/4/2020
2020-02-04,Tuesday,5:30 PM,17,5,3,10,5,40,2/4/2020
2020-02-04,Tuesday,6:30 PM,5,1,8,4,1,19,2/4/2020
2020-02-04,Tuesday,7:30 PM,7,1,5,4,0,17,2/4/2020
2020-02-04,Tuesday,8:30 PM,5,1,3,4,3,16,2/4/2020
2020-02-06,Thursday,8:30 AM,10,2,1,3,2,18,2/6/2020
2020-02-06,Thursday,9:30 AM,15,4,4,10,3,36,2/6/2020
2020-02-06,Thursday,10:30 AM,20,1,8,3,10,42,2/6/2020
2020-02-06,Thursday,5:30 PM,13,14,7,10,4,48,2/6/2020
2020-02-06,Thursday,6:30 PM,6,2,3,6,2,19,2/6/2020
2020-02-06,Thursday,7:30 PM,7,1,2,5,2,17,2/6/2020
2020-02-06,Thursday,8:30 PM,6,4,1,2,1,14,2/6/2020
2020-02-07,Friday,8:30 AM,8,3,3,6,1,21,2/7/2020
2020-02-07,Friday,9:30 AM,18,4,6,6,3,37,2/7/2020
2020-02-07,Friday,10:30 AM,20,10,8,8,4,50,2/7/2020
2020-02-08,Saturday,10:30 AM,0,0,0,0,0,0,2/8/2020
2020-02-08,Saturday,11:30 AM,4,0,0,0,1,5,2/8/2020
2020-02-08,Saturday,12:30 PM,2,0,4,2,1,9,2/8/2020
2020-02-08,Saturday,1:30 PM,4,0,2,0,2,8,2/8/2020
2020-02-10,Monday,8:30 AM,4,1,1,5,6,17,2/10/2020
2020-02-10,Monday,9:30 AM,8,8,4,3,12,35,2/10/2020
2020-02-10,Monday,10:30 AM,8,4,5,12,6,35,2/10/2020
2020-02-10,Monday,1:30 PM,12,7,13,7,2,41,2/10/2020
2020-02-10,Monday,2:30 PM,29,9,13,9,3,63,2/10/2020
2020-02-10,Monday,3:30 PM,18,7,23,11,3,62,2/10/2020
2020-02-10,Monday,4:30 PM,19,9,10,9,4,51,2/10/2020
2020-02-10,Monday,7:30 PM,9,0,7,3,0,19,2/10/2020
2020-02-11,Tuesday,8:30 AM,7,2,3,10,6,28,2/11/2020
2020-02-11,Tuesday,9:30 AM,10,12,10,12,5,49,2/11/2020
2020-02-11,Tuesday,10:30 AM,23,10,8,16,6,63,2/11/2020
2020-02-12,Wednesday,8:30 AM,10,4,2,3,6,25,2/12/2020
2020-02-12,Wednesday,9:30 AM,13,6,1,6,3,29,2/12/2020
2020-02-12,Wednesday,10:30 AM,26,10,1,12,10,59,2/12/2020
2020-02-13,Thursday,8:30 AM,15,4,2,4,4,29,2/13/2020
2020-02-13,Thursday,9:30 AM,15,6,6,6,6,39,2/13/2020
2020-02-13,Thursday,10:30 AM,15,6,6,6,6,39,2/13/2020
2020-02-13,Thursday,5:30 PM,11,7,28,6,2,54,2/13/2020
2020-02-13,Thursday,6:30 PM,7,2,7,4,0,20,2/13/2020
2020-02-13,Thursday,7:30 PM,11,3,6,1,0,21,2/13/2020
2020-02-13,Thursday,8:30 PM,8,1,2,0,0,11,2/13/2020
2020-02-14,Friday,8:30 AM,8,1,4,1,1,15,2/14/2020
2020-02-14,Friday,9:30 AM,6,5,4,3,2,20,2/14/2020
2020-02-14,Friday,10:30 AM,6,2,3,6,2,19,2/14/2020
2020-02-14,Friday,11:30 AM,10,6,6,6,3,31,2/14/2020
2020-02-15,Saturday,10:30 AM,1,1,1,0,0,3,2/15/2020
2020-02-15,Saturday,11:30 AM,5,1,1,0,1,8,2/15/2020
2020-02-15,Saturday,12:30 PM,7,0,1,1,0,9,2/15/2020
2020-02-17,Monday,8:30 AM,10,2,4,4,5,25,2/17/2020
2020-02-17,Monday,9:30 AM,30,9,4,6,6,55,2/17/2020
2020-02-17,Monday,10:30 AM,30,10,8,10,6,64,2/17/2020
2020-02-17,Monday,5:30 PM,19,6,3,3,2,33,2/17/2020
2020-02-17,Monday,6:30 PM,13,3,2,4,1,23,2/17/2020
2020-02-17,Monday,7:30 PM,8,1,2,4,1,16,2/17/2020
2020-02-17,Monday,8:30 PM,6,2,0,1,1,10,2/17/2020
2020-02-18,Tuesday,8:30 AM,12,4,3,6,5,30,2/18/2020
2020-02-18,Tuesday,9:30 AM,30,12,8,9,6,65,2/18/2020
2020-02-18,Tuesday,5:30 PM,18,2,3,4,4,31,2/18/2020
2020-02-18,Tuesday,7:30 PM,9,1,10,5,2,27,2/18/2020
2020-02-18,Tuesday,8:30 PM,6,1,0,5,0,12,2/18/2020
2020-02-19,Wednesday,8:30 AM,12,4,6,4,3,29,2/19/2020
2020-02-19,Wednesday,9:30 AM,8,4,5,8,6,31,2/19/2020
2020-02-19,Wednesday,10:30 AM,20,8,4,8,4,44,2/19/2020
2020-02-19,Wednesday,5:30 PM,14,9,7,6,2,38,2/19/2020
2020-02-19,Wednesday,6:30 PM,12,1,6,3,2,24,2/19/2020
2020-02-20,Thursday,8:30 AM,8,3,4,6,2,23,2/20/2020
2020-02-20,Thursday,9:30 AM,5,5,3,6,3,22,2/20/2020
2020-02-20,Thursday,10:30 AM,20,8,4,8,4,44,2/20/2020
2020-02-20,Thursday,12:30 PM,31,15,4,16,6,72,2/20/2020
2020-02-20,Thursday,1:30 PM,17,9,8,11,4,49,2/20/2020
2020-02-20,Thursday,2:30 PM,18,9,10,9,3,49,2/20/2020
2020-02-20,Thursday,3:30 PM,22,6,8,11,3,50,2/20/2020
2020-02-20,Thursday,5:30 PM,7,4,14,7,3,35,2/20/2020
2020-02-20,Thursday,6:30 PM,4,3,5,7,1,20,2/20/2020
2020-02-20,Thursday,7:30 PM,9,4,8,6,2,29,2/20/2020
2020-02-20,Thursday,8:30 PM,7,3,4,3,1,18,2/20/2020
2020-02-21,Friday,8:30 AM,8,4,2,4,1,19,2/21/2020
2020-02-21,Friday,9:30 AM,6,2,4,6,3,21,2/21/2020
2020-02-21,Friday,10:30 AM,10,6,5,6,1,28,2/21/2020
2020-02-22,Saturday,11:30 AM,4,1,2,0,1,8,2/22/2020
2020-02-22,Saturday,1:30 PM,4,0,1,1,0,6,2/22/2020
2020-02-22,Saturday,1:30 PM,4,0,1,1,0,6,2/22/2020
2020-02-24,Monday,8:30 AM,14,4,6,8,3,35,2/24/2020
2020-02-24,Monday,9:30 AM,22,10,1,10,2,45,2/24/2020
2020-02-24,Monday,10:30 AM,26,8,6,10,5,55,2/24/2020
2020-02-24,Monday,12:30 PM,33,10,14,14,7,78,2/24/2020
2020-02-24,Monday,2:30 PM,9,3,16,5,2,35,2/24/2020
2020-02-24,Monday,1:30 PM,13,6,8,11,3,41,2/24/2020
2020-02-24,Monday,3:30 PM,17,2,8,5,2,34,2/24/2020
2020-02-24,Monday,4:30 PM,14,3,1,12,2,32,2/24/2020
2020-02-24,Monday,5:30 PM,10,5,10,8,4,37,2/24/2020
2020-02-24,Monday,6:30 PM,15,2,3,2,2,24,2/24/2020
2020-02-24,Monday,6:30 PM,16,2,2,2,1,23,2/24/2020
2020-02-24,Monday,8:30 PM,5,2,3,4,0,14,2/24/2020
2020-02-25,Tuesday,8:30 AM,12,5,8,10,4,39,2/25/2020
2020-02-25,Tuesday,9:30 AM,25,10,10,12,4,61,2/25/2020
2020-02-25,Tuesday,10:30 AM,12,10,10,8,3,43,2/25/2020
2020-02-25,Tuesday,12:30 PM,22,8,22,13,3,68,2/25/2020
2020-02-25,Tuesday,12:30 PM,27,19,17,18,8,89,2/25/2020
2020-02-25,Tuesday,3:30 PM,22,10,11,12,3,58,2/25/2020
2020-02-25,Tuesday,4:30 PM,17,8,13,15,5,58,2/25/2020
2020-02-25,Tuesday,5:30 PM,9,6,3,5,3,26,2/25/2020
2020-02-25,Tuesday,6:30 PM,4,2,6,3,1,16,2/25/2020
2020-02-25,Tuesday,7:30 PM,7,1,7,1,0,16,2/25/2020
2020-02-25,Tuesday,8:30 PM,5,0,3,3,1,12,2/25/2020
2020-02-26,Wednesday,8:30 AM,8,3,3,8,3,25,2/26/2020
2020-02-26,Wednesday,9:30 AM,12,4,5,8,4,33,2/26/2020
2020-02-26,Wednesday,1:30 PM,13,8,12,10,3,46,2/26/2020
2020-02-26,Wednesday,2:30 PM,15,10,8,9,3,45,2/26/2020
2020-02-26,Wednesday,3:30 PM,12,6,11,8,4,41,2/26/2020
2020-02-26,Wednesday,4:30 PM,9,2,28,9,3,51,2/26/2020
2020-02-26,Wednesday,5:30 PM,16,5,17,8,2,48,2/26/2020
2020-02-26,Wednesday,7:30 PM,12,0,9,1,1,23,2/26/2020
2020-02-27,Thursday,8:30 AM,8,4,1,3,2,18,2/27/2020
2020-02-27,Thursday,9:30 AM,8,5,2,8,5,28,2/27/2020
2020-02-27,Thursday,10:30 AM,12,6,4,6,5,33,2/27/2020
2020-02-27,Thursday,12:30 PM,31,14,16,18,3,82,2/27/2020
2020-02-27,Thursday,2:30 PM,12,5,17,12,2,48,2/27/2020
2020-02-27,Thursday,3:30 PM,12,4,10,11,1,38,2/27/2020
2020-02-27,Thursday,4:30 PM,21,3,5,17,2,48,2/27/2020
2020-02-27,Thursday,5:30 PM,12,5,9,11,3,40,2/27/2020
2020-02-27,Thursday,6:30 PM,4,1,10,1,1,17,2/27/2020
2020-02-27,Thursday,7:30 PM,7,0,8,1,1,17,2/27/2020
2020-02-27,Thursday,8:30 PM,6,0,6,1,0,13,2/27/2020
2020-02-27,Thursday,8:30 PM,6,0,6,1,0,13,2/27/2020
2020-02-28,Friday,8:30 AM,11,4,4,5,3,27,2/28/2020
2020-02-28,Friday,9:30 AM,6,6,5,4,2,23,2/28/2020
2020-02-29,Saturday,12:30 PM,6,0,12,5,0,23,2/29/2020
2020-02-29,Saturday,1:30 PM,2,1,11,2,2,18,2/29/2020
2020-03-02,Monday,8:30 AM,12,4,2,6,3,27,3/2/2020
2020-03-02,Monday,9:30 AM,20,8,4,6,3,41,3/2/2020
2020-03-02,Monday,12:30 PM,31,10,21,27,9,98,3/2/2020
2020-03-02,Monday,1:30 PM,8,2,28,11,2,51,3/2/2020
2020-03-02,Monday,2:30 PM,20,3,10,9,3,45,3/2/2020
2020-03-02,Monday,3:30 PM,17,5,22,9,3,56,3/2/2020
2020-03-02,Monday,4:30 PM,16,2,9,15,3,45,3/2/2020
2020-03-02,Monday,5:30 PM,15,5,18,11,1,50,3/2/2020
2020-03-02,Monday,6:30 PM,2,3,7,4,2,18,3/2/2020
2020-03-02,Monday,7:30 PM,8,1,6,6,2,23,3/2/2020
2020-03-03,Tuesday,8:30 AM,12,4,2,6,3,27,3/3/2020
2020-03-03,Tuesday,9:30 AM,30,10,6,12,5,63,3/3/2020
2020-03-03,Tuesday,10:30 AM,34,10,8,12,6,70,3/3/2020
2020-03-03,Tuesday,5:30 PM,18,6,30,8,5,67,3/3/2020
2020-03-03,Tuesday,6:30 PM,5,1,5,2,1,14,3/3/2020
2020-03-03,Tuesday,3:30 PM,8,1,9,4,0,22,3/3/2020
2020-03-03,Tuesday,8:30 PM,6,0,8,2,1,17,3/3/2020
2020-03-04,Wednesday,8:30 AM,10,4,2,6,2,24,3/4/2020
2020-03-04,Wednesday,9:30 AM,12,4,2,6,2,26,3/4/2020
2020-03-04,Wednesday,10:30 AM,18,6,1,3,4,32,3/4/2020
2020-03-04,Wednesday,4:30 PM,16,4,2,13,3,38,3/4/2020
2020-03-04,Wednesday,5:30 PM,10,6,9,8,3,36,3/4/2020
2020-03-04,Wednesday,6:30 PM,8,0,9,4,1,22,3/4/2020
2020-03-05,Thursday,8:30 AM,8,2,4,3,2,19,3/5/2020
2020-03-05,Thursday,9:30 AM,10,2,6,12,2,32,3/5/2020
2020-03-05,Thursday,11:30 AM,18,9,14,17,5,63,3/5/2020
2020-03-05,Thursday,12:30 PM,36,17,11,11,4,79,3/5/2020
2020-03-05,Thursday,1:30 PM,11,4,10,7,1,33,3/5/2020
2020-03-05,Thursday,2:30 PM,13,14,9,7,2,45,3/5/2020
2020-03-05,Thursday,3:30 PM,15,13,16,10,1,55,3/5/2020
2020-03-05,Thursday,1:30 PM,11,12,28,8,1,60,3/5/2020
2020-03-05,Thursday,5:30 PM,8,1,20,7,2,38,3/5/2020
2020-03-05,Thursday,6:30 PM,8,3,14,4,0,29,3/5/2020
2020-03-05,Thursday,7:30 PM,6,1,8,2,0,17,3/5/2020
2020-03-06,Friday,8:30 AM,8,2,2,6,1,19,3/6/2020
2020-03-06,Friday,9:30 AM,6,4,6,5,2,23,3/6/2020
2020-03-06,Friday,10:30 AM,10,5,8,5,2,30,3/6/2020
2020-03-07,Saturday,11:30 AM,6,0,10,1,0,17,3/7/2020
2020-03-07,Saturday,1:30 PM,7,0,3,0,0,10,3/7/2020
2020-03-09,Monday,8:30 AM,10,5,4,10,3,32,3/9/2020
2020-03-09,Monday,9:30 AM,10,5,4,12,2,33,3/9/2020
2020-03-09,Monday,10:30 AM,22,6,6,10,3,47,3/9/2020
2020-03-09,Monday,12:30 PM,36,18,11,20,6,91,3/9/2020
2020-03-09,Monday,1:30 PM,8,4,7,9,3,31,3/9/2020
2020-03-09,Monday,3:30 PM,13,3,14,8,5,43,3/9/2020
2020-03-09,Monday,3:30 PM,12,3,10,6,1,32,3/9/2020
2020-03-09,Monday,4:30 PM,12,3,10,6,1,32,3/9/2020
2020-03-09,Monday,5:30 PM,13,7,9,3,1,33,3/9/2020
2020-03-09,Monday,6:30 PM,4,2,6,2,0,14,3/9/2020
2020-03-09,Monday,8:30 PM,3,0,1,1,2,7,3/9/2020
2020-03-10,Tuesday,8:30 AM,6,4,2,6,1,19,3/10/2020
2020-03-10,Tuesday,9:30 AM,12,10,4,6,4,36,3/10/2020
2020-03-10,Tuesday,10:30 AM,29,10,8,10,1,58,3/10/2020
2020-03-10,Tuesday,12:30 PM,19,14,13,18,6,70,3/10/2020
2020-03-10,Tuesday,1:30 PM,10,6,14,9,3,42,3/10/2020
2020-03-10,Tuesday,2:30 PM,17,2,29,6,3,57,3/10/2020
2020-03-10,Tuesday,4:30 PM,17,10,21,12,3,63,3/10/2020
2020-03-10,Tuesday,5:30 PM,17,7,6,7,3,40,3/10/2020
2020-03-11,Wednesday,8:30 AM,12,6,3,5,2,28,3/11/2020
2020-03-11,Wednesday,9:30 AM,8,6,1,5,4,24,3/11/2020
2020-03-11,Wednesday,10:30 AM,16,9,2,5,4,36,3/11/2020
2020-03-11,Wednesday,4:30 PM,7,2,11,15,1,36,3/11/2020
2020-03-11,Wednesday,5:30 PM,12,1,8,7,3,31,3/11/2020
2020-03-11,Wednesday,6:30 PM,7,1,2,4,2,16,3/11/2020
2020-03-11,Wednesday,7:30 PM,2,0,0,2,1,5,3/11/2020
2020-03-12,Thursday,8:30 AM,3,1,0,1,0,5,3/12/2020
2020-03-12,Thursday,9:30 AM,12,8,3,6,2,31,3/12/2020
2020-03-12,Thursday,10:30 AM,20,10,8,8,3,49,3/12/2020
2020-03-12,Thursday,11:30 PM,18,9,8,11,2,48,3/12/2020
2020-03-12,Thursday,2:30 PM,9,5,11,3,2,30,3/12/2020
2020-03-12,Thursday,3:30 PM,5,4,11,10,2,32,3/12/2020
2020-03-12,Thursday,4:30 PM,7,2,12,9,2,32,3/12/2020
2020-03-13,Friday,8:30 AM,6,5,2,0,1,14,3/13/2020
2020-03-13,Friday,9:30 AM,4,3,1,2,1,11,3/13/2020
2020-09-25,Friday,7:30 AM,0,0,0,1,0,1,9/25/2020
2020-09-25,Friday,8:30 AM,0,0,0,1,0,1,9/25/2020
2020-09-25,Friday,9:30 AM,1,0,0,1,0,2,9/25/2020
2020-09-25,Friday,10:30 AM,2,1,0,2,0,5,9/25/2020
2020-09-25,Friday,11:30 AM,2,1,1,2,1,7,9/25/2020
2020-09-28,Monday,8:30 AM,2,1,0,1,1,5,9/28/2020
2020-09-28,Monday,9:30 AM,4,4,3,1,3,15,9/28/2020
2020-09-28,Monday,10:30 AM,6,3,4,4,2,19,9/28/2020
2020-09-28,Monday,11:30 AM,9,0,2,3,2,16,9/28/2020
2020-09-28,Monday,1:30 PM,3,2,0,2,0,7,9/28/2020
2020-09-28,Monday,2:30 PM,2,0,0,2,0,4,9/28/2020
2020-09-28,Monday,3:30 PM,1,0,4,1,1,7,9/28/2020
2020-09-28,Monday,3:30 PM,4,0,1,2,1,8,9/28/2020
2020-09-28,Monday,4:30 PM,2,1,1,1,2,7,9/28/2020
2020-09-28,Monday,5:30 PM,2,1,1,2,1,7,9/28/2020
2020-09-28,Monday,6:30 PM,2,0,3,0,0,5,9/28/2020
2020-09-28,Monday,7:30 PM,1,0,3,1,0,5,9/28/2020
2020-09-29,Tuesday,8:30 AM,0,1,0,1,1,3,9/29/2020
2020-09-29,Tuesday,9:30 AM,2,2,2,2,1,9,9/29/2020
2020-09-29,Tuesday,11:30 AM,3,3,1,4,2,13,9/29/2020
2020-09-29,Tuesday,12:30 PM,8,5,2,3,1,19,9/29/2020
2020-09-29,Tuesday,1:30 PM,0,1,0,4,1,6,9/29/2020
2020-09-29,Tuesday,2:30 PM,2,3,2,2,2,11,9/29/2020
2020-09-29,Tuesday,3:30 PM,1,1,4,5,1,12,9/29/2020
2020-09-29,Tuesday,4:30 PM,3,2,5,3,1,14,9/29/2020
2020-09-29,Tuesday,5:30 PM,6,2,3,2,0,13,9/29/2020
2020-09-29,Tuesday,7:30 PM,3,0,2,2,0,7,9/29/2020
2020-09-30,Wednesday,8:30 AM,2,0,0,2,0,4,9/30/2020
2020-09-30,Wednesday,9:30 AM,3,6,1,2,3,15,9/30/2020
2020-09-30,Wednesday,11:30 AM,7,2,3,3,1,16,9/30/2020
2020-09-30,Wednesday,12:30 PM,8,3,2,2,1,16,9/30/2020
2020-09-30,Wednesday,1:30 PM,2,2,0,1,0,5,9/30/2020
2020-09-30,Wednesday,1:30 PM,2,1,0,1,0,4,9/30/2020
2020-09-30,Wednesday,2:30 PM,4,1,0,1,0,6,9/30/2020
2020-09-30,Wednesday,4:30 PM,3,0,0,2,0,5,9/30/2020
2020-09-30,Wednesday,5:30 PM,3,0,0,2,1,6,9/30/2020
2020-09-30,Wednesday,7:30 PM,3,0,0,0,0,3,9/30/2020
2020-10-01,Thursday,7:30 AM,1,1,1,1,1,5,10/1/2020
2020-10-01,Thursday,8:30 AM,4,2,1,2,1,10,10/1/2020
2020-10-01,Thursday,9:30 AM,2,2,1,3,2,10,10/1/2020
2020-10-01,Thursday,10:30 AM,3,2,1,2,2,10,10/1/2020
2020-10-01,Thursday,11:30 AM,3,2,1,3,2,11,10/1/2020
2020-10-01,Thursday,12:30 PM,4,4,2,3,4,17,10/1/2020
2020-10-01,Thursday,1:30 PM,2,1,1,3,1,8,10/1/2020
2020-10-01,Thursday,2:30 PM,2,3,1,2,1,9,10/1/2020
2020-10-01,Thursday,3:30 PM,4,0,0,2,0,6,10/1/2020
2020-10-01,Thursday,4:30 PM,3,0,1,0,0,4,10/1/2020
2020-10-01,Thursday,5:30 PM,2,0,1,2,1,6,10/1/2020
2020-10-02,Friday,8:30 AM,0,0,0,0,1,1,10/2/2020
2020-10-02,Friday,9:30 AM,1,0,0,0,1,2,10/2/2020
2020-10-02,Friday,10:30 AM,0,0,0,0,1,1,10/2/2020
2020-10-02,Friday,11:30 AM,2,1,0,0,1,4,10/2/2020
2020-10-02,Friday,1:30 PM,1,0,4,0,0,5,10/2/2020
2020-10-02,Friday,12:30 PM,0,0,3,1,1,5,10/2/2020
2020-10-02,Friday,3:30 PM,0,0,3,1,1,5,10/2/2020
2020-10-05,Monday,7:30 AM,1,0,0,0,1,2,10/5/2020
2020-10-05,Monday,8:30 AM,2,0,0,1,1,4,10/5/2020
2020-10-05,Monday,9:30 AM,3,0,0,1,2,6,10/5/2020
2020-10-05,Monday,10:30 AM,4,1,1,1,1,8,10/5/2020
2020-10-05,Monday,11:30 AM,12,3,2,2,2,21,10/5/2020
2020-10-05,Monday,1:30 PM,5,2,3,1,1,12,10/5/2020
2020-10-05,Monday,2:30 PM,3,1,4,1,0,9,10/5/2020
2020-10-05,Monday,3:30 PM,7,2,3,2,1,15,10/5/2020
2020-10-05,Monday,4:30 PM,6,3,1,3,2,15,10/5/2020
2020-10-05,Monday,5:30 PM,3,1,2,0,2,8,10/5/2020
2020-10-05,Monday,6:30 PM,1,0,0,0,1,2,10/5/2020
2020-10-05,Monday,7:30 PM,3,0,1,0,1,5,10/5/2020
2020-10-06,Tuesday,7:30 AM,0,0,0,0,0,0,10/6/2020
2020-10-06,Tuesday,8:30 AM,0,0,0,0,1,1,10/6/2020
2020-10-06,Tuesday,9:30 AM,2,2,2,2,2,10,10/6/2020
2020-10-06,Tuesday,10:30 AM,3,3,3,1,3,13,10/6/2020
2020-10-06,Tuesday,11:30 AM,3,2,1,5,4,15,10/6/2020
2020-10-06,Tuesday,11:30 AM,10,5,2,3,4,24,10/6/2020
2020-10-06,Tuesday,2:30 PM,5,1,0,3,0,9,10/6/2020
2020-10-06,Tuesday,4:30 PM,2,0,2,0,0,4,10/6/2020
2020-10-06,Tuesday,5:30 PM,5,0,1,0,0,6,10/6/2020
2020-10-06,Tuesday,6:30 PM,3,0,0,0,0,3,10/6/2020
2020-10-06,Tuesday,7:30 PM,0,0,0,1,0,1,10/6/2020
2020-10-07,Wednesday,8:30 AM,5,1,1,0,3,10,10/7/2020
2020-10-07,Wednesday,9:30 AM,7,5,0,3,3,18,10/7/2020
2020-10-07,Wednesday,10:30 AM,5,2,0,1,0,8,10/7/2020
2020-10-07,Wednesday,11:30 AM,6,5,6,3,1,21,10/7/2020
2020-10-07,Wednesday,1:30 PM,2,0,2,1,0,5,10/7/2020
2020-10-07,Wednesday,2:30 PM,2,0,1,3,1,7,10/7/2020
2020-10-07,Wednesday,4:30 PM,2,0,2,2,1,7,10/7/2020
2020-10-07,Wednesday,5:30 PM,2,0,2,2,1,7,10/7/2020
2020-10-07,Wednesday,6:30 PM,2,0,2,2,1,7,10/7/2020
2020-10-07,Wednesday,7:30 PM,0,0,0,2,0,2,10/7/2020
2020-10-08,Thursday,8:30 AM,0,0,0,1,1,2,10/8/2020
2020-10-08,Thursday,9:30 AM,2,1,2,4,0,9,10/8/2020
2020-10-08,Thursday,10:30 AM,6,1,1,2,2,12,10/8/2020
2020-10-08,Thursday,11:30 AM,3,2,0,5,4,14,10/8/2020
2020-10-08,Thursday,2:30 PM,5,0,1,3,1,10,10/8/2020
2020-10-08,Thursday,3:30 PM,3,0,0,1,0,4,10/8/2020
2020-10-08,Thursday,4:30 PM,2,0,1,0,0,3,10/8/2020
2020-10-08,Thursday,5:30 PM,5,0,1,0,0,6,10/8/2020
2020-10-08,Thursday,6:30 PM,1,0,1,0,1,3,10/8/2020
2020-10-08,Thursday,7:30 PM,0,0,1,0,0,1,10/8/2020
2020-10-09,Friday,8:30 AM,1,0,0,1,0,2,10/9/2020
2020-10-09,Friday,9:30 AM,1,0,1,0,0,2,10/9/2020
2020-10-09,Friday,10:30 AM,0,0,1,0,1,2,10/9/2020
2020-10-09,Friday,10:30 AM,4,0,0,0,0,4,10/9/2020
2020-10-09,Friday,11:30 AM,4,0,0,0,0,4,10/9/2020
2020-10-09,Friday,1:30 PM,0,2,2,0,0,4,10/9/2020
2020-10-09,Friday,3:30 PM,1,0,2,2,0,5,10/9/2020
2020-10-09,Friday,4:30 PM,2,0,1,0,0,3,10/9/2020
2020-10-10,Saturday,9:30 AM,0,0,0,0,0,0,10/10/2020
2020-10-10,Saturday,10:30 AM,2,0,0,1,0,3,10/10/2020
2020-10-10,Saturday,11:30 AM,1,0,0,0,0,1,10/10/2020
2020-10-10,Saturday,12:30 PM,1,0,0,0,0,1,10/10/2020
2020-10-10,Saturday,1:30 PM,3,0,0,0,0,3,10/10/2020
2020-10-10,Saturday,2:30 PM,1,0,0,0,0,1,10/10/2020
2020-10-12,Monday,8:30 AM,2,1,0,1,0,4,10/12/2020
2020-10-12,Monday,9:30 AM,7,4,1,1,2,15,10/12/2020
2020-10-12,Monday,10:30 AM,4,3,1,3,3,14,10/12/2020
2020-10-12,Monday,11:30 AM,10,1,2,3,3,19,10/12/2020
2020-10-12,Monday,12:30 PM,5,4,2,2,1,14,10/12/2020
2020-10-12,Monday,1:30 PM,8,2,2,3,0,15,10/12/2020
2020-10-12,Monday,2:30 AM,3,0,1,3,0,7,10/12/2020
2020-10-12,Monday,4:30 PM,4,0,2,1,0,7,10/12/2020
2020-10-12,Monday,5:30 PM,3,0,1,0,0,4,10/12/2020
2020-10-12,Monday,6:30 PM,0,0,0,0,0,0,10/12/2020
2020-10-12,Monday,7:30 PM,3,0,0,0,0,3,10/12/2020
2020-10-13,Tuesday,8:30 AM,1,1,1,0,1,4,10/13/2020
2020-10-13,Tuesday,10:30 AM,2,0,1,3,0,6,10/13/2020
2020-10-13,Tuesday,11:30 AM,6,3,2,4,3,18,10/13/2020
2020-10-13,Tuesday,1:30 PM,3,3,0,3,2,11,10/13/2020
2020-10-13,Tuesday,2:30 PM,3,1,3,3,1,11,10/13/2020
2020-10-13,Tuesday,3:30 PM,3,1,1,3,1,9,10/13/2020
2020-10-13,Tuesday,4:30 PM,3,1,2,2,0,8,10/13/2020
2020-10-13,Tuesday,5:30 PM,0,1,1,0,1,3,10/13/2020
2020-10-13,Tuesday,6:30 PM,2,0,0,0,0,2,10/13/2020
2020-10-13,Tuesday,7:30 PM,2,0,0,0,1,3,10/13/2020
2020-10-14,Wednesday,8:30 AM,1,1,1,0,0,3,10/14/2020
2020-10-14,Wednesday,9:30 AM,5,3,1,6,2,17,10/14/2020
2020-10-14,Wednesday,10:30 AM,3,0,2,3,2,10,10/14/2020
2020-10-14,Wednesday,11:30 AM,10,1,1,2,0,14,10/14/2020
2020-10-14,Wednesday,2:30 PM,3,2,0,3,2,10,10/14/2020
2020-10-14,Wednesday,3:30 PM,4,0,1,0,1,6,10/14/2020
2020-10-14,Wednesday,4:30 PM,3,0,1,0,0,4,10/14/2020
2020-10-14,Wednesday,5:30 PM,1,0,3,0,0,4,10/14/2020
2020-10-14,Wednesday,6:30 PM,5,0,4,0,1,10,10/14/2020
2020-10-14,Wednesday,7:30 PM,0,0,4,0,0,4,10/14/2020
2020-10-15,Thursday,8:30 AM,1,0,0,0,3,4,10/15/2020
2020-10-15,Thursday,9:30 AM,1,0,0,0,1,2,10/15/2020
2020-10-15,Thursday,10:30 AM,1,0,1,1,0,3,10/15/2020
2020-10-15,Thursday,11:30 AM,0,2,0,3,3,8,10/15/2020
2020-10-15,Thursday,1:30 PM,2,3,2,3,3,13,10/15/2020
2020-10-15,Thursday,2:30 PM,3,1,1,1,1,7,10/15/2020
2020-10-15,Thursday,3:30 PM,1,1,0,1,1,4,10/15/2020
2020-10-15,Thursday,4:30 PM,3,1,2,0,0,6,10/15/2020
2020-10-16,Friday,8:30 AM,0,0,0,1,0,1,10/16/2020
2020-10-16,Friday,10:30 AM,3,1,0,1,1,6,10/16/2020
2020-10-16,Friday,11:30 AM,2,1,2,2,2,9,10/16/2020
2020-10-16,Friday,1:30 PM,2,2,2,0,0,6,10/16/2020
2020-10-16,Friday,2:30 PM,1,0,2,1,0,4,10/16/2020
2020-10-16,Friday,3:30 PM,2,0,2,1,0,5,10/16/2020
2020-10-16,Friday,4:30 PM,0,0,1,1,0,2,10/16/2020
2020-10-17,Saturday,9:30 AM,0,0,1,0,0,1,10/17/2020
2020-10-17,Saturday,10:30 AM,0,0,1,0,0,1,10/17/2020
2020-10-17,Saturday,11:30 AM,1,0,2,0,0,3,10/17/2020
2020-10-17,Saturday,12:30 PM,1,0,2,0,0,3,10/17/2020
2020-10-17,Saturday,1:30 PM,0,0,2,0,0,2,10/17/2020
2020-10-19,Monday,8:30 AM,3,2,0,2,3,10,10/19/2020
2020-10-19,Monday,9:30 AM,4,0,2,1,3,10,10/19/2020
2020-10-19,Monday,10:30 AM,2,2,2,3,3,12,10/19/2020
2020-10-19,Monday,11:30 AM,8,4,3,5,2,22,10/19/2020
2020-10-19,Monday,12:30 PM,4,6,3,2,4,19,10/19/2020
2020-10-19,Monday,1:30 PM,4,1,3,2,1,11,10/19/2020
2020-10-19,Monday,2:30 PM,6,3,3,3,3,18,10/19/2020
2020-10-19,Monday,3:30 PM,1,0,2,3,0,6,10/19/2020
2020-10-19,Monday,4:30 PM,4,1,6,1,3,15,10/19/2020
2020-10-19,Monday,5:30 PM,4,3,5,2,3,17,10/19/2020
2020-10-19,Monday,5:30 PM,0,1,4,0,2,7,10/19/2020
2020-10-19,Monday,6:30 PM,2,1,2,0,1,6,10/19/2020
2020-10-19,Monday,7:30 PM,0,1,2,0,1,4,10/19/2020
2020-10-20,Tuesday,8:30 AM,1,0,1,0,1,3,10/20/2020
2020-10-20,Tuesday,9:30 AM,3,2,2,0,1,8,10/20/2020
2020-10-20,Tuesday,10:30 AM,4,2,3,4,2,15,10/20/2020
2020-10-20,Tuesday,11:30 AM,4,3,5,4,3,19,10/20/2020
2020-10-20,Tuesday,12:30 PM,9,3,7,4,3,26,10/20/2020
2020-10-20,Tuesday,1:30 PM,7,3,5,3,2,20,10/20/2020
2020-10-20,Tuesday,2:30 PM,5,3,2,1,2,13,10/20/2020
2020-10-20,Tuesday,3:30 PM,4,2,2,4,1,13,10/20/2020
2020-10-20,Tuesday,4:30 PM,3,0,1,1,1,6,10/20/2020
2020-10-20,Tuesday,5:30 PM,4,2,1,2,1,10,10/20/2020
2020-10-20,Tuesday,6:30 PM,2,0,1,1,0,4,10/20/2020
2020-10-20,Tuesday,7:30 PM,2,0,1,1,0,4,10/20/2020
2020-10-21,Wednesday,8:30 AM,3,2,0,3,1,9,10/21/2020
2020-10-21,Wednesday,9:30 AM,4,1,0,3,3,11,10/21/2020
2020-10-21,Wednesday,10:30 AM,2,1,0,2,1,6,10/21/2020
2020-10-21,Wednesday,4:30 PM,2,0,0,1,0,3,10/21/2020
2020-10-22,Thursday,9:30 AM,4,3,2,1,0,10,10/22/2020
2020-10-22,Thursday,10:30 AM,3,3,3,2,2,13,10/22/2020
2020-10-22,Thursday,11:30 AM,3,2,3,3,2,13,10/22/2020
2020-10-22,Thursday,12:30 PM,3,2,4,3,2,14,10/22/2020
2020-10-22,Thursday,1:30 PM,5,3,1,4,2,15,10/22/2020
2020-10-22,Thursday,4:30 PM,2,1,2,3,1,9,10/22/2020
2020-10-22,Thursday,5:30 PM,4,0,2,3,2,11,10/22/2020
2020-10-22,Thursday,6:30 PM,1,0,1,2,0,4,10/22/2020
2020-10-22,Thursday,7:30 PM,0,0,0,0,0,0,10/22/2020
2020-10-23,Friday,8:30 AM,1,0,0,1,0,2,10/23/2020
2020-10-23,Friday,9:30 AM,2,0,0,0,0,2,10/23/2020
2020-10-23,Friday,10:30 AM,1,0,1,2,1,5,10/23/2020
2020-10-23,Friday,12:30 PM,5,0,1,1,2,9,10/23/2020
2020-10-23,Friday,1:30 PM,2,1,4,0,0,7,10/23/2020
2020-10-23,Friday,2:30 PM,1,0,4,1,0,6,10/23/2020
2020-10-23,Friday,3:30 PM,1,1,1,1,0,4,10/23/2020
2020-10-23,Friday,4:30 PM,2,0,1,2,0,5,10/23/2020
2020-10-24,Saturday,9:30 AM,0,0,0,0,0,0,10/24/2020
2020-10-24,Saturday,10:30 AM,1,0,0,0,0,1,10/24/2020
2020-10-24,Saturday,11:30 AM,1,0,0,0,0,1,10/24/2020
2020-10-24,Saturday,12:30 PM,1,0,1,1,0,3,10/24/2020
2020-10-24,Saturday,1:30 PM,0,0,2,1,0,3,10/24/2020
2020-10-24,Saturday,2:30 PM,0,0,2,0,0,2,10/24/2020
2020-10-26,Monday,8:30 AM,2,1,0,4,1,8,10/26/2020
2020-10-26,Monday,9:30 AM,4,4,3,1,2,14,10/26/2020
2020-10-26,Monday,9:30 AM,4,4,3,1,2,14,10/26/2020
2020-10-26,Monday,9:30 AM,4,4,3,1,2,14,10/26/2020
2020-10-26,Monday,10:30 AM,3,4,2,1,2,12,10/26/2020
2020-10-26,Monday,11:30 AM,7,5,3,4,2,21,10/26/2020
2020-10-26,Monday,12:30 PM,1,1,2,4,2,10,10/26/2020
2020-10-26,Monday,2:30 PM,3,0,1,1,3,8,10/26/2020
2020-10-26,Monday,4:30 PM,5,1,1,2,0,9,10/26/2020
2020-10-26,Monday,4:30 PM,2,0,1,1,0,4,10/26/2020
2020-10-26,Monday,5:30 PM,4,0,2,1,0,7,10/26/2020
2020-10-26,Monday,6:30 PM,0,0,3,0,0,3,10/26/2020
2020-10-26,Monday,7:30 PM,2,0,0,0,0,2,10/26/2020
2020-10-27,Tuesday,8:30 AM,0,1,0,3,1,5,10/27/2020
2020-10-27,Tuesday,9:30 AM,2,3,1,3,4,13,10/27/2020
2020-10-27,Tuesday,10:30 AM,3,3,6,2,2,16,10/27/2020
2020-10-27,Tuesday,11:30 AM,2,1,5,3,2,13,10/27/2020
2020-10-27,Tuesday,12:30 PM,6,3,7,5,2,23,10/27/2020
2020-10-27,Tuesday,1:30 PM,3,2,7,5,1,18,10/27/2020
2020-10-27,Tuesday,2:30 PM,4,1,3,2,0,10,10/27/2020
2020-10-27,Tuesday,3:30 PM,4,2,3,3,1,13,10/27/2020
2020-10-27,Tuesday,4:30 PM,3,2,1,2,1,9,10/27/2020
2020-10-28,Wednesday,8:30 AM,4,1,0,1,0,6,10/28/2020
2020-10-28,Wednesday,9:30 AM,2,4,2,2,1,11,10/28/2020
2020-10-28,Wednesday,10:30 AM,4,3,2,2,1,12,10/28/2020
2020-10-29,Thursday,2:30 PM,2,2,4,5,1,14,10-29-2020 2:33:06
2020-10-29,Thursday,3:30 PM,1,0,5,4,0,10,10-29-2020 3:31:45
2020-10-29,Thursday,4:30 PM,0,0,5,1,1,7,10/29/2020
2020-10-29,Thursday,5:30 PM,3,0,2,0,2,7,10-29-2020 5:32:22
2020-10-30,Friday,9:30 AM,1,0,0,1,1,3,10-30-2020 9:32:21
2020-10-30,Friday,11:30 AM,0,0,0,2,0,2,10-30-2020 11:39:48
2020-10-30,Friday,12:30 PM,1,0,0,2,1,4,10-30-2020 12:36:06
2020-10-30,Friday,2:30 PM,2,0,0,0,1,3,10-30-2020 2:35:04
2020-10-30,Friday,3:30 PM,1,0,1,0,1,3,10-30-2020 3:31:53
2020-10-30,Friday,4:30 PM,1,0,1,0,0,2,10-30-2020 4:31:52
2020-11-02,Monday,10:30 AM,9,5,4,5,2,25,11-02-2020 12:33:20
2020-11-02,Monday,12:30 PM,9,5,4,5,2,25,11-02-2020 12:33:41
2020-11-02,Monday,1:30 PM,4,1,2,2,0,9,11/2/2020
2020-11-02,Monday,2:30 PM,7,0,2,0,0,9,11/2/2020
2020-11-02,Monday,4:30 PM,5,2,0,1,1,9,11-02-2020 4:31:27
2020-11-02,Monday,5:30 PM,4,0,1,0,0,5,11-02-2020 5:32:00
2020-11-04,Wednesday,12:30 PM,7,5,3,3,1,19,11-04-2020 12:32:02
2020-11-04,Wednesday,1:30 PM,3,0,2,3,0,8,11-04-2020 1:32:08
2020-11-04,Wednesday,4:30 PM,3,0,1,2,0,6,11-04-2020 4:31:38
2020-11-04,Wednesday,5:30 PM,5,0,1,2,1,9,11-04-2020 5:31:35
2020-11-05,Thursday,11:30 AM,3,2,2,2,4,13,11-05-2020 11:31:59
2020-11-05,Thursday,12:30 PM,4,4,2,2,6,18,11-05-2020 12:17:39
2020-11-05,Thursday,2:30 PM,3,1,2,3,4,13,11-05-2020 2:35:53
2020-11-05,Thursday,3:30 PM,2,1,0,2,3,8,11-05-2020 3:30:56
2020-11-05,Thursday,5:30 PM,3,1,3,0,0,7,11-05-2020 5:31:13
2020-11-06,Friday,11:30 AM,0,0,3,0,1,4,11-06-2020 11:49:57
2020-11-06,Friday,12:30 PM,2,0,3,2,1,8,11-06-2020 12:56:26
2020-11-06,Friday,1:30 PM,2,0,2,1,0,5,11-06-2020 1:30:32
2020-11-06,Friday,1:30 PM,0,0,3,0,0,3,11-06-2020 2:33:01
2020-11-06,Friday,4:30 PM,0,0,2,0,0,2,11-06-2020 4:26:54
2020-11-19,Thursday,1:30 PM,1,0,0,0,0,1,11/19/2020
2020-11-30,Monday,10:30 AM,1,1,0,0,0,2,11-30-2020 11:15:06
2020-11-30,Monday,11:30 AM,2,0,0,1,1,4,11-30-2020 12:34:51
2020-11-30,Monday,12:30 PM,1,0,0,0,1,2,11-30-2020 12:35:13
2020-11-30,Monday,1:30 PM,3,0,0,0,1,4,11-30-2020 1:32:32
2020-11-30,Monday,2:30 PM,2,0,2,0,1,5,11-30-2020 2:32:55
2020-11-30,Monday,3:30 PM,1,1,2,0,1,5,11-30-2020 3:32:54
2020-11-30,Monday,5:30 PM,0,1,1,0,0,2,11-30-2020 5:31:53
2020-12-01,Tuesday,11:30 AM,2,0,0,0,0,2,12-01-2020 11:32:03
2020-12-01,Tuesday,1:30 PM,3,0,0,1,0,4,12-01-2020 1:37:49
2020-12-01,Tuesday,2:30 PM,3,0,1,2,0,6,12-01-2020 2:32:47
2020-12-01,Tuesday,5:30 PM,0,1,1,0,0,2,12-01-2020 5:31:34
2020-12-02,Wednesday,2:30 PM,0,0,2,3,1,6,12-02-2020 2:34:43
2020-12-02,Wednesday,3:30 PM,0,0,0,2,1,3,12-02-2020 3:31:39
2020-12-02,Wednesday,5:30 PM,0,1,1,1,0,3,12-02-2020 5:31:31
2020-12-03,Thursday,12:30 PM,3,0,0,0,0,3,12-03-2020 12:31:22
2020-12-03,Thursday,2:30 PM,2,0,2,1,0,5,12-03-2020 2:34:06
2020-12-03,Thursday,3:30 PM,2,0,1,1,0,4,12-03-2020 3:31:59
2020-12-03,Thursday,4:30 PM,0,0,1,0,0,1,12-03-2020 4:33:49
2020-12-03,Thursday,4:30 PM,1,0,1,1,0,3,12-03-2020 4:48:19
2020-12-03,Thursday,5:30 PM,2,0,1,0,0,3,12-03-2020 5:31:14
2020-12-04,Friday,10:30 AM,1,0,1,0,0,2,12-04-2020 10:34:31
2020-12-04,Friday,11:30 AM,1,0,2,0,0,3,12-04-2020 11:51:19
2020-12-04,Friday,12:30 PM,2,0,2,0,0,4,12-04-2020 1:03:51
2020-12-04,Friday,3:30 PM,0,0,0,0,0,0,12-04-2020 3:31:54
2020-12-04,Friday,4:30 PM,1,0,1,0,0,2,12-04-2020 4:29:12
2020-12-09,Wednesday,11:30 AM,2,1,0,1,1,5,12-09-2020 12:34:31
2020-12-09,Wednesday,12:30 PM,3,3,1,1,1,9,12-09-2020 12:34:51
2020-12-09,Wednesday,2:30 PM,1,0,1,1,1,4,12-09-2020 2:33:45
2020-12-10,Thursday,11:30 PM,1,0,0,1,0,2,12-10-2020 12:37:52
2020-12-10,Thursday,12:30 PM,3,0,0,0,0,3,12-10-2020 12:38:55
2020-12-10,Thursday,1:30 PM,3,0,1,1,0,5,12-10-2020 1:30:25
2020-12-10,Thursday,2:30 PM,3,0,0,1,0,4,12-10-2020 2:27:32
2020-12-10,Thursday,4:30 PM,1,0,2,0,1,4,12-10-2020 4:31:06
2020-12-11,Friday,11:30 PM,3,0,1,0,0,4,12-11-2020 12:30:28
2020-12-11,Friday,12:30 PM,1,0,0,0,0,1,12-11-2020 12:30:43
2020-12-11,Friday,2:30 PM,1,0,2,0,0,3,12-11-2020 2:34:51
2020-12-11,Friday,4:30 PM,2,0,0,0,0,2,12-11-2020 3:31:33
2020-12-11,Friday,4:30 PM,3,0,0,0,0,3,12-11-2020 4:23:29
2021-01-19,Tuesday,10:30 AM,8,6,3,3,4,24,01-19-2021 10:53:15
2021-01-20,Wednesday,10:30 AM,4,3,3,5,4,19,01-20-2021 10:33:03
2021-01-20,Wednesday,11:30 AM,16,3,3,4,7,33,01-20-2021 11:32:01
2021-01-20,Wednesday,12:30 PM,8,6,2,5,3,24,01-20-2021 12:30:41
2021-01-20,Wednesday,3:30 PM,3,3,2,0,3,11,01-20-2021 3:43:17
2021-01-21,Thursday,12:30 PM,4,2,1,4,1,12,01-21-2021 12:51:45
2021-01-21,Thursday,1:30 PM,6,1,2,2,0,11,01-21-2021 1:39:07
2021-01-21,Thursday,2:30 PM,8,2,3,2,3,18,01-21-2021 2:31:48
2021-01-21,Thursday,3:30 PM,1,1,3,2,1,8,01-21-2021 3:31:53
2021-01-22,Friday,9:30 AM,0,0,0,0,0,0,01-22-2021 9:31:32
2021-01-22,Friday,12:30 PM,4,2,1,2,0,9,01-22-2021 12:45:52
2021-01-22,Friday,2:30 PM,6,0,1,0,0,7,01-22-2021 1:31:42
2021-01-22,Friday,2:30 PM,6,0,1,2,0,9,01-22-2021 2:30:35
2021-01-22,Friday,4:30 PM,5,0,1,0,0,6,01-22-2021 4:30:30
2021-01-25,Monday,3:30 PM,5,0,0,3,1,9,01-25-2021 3:39:16
2021-01-26,Tuesday,12:30 PM,6,7,2,4,4,23,01-26-2021 12:34:05
2021-01-26,Tuesday,1:30 PM,2,2,1,2,0,7,01-26-2021 1:31:37
2021-01-26,Tuesday,2:30 PM,1,2,0,2,2,7,01-26-2021 2:30:26
2021-01-27,Wednesday,10:30 AM,3,5,1,6,2,17,01-27-2021 10:31:54
2021-01-27,Wednesday,12:30 PM,10,11,2,6,4,33,01-27-2021 12:40:44
2021-01-27,Wednesday,1:30 PM,9,3,0,5,1,18,01-27-2021 1:32:19
2021-01-27,Wednesday,2:30 PM,10,1,1,2,2,16,01-27-2021 2:31:54
2021-01-28,Thursday,12:30 PM,1,3,3,4,2,13,01-28-2021 12:32:25
2021-01-28,Thursday,2:30 PM,3,4,1,3,0,11,01-28-2021 2:48:06
2021-01-28,Thursday,3:30 PM,8,2,2,1,3,16,01-28-2021 3:32:13
2021-01-29,Friday,11:30 PM,5,0,0,1,0,6,01-29-2021 12:06:14
2021-01-29,Friday,1:30 PM,3,2,0,2,0,7,01-29-2021 1:10:59
2021-01-29,Friday,2:30 PM,4,0,0,2,1,7,01-29-2021 1:30:29
2021-01-29,Friday,3:30 PM,4,0,0,2,1,7,01-29-2021 3:27:26
2021-01-29,Friday,4:30 PM,1,0,0,1,1,3,01-29-2021 4:37:22
2021-02-24,Wednesday,1:30 PM,3,1,1,2,2,9,02-24-2021 1:35:38
2021-02-24,Wednesday,2:30 PM,5,1,1,1,3,11,02-24-2021 2:38:40
2021-02-25,Thursday,12:30 PM,4,1,2,3,4,14,02-25-2021 12:49:10
2021-03-02,Tuesday,12:30 PM,5,6,2,4,4,21,03-02-2021 12:05:37
2021-03-08,Monday,11:30 AM,4,7,6,9,4,30,03-08-2021 11:32:37
2021-03-08,Monday,12:30 PM,8,1,4,1,1,15,03-08-2021 12:32:13
2021-03-08,Monday,1:30 PM,8,2,3,3,3,19,03-08-2021 1:32:02
2021-03-08,Monday,2:30 PM,4,2,3,3,2,14,03-08-2021 2:27:17
2021-03-08,Monday,3:30 PM,2,2,1,2,1,8,03-08-2021 3:32:22
2021-03-09,Tuesday,10:30 AM,5,0,2,1,1,9,03-09-2021 10:53:29
2021-03-09,Tuesday,11:30 AM,5,0,3,1,2,11,03-09-2021 11:42:16
2021-03-09,Tuesday,12:30 PM,4,2,2,0,2,10,03-09-2021 12:32:07
2021-03-09,Tuesday,1:30 PM,5,2,2,0,1,10,03-09-2021 1:32:02
2021-03-09,Tuesday,2:30 PM,3,1,1,2,2,9,03-09-2021 2:30:34
2021-03-09,Tuesday,3:30 PM,3,2,1,2,1,9,03-09-2021 3:30:27
2021-03-10,Wednesday,10:30 AM,7,2,2,3,2,16,03-10-2021 10:32:30
2021-03-10,Wednesday,11:30 AM,7,2,1,7,4,21,03-10-2021 11:35:27
2021-03-10,Wednesday,12:30 PM,8,5,3,5,3,24,03-10-2021 12:30:01
2021-03-10,Wednesday,1:30 PM,4,2,2,4,4,16,03-10-2021 1:32:10
2021-03-10,Wednesday,2:30 PM,4,2,0,4,2,12,03-10-2021 2:30:27
2021-03-10,Wednesday,3:30 PM,3,2,1,3,2,11,03-10-2021 4:00:20
2021-03-11,Thursday,9:30 AM,4,1,0,3,1,9,03-11-2021 9:29:39
2021-03-11,Thursday,10:30 AM,1,1,1,1,0,4,03-11-2021 10:30:30
2021-03-11,Thursday,11:30 AM,1,1,1,1,0,4,03-11-2021 11:32:38
2021-03-11,Thursday,12:30 PM,3,1,0,3,2,9,03-11-2021 12:27:49
2021-03-11,Thursday,1:30 PM,2,1,0,1,0,4,03-11-2021 1:35:51
2021-03-12,Friday,9:30 AM,2,1,0,0,1,4,03-12-2021 10:30:29
2021-03-12,Friday,12:30 AM,2,1,1,0,1,5,03-12-2021 1:30:27
2021-03-12,Friday,2:30 PM,3,0,1,2,0,6,03-12-2021 1:30:43
2021-03-12,Friday,3:30 PM,0,0,1,1,0,2,03-12-2021 3:43:40
2021-03-15,Monday,1:30 PM,3,1,1,1,1,7,03-15-2021 1:45:32
2021-03-15,Monday,2:30 PM,2,1,1,0,1,5,03-15-2021 2:32:15
2021-03-15,Monday,3:30 PM,1,1,2,0,1,5,03-15-2021 3:32:24
2021-03-15,Monday,4:30 PM,2,1,3,0,0,6,03-15-2021 4:32:06
2021-03-15,Monday,5:30 PM,4,0,0,0,0,4,03-15-2021 5:32:22
2021-03-16,Tuesday,1:30 PM,4,1,1,1,0,7,03-16-2021 1:38:51
2021-03-16,Tuesday,1:30 PM,1,0,0,0,1,2,03-16-2021 2:32:31
2021-03-16,Tuesday,2:30 PM,1,0,0,0,1,2,03-16-2021 2:33:31
2021-03-16,Tuesday,3:30 PM,1,0,1,0,1,3,03-16-2021 3:32:35
2021-03-16,Tuesday,4:30 PM,2,0,1,0,0,3,03-16-2021 4:35:11
2021-03-16,Tuesday,5:30 PM,5,0,0,0,0,5,03-16-2021 5:30:30
2021-03-17,Wednesday,1:30 PM,3,0,4,0,1,8,03-17-2021 1:35:11
2021-03-17,Wednesday,2:30 PM,3,1,4,1,0,9,03-17-2021 2:31:16
2021-03-17,Wednesday,3:30 PM,3,1,1,0,0,5,03-17-2021 3:32:08
2021-03-17,Wednesday,4:30 PM,3,1,0,0,0,4,03-17-2021 4:31:23
2021-03-17,Wednesday,5:30 PM,1,1,0,0,0,2,03-17-2021 5:27:58
2021-03-18,Thursday,1:30 PM,5,2,1,3,0,11,03-18-2021 1:36:40
2021-03-18,Thursday,2:30 PM,2,0,3,1,0,6,03-18-2021 2:32:51
2021-03-18,Thursday,3:30 PM,3,0,1,2,0,6,03-18-2021 3:30:41
2021-03-18,Thursday,4:30 PM,3,0,4,1,1,9,03-18-2021 4:28:18
2021-03-18,Thursday,5:30 PM,0,0,0,0,0,0,03-18-2021 5:30:28
2021-03-19,Friday,1:30 PM,3,2,0,2,0,7,03-19-2021 1:34:22
2021-03-19,Friday,2:30 PM,2,2,1,0,0,5,03-19-2021 2:33:41
2021-03-19,Friday,3:30 PM,1,3,1,0,1,6,03-19-2021 3:27:44
2021-03-19,Friday,4:30 PM,1,2,1,0,0,4,03-19-2021 4:27:04
2021-03-22,Monday,8:30 AM,0,0,0,0,0,0,03-22-2021 8:30:23
2021-03-22,Monday,10:30 AM,0,2,0,1,1,4,03-22-2021 10:47:11
2021-03-22,Monday,11:30 PM,2,2,0,1,1,6,03-22-2021 11:31:43
2021-03-22,Monday,12:30 PM,2,2,1,2,1,8,03-22-2021 12:28:45
2021-03-22,Monday,1:30 PM,2,1,2,1,1,7,03-22-2021 1:31:29
2021-03-22,Monday,1:30 PM,2,3,2,0,0,7,03-22-2021 2:32:08
2021-03-23,Tuesday,10:30 AM,3,0,2,0,1,6,03-23-2021 10:30:18
2021-03-23,Tuesday,11:30 AM,3,0,2,1,1,7,03-23-2021 11:30:20
2021-03-23,Tuesday,12:30 PM,2,0,2,2,1,7,03-23-2021 12:33:08
2021-03-23,Tuesday,1:30 PM,5,1,2,2,1,11,03-23-2021 1:30:25
2021-03-23,Tuesday,2:30 PM,3,0,2,2,1,8,03-23-2021 2:30:23
2021-03-23,Tuesday,3:30 PM,3,0,2,2,0,7,03-23-2021 3:30:21
2021-03-25,Thursday,9:30 AM,1,2,2,0,0,5,03-25-2021 10:06:11
2021-03-25,Thursday,11:30 AM,1,2,2,0,1,6,03-25-2021 12:30:18
2021-03-25,Thursday,12:30 PM,1,1,3,1,0,6,03-25-2021 12:30:40
2021-03-25,Thursday,1:30 PM,5,1,3,1,0,10,03-25-2021 1:36:08
2021-03-25,Thursday,3:30 PM,2,1,0,1,0,4,03-25-2021 3:51:17
2021-03-26,Friday,8:30 AM,1,0,3,2,1,7,03-26-2021 9:29:40
2021-03-26,Friday,12:30 PM,5,0,0,0,0,5,03-26-2021 12:32:05
2021-03-26,Friday,2:30 PM,3,1,3,1,0,8,03-26-2021 2:27:40
2021-03-26,Friday,4:30 PM,1,1,0,1,0,3,03-26-2021 4:23:39
2021-03-29,Monday,11:30 AM,0,0,2,2,1,5,03-29-2021 11:32:02
2021-03-29,Monday,12:30 PM,1,0,0,2,1,4,03-29-2021 12:36:11
2021-03-29,Monday,1:30 PM,1,0,0,2,1,4,03-29-2021 1:40:39
2021-03-29,Monday,2:30 PM,1,0,0,2,1,4,03-29-2021 2:19:55
2021-03-30,Tuesday,9:30 AM,2,0,4,1,0,7,03-30-2021 9:45:13
2021-03-30,Tuesday,10:30 AM,2,0,2,1,0,5,03-30-2021 10:53:10
2021-03-30,Tuesday,11:30 AM,2,0,2,2,0,6,03-30-2021 11:41:06
2021-03-30,Tuesday,12:30 PM,2,0,1,2,1,6,03-30-2021 12:40:58
2021-03-30,Tuesday,1:30 PM,3,1,1,2,0,7,03-30-2021 1:30:28
2021-03-30,Tuesday,3:30 PM,2,0,1,2,0,5,03-30-2021 3:08:54
2021-03-31,Wednesday,11:30 AM,6,2,1,3,1,13,03-31-2021 11:31:39
2021-03-31,Wednesday,12:30 PM,6,1,1,2,0,10,03-31-2021 12:30:28
2021-03-31,Wednesday,1:30 PM,4,0,1,2,0,7,03-31-2021 12:57:11
2021-03-31,Wednesday,2:30 PM,3,0,2,1,1,7,03-31-2021 2:35:49
2021-03-31,Wednesday,3:30 PM,3,0,1,2,0,6,03-31-2021 3:27:54
2021-04-01,Thursday,9:30 AM,1,0,0,1,0,2,04-01-2021 9:55:14
2021-04-01,Thursday,10:30 AM,1,1,1,0,0,3,04-01-2021 10:43:18
2021-04-01,Thursday,12:30 PM,3,0,0,2,1,6,04-01-2021 12:30:23
2021-04-01,Thursday,1:30 PM,4,0,2,1,0,7,04-01-2021 1:36:23
2021-04-01,Thursday,2:30 PM,3,0,2,1,0,6,04-01-2021 2:25:49
2021-04-02,Friday,2:30 PM,3,0,3,2,0,8,04-02-2021 2:55:55
2021-04-02,Friday,3:30 PM,2,2,2,1,0,7,04-02-2021 3:30:21
2021-04-02,Friday,4:30 PM,1,0,0,0,0,1,04-02-2021 4:30:52
2021-04-07,Wednesday,10:30 AM,4,2,7,3,1,17,04-07-2021 10:35:20
2021-04-07,Wednesday,11:30 AM,4,0,3,3,0,10,04-07-2021 1:50:11
2021-04-07,Wednesday,2:30 PM,6,1,2,2,1,12,04-07-2021 2:29:07
2021-04-08,Thursday,12:30 PM,6,0,2,3,1,12,04-08-2021 1:20:10
2021-04-08,Thursday,1:30 PM,2,2,2,2,0,8,04-08-2021 1:30:29
2021-04-08,Thursday,2:30 PM,4,1,1,2,2,10,04-08-2021 2:30:29
2021-04-08,Thursday,3:30 PM,3,0,0,2,2,7,04-08-2021 3:34:58
2021-04-09,Friday,9:30 AM,1,0,1,1,0,3,04-09-2021 10:30:41
2021-04-09,Friday,11:30 AM,1,0,0,1,0,2,04-09-2021 11:31:35
2021-04-09,Friday,12:30 PM,2,0,1,1,0,4,04-09-2021 12:30:35
2021-04-09,Friday,1:30 PM,1,0,1,1,0,3,04-09-2021 1:30:19
2021-04-09,Friday,2:30 PM,4,1,0,2,0,7,04-09-2021 2:18:28
2021-04-09,Friday,3:30 PM,3,0,0,0,0,3,04-09-2021 3:40:37
2021-04-09,Friday,4:30 PM,0,0,0,0,0,0,04-09-2021 4:25:46
2021-04-12,Monday,11:30 AM,4,0,8,3,2,17,04-12-2021 11:36:31
2021-04-12,Monday,12:30 PM,6,2,2,3,1,14,04-12-2021 12:32:24
2021-04-12,Monday,1:30 PM,5,2,3,4,2,16,04-12-2021 1:54:05
2021-04-12,Monday,2:30 PM,8,3,3,4,1,19,04-12-2021 2:30:39
2021-04-12,Monday,3:30 PM,5,3,1,3,2,14,04-12-2021 3:30:40
2021-04-13,Tuesday,9:30 AM,5,2,0,1,1,9,04-13-2021 9:45:56
2021-04-13,Tuesday,10:30 AM,4,0,0,3,1,8,04-13-2021 10:38:18
2021-04-13,Tuesday,12:30 PM,9,4,4,3,2,22,04-13-2021 12:32:50
2021-04-13,Tuesday,1:30 PM,5,1,3,3,1,13,04-13-2021 1:30:52
2021-04-13,Tuesday,3:30 PM,8,2,1,3,2,16,04-13-2021 3:30:45
2021-04-15,Thursday,12:30 PM,5,2,0,3,0,10,04-15-2021 12:32:35
2021-04-19,Monday,9:30 AM,5,2,1,2,2,12,04-19-2021 9:30:31
2021-04-19,Monday,12:30 PM,9,2,0,4,2,17,04-19-2021 12:19:58
2021-04-19,Monday,1:30 PM,5,1,3,3,2,14,04-19-2021 1:56:34
2021-04-19,Monday,3:30 PM,1,1,1,2,1,6,04-19-2021 3:35:49
2021-04-20,Tuesday,11:30 AM,4,2,2,3,2,13,04-20-2021 11:44:45
2021-04-20,Tuesday,12:30 PM,4,0,2,2,1,9,04-20-2021 12:29:17
2021-04-20,Tuesday,1:30 PM,2,2,1,3,1,9,04-20-2021 1:30:25
2021-04-20,Tuesday,2:30 PM,3,2,2,4,2,13,04-20-2021 3:18:35
2021-04-21,Wednesday,9:30 AM,2,2,2,0,1,7,04-21-2021 9:32:47
2021-04-21,Wednesday,10:30 AM,5,2,2,1,1,11,04-21-2021 11:30:49
2021-04-21,Wednesday,11:30 AM,3,0,2,2,1,8,04-21-2021 11:31:20
2021-04-21,Wednesday,12:30 PM,12,4,3,4,2,25,04-21-2021 12:30:23
2021-04-21,Wednesday,1:30 PM,2,1,2,3,1,9,04-21-2021 1:30:32
2021-04-21,Wednesday,2:30 PM,6,2,1,3,1,13,04-21-2021 2:30:36
2021-04-21,Wednesday,5:30 PM,2,0,0,2,1,5,04-21-2021 5:36:06
2021-04-21,Wednesday,6:30 PM,1,0,0,1,0,2,04-21-2021 6:26:51
2021-04-21,Wednesday,7:30 PM,0,0,0,1,0,1,04-21-2021 7:24:13
2021-04-22,Thursday,4:30 PM,5,0,2,1,0,8,04-22-2021 4:32:37
2021-04-22,Thursday,5:30 PM,3,0,1,1,2,7,04-22-2021 5:35:15
2021-04-22,Thursday,6:30 PM,3,0,0,1,1,5,04-22-2021 6:35:17
2021-04-22,Thursday,7:30 PM,1,0,0,2,0,3,04-22-2021 7:35:49
2021-04-23,Friday,7:30 AM,0,0,0,0,0,0,04-23-2021 8:48:19
2021-04-24,Saturday,1:30 PM,4,0,0,0,0,4,04-24-2021 1:35:17
2021-04-24,Saturday,2:30 PM,3,0,0,0,0,3,04-24-2021 2:31:36
2021-04-26,Monday,1:30 PM,1,0,4,2,1,8,04-26-2021 1:31:21
2021-04-26,Monday,2:30 PM,4,2,2,1,0,9,04-26-2021 3:40:34
2021-04-26,Monday,3:30 PM,6,0,2,2,1,11,04-26-2021 3:40:58
2021-04-26,Monday,4:30 PM,3,0,1,2,2,8,04-26-2021 5:57:26
2021-04-26,Monday,5:30 PM,4,0,0,0,0,4,04-26-2021 5:58:01
2021-04-26,Monday,6:30 PM,6,0,0,2,1,9,04-26-2021 6:31:59
2021-04-27,Tuesday,10:30 AM,6,3,3,2,2,16,04-27-2021 10:27:17
2021-04-27,Tuesday,12:30 PM,6,5,4,4,2,21,04-27-2021 12:28:37
2021-04-27,Tuesday,1:30 PM,4,0,5,2,0,11,04-27-2021 5:06:48
2021-04-27,Tuesday,2:30 PM,5,0,3,2,2,12,04-27-2021 5:07:10
2021-04-27,Tuesday,3:30 PM,3,0,2,4,1,10,04-27-2021 5:07:30
2021-04-27,Tuesday,4:30 PM,5,2,1,3,0,11,04-27-2021 5:08:01
2021-04-27,Tuesday,6:30 PM,9,3,2,3,1,18,04-27-2021 5:15:27
2021-04-27,Tuesday,6:30 PM,6,1,1,2,0,10,04-27-2021 6:52:26
2021-04-27,Tuesday,6:30 PM,3,0,0,2,1,6,04-27-2021 7:34:11
2021-04-28,Wednesday,12:30 PM,6,3,2,0,2,13,04-28-2021 2:44:08
2021-04-28,Wednesday,1:30 PM,4,1,2,2,0,9,04-28-2021 2:44:28
2021-04-28,Wednesday,2:30 PM,7,0,3,3,1,14,04-28-2021 2:45:23
2021-04-28,Wednesday,3:30 PM,8,1,3,2,2,16,04-28-2021 3:45:16
2021-04-28,Wednesday,5:30 PM,2,1,0,1,0,4,04-28-2021 5:29:07
2021-04-29,Thursday,12:30 PM,8,1,2,3,2,16,04-29-2021 12:49:32
2021-04-29,Thursday,1:30 PM,4,2,2,3,1,12,04-29-2021 5:00:46
2021-04-29,Thursday,2:30 PM,6,0,2,3,1,12,04-29-2021 5:01:09
2021-04-29,Thursday,3:30 PM,5,0,3,4,2,14,04-29-2021 5:01:43
2021-04-29,Thursday,4:30 PM,4,1,2,0,1,8,04-29-2021 5:02:08
2021-04-29,Thursday,6:30 PM,4,2,1,2,0,9,04-29-2021 6:01:27
2021-04-29,Thursday,6:30 PM,3,0,0,1,0,4,04-29-2021 6:58:35
2021-04-29,Thursday,4:30 PM,1,1,2,0,0,4,04-29-2021 7:32:43
2021-04-30,Friday,10:30 AM,0,0,1,0,0,1,04-30-2021 10:34:30
2021-05-01,Saturday,2:30 PM,6,0,0,0,0,6,05-01-2021 2:29:51
2021-05-03,Monday,8:30 AM,2,2,0,0,2,6,05-03-2021 8:31:25
2021-05-03,Monday,12:30 PM,3,2,2,2,2,11,05-03-2021 3:16:38
2021-05-03,Monday,1:30 PM,4,2,1,0,0,7,05-03-2021 3:17:02
2021-05-03,Monday,2:30 PM,3,2,2,3,1,11,05-03-2021 3:17:40
2021-05-03,Monday,3:30 PM,2,0,1,1,0,4,05-03-2021 3:18:05
2021-05-03,Monday,4:30 PM,5,1,1,2,0,9,05-03-2021 6:23:47
2021-05-03,Monday,5:30 PM,2,0,0,1,0,3,05-03-2021 6:24:07
2021-05-03,Monday,6:30 PM,2,1,0,2,1,6,05-03-2021 6:24:35
2021-05-04,Tuesday,12:30 PM,4,3,2,4,2,15,05-04-2021 1:47:54
2021-05-04,Tuesday,1:30 PM,6,4,2,2,1,15,05-04-2021 1:48:16
2021-05-04,Tuesday,2:30 PM,5,1,1,2,2,11,05-04-2021 3:35:34
2021-05-04,Tuesday,3:30 PM,5,1,1,3,0,10,05-04-2021 3:36:22
2021-05-04,Tuesday,5:30 PM,1,0,2,0,0,3,05-04-2021 5:37:15
2021-05-04,Tuesday,6:30 PM,2,0,2,4,1,9,05-04-2021 6:37:28
2021-05-04,Tuesday,7:30 PM,1,0,2,3,1,7,05-04-2021 7:26:36
2021-05-05,Wednesday,12:30 PM,8,1,2,3,1,15,05-05-2021 1:28:49
2021-05-05,Wednesday,2:30 PM,7,0,3,2,0,12,05-05-2021 1:29:07
2021-05-05,Wednesday,2:30 PM,4,1,2,2,1,10,05-05-2021 3:38:26
2021-05-05,Wednesday,3:30 PM,3,0,1,2,0,6,05-05-2021 3:38:53
2021-05-05,Wednesday,4:30 PM,3,0,1,2,0,6,05-05-2021 5:34:06
2021-05-05,Wednesday,6:30 PM,3,0,1,2,0,6,05-05-2021 6:36:27
2021-05-05,Wednesday,5:30 PM,0,0,1,0,0,1,05-05-2021 7:29:13
2021-05-06,Thursday,12:30 PM,5,1,3,3,1,13,05-06-2021 1:07:29
2021-05-06,Thursday,2:30 PM,4,1,1,1,1,8,05-06-2021 3:44:38
2021-05-06,Thursday,3:30 PM,3,0,1,3,2,9,05-06-2021 3:44:59
2021-05-06,Thursday,4:30 PM,6,0,2,1,1,10,05-06-2021 5:06:52
2021-05-06,Thursday,5:30 PM,4,0,1,2,0,7,05-06-2021 5:42:02
2021-05-06,Thursday,6:30 PM,5,0,1,3,1,10,05-06-2021 6:38:08
2021-05-07,Friday,8:30 AM,1,0,1,1,0,3,05-07-2021 8:38:44
2021-05-07,Friday,10:30 AM,1,0,0,1,0,2,05-07-2021 10:32:45
2021-05-07,Friday,12:30 PM,5,1,2,2,3,13,05-07-2021 3:56:48
2021-05-07,Friday,1:30 PM,4,2,3,2,1,12,05-07-2021 3:57:05
2021-05-07,Friday,2:30 PM,5,0,1,1,0,7,05-07-2021 3:57:31
2021-05-07,Friday,3:30 PM,1,0,1,0,0,2,05-07-2021 3:58:04
2021-05-10,Monday,8:30 AM,0,3,2,0,2,7,05-10-2021 8:31:18
2021-05-10,Monday,12:30 PM,5,2,0,2,1,10,05-10-2021 2:47:16
2021-05-10,Monday,1:30 PM,3,0,1,2,2,8,05-10-2021 2:47:34
2021-05-10,Monday,2:30 PM,2,1,0,1,0,4,05-10-2021 2:47:53
2021-05-10,Monday,3:30 PM,1,1,0,1,0,3,05-10-2021 3:58:17
2021-05-10,Monday,5:30 PM,2,0,0,1,0,3,05-10-2021 6:01:36
2021-05-10,Monday,4:30 PM,1,0,0,1,2,4,05-10-2021 6:01:58
2021-05-10,Monday,6:30 PM,3,0,0,0,0,3,05-10-2021 6:45:29
2021-05-10,Monday,7:30 PM,3,0,0,0,0,3,05-10-2021 7:30:37
2021-05-10,Monday,5:30 PM,1,0,0,0,0,1,05-10-2021 7:32:56
2021-05-11,Tuesday,8:30 AM,1,1,1,2,1,6,05-11-2021 8:31:44
2021-05-11,Tuesday,12:30 PM,3,0,1,1,0,5,05-11-2021 1:41:24
2021-05-11,Tuesday,1:30 PM,4,0,1,1,0,6,05-11-2021 1:43:31
2021-05-11,Tuesday,2:30 PM,3,0,1,0,0,4,05-11-2021 2:30:37
2021-05-11,Tuesday,3:30 PM,4,0,2,2,1,9,05-11-2021 6:25:38
2021-05-11,Tuesday,4:30 PM,3,0,0,1,0,4,05-11-2021 6:25:55
2021-05-11,Tuesday,5:30 PM,2,0,0,2,1,5,05-11-2021 6:26:09
2021-05-11,Tuesday,6:30 PM,4,0,0,0,0,4,05-11-2021 6:26:24
2021-05-12,Wednesday,10:30 AM,2,0,0,4,2,8,05-12-2021 10:36:12
2021-05-12,Wednesday,12:30 PM,4,1,2,2,0,9,05-12-2021 2:50:15
2021-05-12,Wednesday,1:30 PM,4,0,2,1,0,7,05-12-2021 2:50:38
2021-05-12,Wednesday,2:30 PM,5,0,1,2,1,9,05-12-2021 2:50:57
2021-05-12,Wednesday,3:30 PM,4,0,1,0,0,5,05-12-2021 2:58:35
2021-05-12,Wednesday,4:30 PM,4,2,0,2,0,8,05-12-2021 7:06:31
2021-05-12,Wednesday,5:30 PM,3,0,0,0,0,3,05-12-2021 7:06:45
2021-05-12,Wednesday,6:30 PM,2,1,0,2,0,5,05-12-2021 7:07:03
2021-05-13,Thursday,12:30 PM,3,0,1,2,0,6,05-13-2021 4:28:54
2021-05-13,Thursday,1:30 PM,2,0,0,1,0,3,05-13-2021 4:29:08
2021-05-13,Thursday,3:30 PM,3,1,0,2,2,8,05-13-2021 4:29:22
2021-05-13,Thursday,4:30 PM,3,0,0,0,0,3,05-13-2021 4:29:39
2021-05-13,Thursday,5:30 PM,4,1,0,1,0,6,05-13-2021 5:36:35
2021-05-13,Thursday,7:30 PM,3,0,0,0,0,3,05-13-2021 7:20:08
2021-05-14,Friday,8:30 AM,1,2,0,0,0,3,05-14-2021 8:31:21
2021-05-14,Friday,12:30 PM,3,0,0,0,0,3,05-14-2021 3:29:14
2021-05-14,Friday,1:30 PM,2,1,0,0,0,3,05-14-2021 3:29:28
2021-05-14,Friday,2:30 PM,4,0,0,2,0,6,05-14-2021 3:29:42
2021-05-14,Friday,3:30 PM,2,0,0,0,0,2,05-14-2021 3:29:54
2021-05-14,Friday,4:30 PM,1,0,0,0,0,1,05-14-2021 4:29:10
2021-05-25,Tuesday,9:30 AM,0,0,0,0,0,0,05-25-2021 8:31:39
2021-05-27,Thursday,8:30 AM,0,0,0,0,0,0,05-27-2021 9:50:59
2021-05-27,Thursday,9:30 AM,0,0,0,1,0,1,05-27-2021 9:54:30
2021-06-01,Tuesday,9:30 AM,1,0,0,0,0,1,06-01-2021 8:37:46
2021-06-03,Thursday,9:30 AM,0,0,0,0,0,0,06-03-2021 8:42:29
2021-06-07,Monday,8:30 AM,0,0,0,0,0,0,06-07-2021 8:45:26
2021-06-08,Tuesday,5:30 PM,0,0,1,1,0,2,06-08-2021 4:29:07
2021-06-08,Tuesday,6:30 PM,1,1,1,2,0,5,06-08-2021 5:47:24
2021-06-08,Tuesday,7:30 PM,2,0,1,2,0,5,06-08-2021 6:30:03
2021-06-08,Tuesday,8:30 PM,1,0,1,2,0,4,06-08-2021 7:30:34
2021-06-09,Wednesday,9:30 AM,2,0,0,1,1,4,06-09-2021 8:40:28
2021-06-09,Wednesday,4:30 PM,1,2,0,0,2,5,06-09-2021 3:31:48
2021-06-09,Wednesday,4:30 PM,2,0,0,2,1,5,06-09-2021 4:39:08
2021-06-09,Wednesday,5:30 PM,3,0,0,0,1,4,06-09-2021 5:57:09
2021-06-09,Wednesday,6:30 PM,2,0,0,0,0,2,06-09-2021 6:38:40
2021-06-09,Wednesday,7:30 PM,0,0,0,0,0,0,06-09-2021 7:24:37
2021-06-09,Wednesday,8:30 PM,0,0,0,0,0,0,06-09-2021 7:35:55
2021-06-10,Thursday,8:30 AM,1,0,1,1,0,3,06-10-2021 8:40:33
2021-06-10,Thursday,3:30 PM,1,1,0,2,0,4,06-10-2021 3:29:55
2021-06-10,Thursday,4:30 PM,2,1,0,2,0,5,06-10-2021 4:38:38
2021-06-10,Thursday,6:30 PM,3,0,0,0,0,3,06-10-2021 5:21:19
2021-06-10,Thursday,6:30 PM,3,0,0,0,0,3,06-10-2021 5:36:09
2021-06-10,Thursday,7:30 PM,1,0,0,0,0,1,06-10-2021 7:29:51
2021-06-14,Monday,2:30 PM,3,0,0,2,0,5,06-14-2021 2:42:44
2021-06-14,Monday,3:30 PM,2,1,0,2,1,6,06-14-2021 3:39:15
2021-06-14,Monday,4:30 PM,3,3,0,1,0,7,06-14-2021 4:30:23
2021-06-14,Monday,5:30 PM,4,3,0,0,0,7,06-14-2021 5:38:31
2021-06-14,Monday,6:30 PM,1,0,0,0,0,1,06-14-2021 6:30:41
2021-06-14,Monday,7:30 PM,1,1,0,0,0,2,06-14-2021 7:16:53
2021-06-15,Tuesday,8:30 AM,0,1,1,0,0,2,06-15-2021 8:37:12
2021-06-15,Tuesday,9:30 AM,2,0,0,1,0,3,06-15-2021 10:05:41
2021-06-15,Tuesday,10:30 AM,1,0,0,1,0,2,06-15-2021 10:35:26
2021-06-15,Tuesday,4:30 PM,2,0,1,2,2,7,06-15-2021 4:26:40
2021-06-15,Tuesday,5:30 PM,4,0,1,1,2,8,06-15-2021 5:28:10
2021-06-15,Tuesday,6:30 PM,4,0,1,1,1,7,06-15-2021 6:27:49
2021-06-15,Tuesday,7:30 PM,3,0,1,0,0,4,06-15-2021 7:28:49
2021-06-16,Wednesday,9:30 AM,1,0,0,0,1,2,06-16-2021 8:33:06
2021-06-16,Wednesday,10:30 AM,1,0,1,0,0,2,06-16-2021 9:30:11
2021-06-16,Wednesday,10:30 AM,3,3,0,0,0,6,06-16-2021 10:56:07
2021-06-16,Wednesday,6:30 PM,4,1,1,1,1,8,06-16-2021 5:27:09
2021-06-16,Wednesday,6:30 PM,3,0,1,0,0,4,06-16-2021 6:32:20
2021-06-16,Wednesday,8:30 PM,2,0,1,0,0,3,06-16-2021 7:29:49
2021-06-16,Wednesday,7:30 PM,2,0,1,0,0,3,06-16-2021 7:32:07
2021-06-17,Thursday,8:30 AM,2,0,1,0,0,3,06-17-2021 8:33:43
2021-06-17,Thursday,9:30 AM,0,3,0,0,0,3,06-17-2021 10:29:40
2021-06-17,Thursday,10:30 AM,0,1,0,1,0,2,06-17-2021 10:30:30
2021-06-17,Thursday,5:30 PM,3,0,2,0,0,5,06-17-2021 4:44:14
2021-06-17,Thursday,6:30 PM,4,0,5,0,0,9,06-17-2021 5:21:17
2021-06-17,Thursday,7:30 PM,1,0,1,0,0,2,06-17-2021 7:29:59
2021-06-18,Friday,9:30 AM,0,0,0,0,0,0,06-18-2021 8:35:19
2021-06-18,Friday,8:30 AM,0,0,0,0,0,0,06-18-2021 8:35:41
2021-06-22,Tuesday,2:30 PM,3,1,4,3,0,11,06-22-2021 2:48:48
2021-06-22,Tuesday,3:30 PM,3,0,2,3,0,8,06-22-2021 3:34:18
2021-06-22,Tuesday,5:30 PM,1,0,4,1,0,6,06-22-2021 4:37:02
2021-06-22,Tuesday,5:30 PM,1,2,2,1,0,6,06-22-2021 5:25:05