Semester,Date,DayOfWeek,Time,Computers,Silent,Quiet,Active,Other,Total
Spring 2019,1/14/2019,Monday,7:30 AM,3,0,1,0,0,4
Spring 2019,1/14/2019,Monday,8:30 AM,5,2,3,1,0,11
Spring 2019,1/14/2019,Monday,9:30 AM,21,2,7,4,2,36
Spring 2019,1/14/2019,Monday,10:30 AM,25,2,24,4,5,60
Spring 2019,1/14/2019,Monday,11:30 AM,23,4,18,2,7,54
Spring 2019,1/14/2019,Monday,1:30 PM,18,7,17,5,4,51
Spring 2019,1/14/2019,Monday,2:30 PM,32,4,8,2,6,52
Spring 2019,1/14/2019,Monday,3:30 PM,19,5,9,3,3,39
Spring 2019,1/14/2019,Monday,4:30 PM,27,7,6,2,4,46
Spring 2019,1/14/2019,Monday,5:30 PM,18,2,3,4,5,32
Spring 2019,1/14/2019,Monday,6:30 PM,15,1,2,0,1,19
Spring 2019,1/14/2019,Monday,7:30 PM,14,2,7,1,1,25
Spring 2019,1/14/2019,Monday,8:30 PM,9,0,5,1,1,16
Spring 2019,1/15/2019,Tuesday,8:30 AM,6,2,3,4,2,17
Spring 2019,1/15/2019,Tuesday,9:30 AM,15,2,5,6,1,29
Spring 2019,1/15/2019,Tuesday,10:30 AM,29,3,20,8,4,64
Spring 2019,1/15/2019,Tuesday,11:30 AM,26,5,13,4,4,52
Spring 2019,1/15/2019,Tuesday,12:30 PM,34,7,38,2,9,90
Spring 2019,1/15/2019,Tuesday,1:30 PM,16,5,14,2,3,40
Spring 2019,1/15/2019,Tuesday,2:30 PM,18,5,11,6,2,42
Spring 2019,1/15/2019,Tuesday,3:30 PM,13,6,14,1,1,35
Spring 2019,1/15/2019,Tuesday,4:30 PM,15,5,9,1,0,30
Spring 2019,1/15/2019,Tuesday,5:30 PM,11,3,5,1,0,20
Spring 2019,1/15/2019,Tuesday,6:30 PM,13,2,3,1,0,19
Spring 2019,1/15/2019,Tuesday,7:30 PM,9,1,3,0,0,13
Spring 2019,1/15/2019,Tuesday,8:30 PM,8,1,4,0,0,13
Spring 2019,1/16/2019,Wednesday,7:30 AM,5,0,0,0,0,5
Spring 2019,1/16/2019,Wednesday,8:30 AM,7,1,2,0,0,10
Spring 2019,1/16/2019,Wednesday,9:30 AM,13,1,11,1,0,26
Spring 2019,1/16/2019,Wednesday,10:30 AM,20,0,17,3,2,42
Spring 2019,1/16/2019,Wednesday,11:30 AM,28,1,20,9,6,64
Spring 2019,1/16/2019,Wednesday,12:30 PM,40,12,48,12,13,125
Spring 2019,1/16/2019,Wednesday,1:30 PM,23,8,19,2,6,58
Spring 2019,1/16/2019,Wednesday,2:30 PM,11,2,8,0,3,24
Spring 2019,1/16/2019,Wednesday,3:30 PM,9,5,7,2,3,26
Spring 2019,1/16/2019,Wednesday,5:30 PM,9,1,3,2,1,16
Spring 2019,1/16/2019,Wednesday,6:30 PM,8,2,4,4,2,20
Spring 2019,1/16/2019,Wednesday,7:30 PM,5,1,2,4,0,12
Spring 2019,1/16/2019,Wednesday,8:30 PM,9,1,1,0,0,11
Spring 2019,1/17/2019,Thursday,7:30 AM,6,0,0,0,1,7
Spring 2019,1/17/2019,Thursday,8:30 AM,9,1,8,3,1,22
Spring 2019,1/17/2019,Thursday,9:30 AM,19,3,14,5,3,44
Spring 2019,1/17/2019,Thursday,10:30 AM,20,7,21,5,1,54
Spring 2019,1/17/2019,Thursday,11:30 AM,24,4,17,7,3,55
Spring 2019,1/17/2019,Thursday,12:30 PM,44,13,39,11,9,116
Spring 2019,1/17/2019,Thursday,1:30 PM,23,5,17,3,0,48
Spring 2019,1/17/2019,Thursday,3:30 PM,15,3,16,5,0,39
Spring 2019,1/17/2019,Thursday,4:30 PM,12,3,11,4,2,32
Spring 2019,1/17/2019,Thursday,5:30 PM,12,3,6,4,0,25
Spring 2019,1/17/2019,Thursday,6:30 PM,12,1,4,3,0,20
Spring 2019,1/17/2019,Thursday,7:30 PM,2,2,3,0,0,7
Spring 2019,1/17/2019,Thursday,8:30 PM,5,1,3,0,1,10
Spring 2019,1/18/2019,Friday,7:30 AM,1,0,1,0,0,2
Spring 2019,1/18/2019,Friday,8:30 AM,4,1,2,0,0,7
Spring 2019,1/18/2019,Friday,9:30 AM,4,0,1,0,0,5
Spring 2019,1/18/2019,Friday,10:30 AM,10,0,3,0,0,13
Spring 2019,1/18/2019,Friday,12:30 PM,15,0,3,0,3,21
Spring 2019,1/18/2019,Friday,1:30 PM,14,1,0,0,1,16
Spring 2019,1/18/2019,Friday,5:30 PM,11,0,7,0,0,18
Spring 2019,1/18/2019,Friday,6:30 PM,5,1,6,1,0,13
Spring 2019,1/18/2019,Friday,7:30 PM,4,0,0,0,1,5
Spring 2019,1/18/2019,Friday,8:30 PM,2,0,0,0,0,2
Spring 2019,1/19/2019,Saturday,9:30 AM,3,0,4,0,2,9
Spring 2019,1/19/2019,Saturday,10:30 AM,4,0,2,0,1,7
Spring 2019,1/19/2019,Saturday,11:30 AM,5,0,2,0,2,9
Spring 2019,1/19/2019,Saturday,12:30 PM,6,2,2,0,0,10
Spring 2019,1/19/2019,Saturday,1:30 PM,5,2,3,0,0,10
Spring 2019,1/19/2019,Saturday,2:30 PM,10,2,2,0,0,14
Spring 2019,1/19/2019,Saturday,3:30 PM,6,1,3,0,0,10
Spring 2019,1/19/2019,Saturday,4:30 PM,5,1,3,0,0,9
Spring 2019,1/19/2019,Saturday,5:30 PM,3,0,0,0,0,3
Spring 2019,1/22/2019,Tuesday,7:30 AM,2,0,0,0,1,3
Spring 2019,1/22/2019,Tuesday,8:30 AM,12,2,5,2,3,24
Spring 2019,1/22/2019,Tuesday,9:30 AM,14,2,9,5,3,33
Spring 2019,1/22/2019,Tuesday,11:30 AM,27,2,21,3,6,59
Spring 2019,1/22/2019,Tuesday,12:30 PM,48,8,38,8,7,109
Spring 2019,1/22/2019,Tuesday,1:30 PM,20,6,18,1,0,45
Spring 2019,1/22/2019,Tuesday,3:30 PM,12,3,15,2,1,33
Spring 2019,1/22/2019,Tuesday,4:30 PM,20,5,16,5,4,50
Spring 2019,1/22/2019,Tuesday,5:30 PM,21,8,7,1,1,38
Spring 2019,1/22/2019,Tuesday,6:30 PM,14,3,1,1,1,20
Spring 2019,1/22/2019,Tuesday,7:30 PM,11,2,1,0,0,14
Spring 2019,1/22/2019,Tuesday,8:30 PM,8,0,1,0,0,9
Spring 2019,1/23/2019,Wednesday,7:30 AM,4,0,0,0,0,4
Spring 2019,1/23/2019,Wednesday,8:30 AM,11,1,7,0,1,20
Spring 2019,1/23/2019,Wednesday,9:30 AM,19,6,9,1,0,35
Spring 2019,1/23/2019,Wednesday,10:30 AM,32,3,12,5,4,56
Spring 2019,1/23/2019,Wednesday,11:30 AM,30,6,19,5,4,64
Spring 2019,1/23/2019,Wednesday,12:30 PM,36,11,46,7,8,108
Spring 2019,1/23/2019,Wednesday,1:30 PM,26,9,22,5,1,63
Spring 2019,1/23/2019,Wednesday,2:30 PM,25,6,21,1,7,60
Spring 2019,1/23/2019,Wednesday,3:30 PM,17,6,16,0,4,43
Spring 2019,1/23/2019,Wednesday,5:30 PM,24,5,12,1,0,42
Spring 2019,1/23/2019,Wednesday,6:30 PM,5,2,7,3,0,17
Spring 2019,1/23/2019,Wednesday,7:30 PM,7,1,4,3,0,15
Spring 2019,1/23/2019,Wednesday,8:30 PM,6,2,4,3,0,15
Spring 2019,1/24/2019,Thursday,7:30 AM,4,0,0,0,0,4
Spring 2019,1/24/2019,Thursday,8:30 AM,8,2,3,2,0,15
Spring 2019,1/24/2019,Thursday,9:30 AM,18,5,16,4,2,45
Spring 2019,1/24/2019,Thursday,10:30 AM,22,7,21,4,2,56
Spring 2019,1/24/2019,Thursday,11:30 AM,21,5,22,2,3,53
Spring 2019,1/24/2019,Thursday,12:30 PM,39,6,44,4,3,96
Spring 2019,1/24/2019,Thursday,1:30 PM,14,6,12,2,2,36
Spring 2019,1/24/2019,Thursday,3:30 PM,22,3,13,1,0,39
Spring 2019,1/24/2019,Thursday,4:30 PM,14,3,14,5,0,36
Spring 2019,1/24/2019,Thursday,5:30 PM,16,2,20,5,0,43
Spring 2019,1/24/2019,Thursday,6:30 PM,8,1,9,2,0,20
Spring 2019,1/24/2019,Thursday,7:30 PM,13,1,5,2,0,21
Spring 2019,1/25/2019,Friday,7:30 AM,3,0,1,0,0,4
Spring 2019,1/25/2019,Friday,8:30 AM,6,1,0,1,0,8
Spring 2019,1/25/2019,Friday,9:30 AM,7,1,3,1,0,12
Spring 2019,1/25/2019,Friday,10:30 AM,14,1,5,1,1,22
Spring 2019,1/25/2019,Friday,12:30 PM,16,2,3,1,3,25
Spring 2019,1/25/2019,Friday,5:30 PM,10,2,5,1,0,18
Spring 2019,1/25/2019,Friday,6:30 PM,6,4,3,0,0,13
Spring 2019,1/25/2019,Friday,7:30 PM,6,4,0,0,0,10
Spring 2019,1/25/2019,Friday,8:30 PM,3,0,0,0,0,3
Spring 2019,1/26/2019,Saturday,9:30 AM,0,0,2,0,0,2
Spring 2019,1/26/2019,Saturday,10:30 AM,1,1,2,0,0,4
Spring 2019,1/26/2019,Saturday,11:30 AM,10,1,3,0,0,14
Spring 2019,1/26/2019,Saturday,1:30 PM,6,1,2,0,0,9
Spring 2019,1/26/2019,Saturday,2:30 PM,6,0,5,1,0,12
Spring 2019,1/26/2019,Saturday,3:30 PM,5,0,5,2,0,12
Spring 2019,1/26/2019,Saturday,4:30 PM,13,0,5,0,0,18
Spring 2019,1/26/2019,Saturday,5:30 PM,3,1,0,0,0,4
Spring 2019,1/28/2019,Monday,7:30 AM,2,0,1,0,0,3
Spring 2019,1/28/2019,Monday,8:30 AM,8,0,6,0,1,15
Spring 2019,1/28/2019,Monday,9:30 AM,18,4,16,3,0,41
Spring 2019,1/28/2019,Monday,11:30 AM,23,5,25,8,3,64
Spring 2019,1/28/2019,Monday,1:30 PM,27,6,24,2,0,59
Spring 2019,1/28/2019,Monday,2:30 PM,24,6,21,0,8,59
Spring 2019,1/28/2019,Monday,3:30 PM,19,8,9,5,0,41
Spring 2019,1/28/2019,Monday,6:30 PM,14,5,5,0,0,24
Spring 2019,1/28/2019,Monday,7:30 PM,14,4,5,3,0,26
Spring 2019,1/28/2019,Monday,8:30 PM,16,4,6,3,0,29
Spring 2019,1/29/2019,Tuesday,7:30 AM,0,0,0,0,0,0
Spring 2019,1/29/2019,Tuesday,8:30 AM,16,3,3,6,1,29
Spring 2019,1/29/2019,Tuesday,9:30 AM,24,2,10,6,4,46
Spring 2019,1/29/2019,Tuesday,10:30 AM,29,3,15,9,3,59
Spring 2019,1/29/2019,Tuesday,11:30 AM,25,5,18,2,4,54
Spring 2019,1/29/2019,Tuesday,12:30 PM,44,7,28,5,9,93
Spring 2019,1/29/2019,Tuesday,1:30 PM,17,4,18,2,0,41
Spring 2019,1/29/2019,Tuesday,3:30 PM,17,3,17,5,0,42
Spring 2019,1/29/2019,Tuesday,4:30 PM,11,3,9,6,0,29
Spring 2019,1/29/2019,Tuesday,5:30 PM,13,6,11,1,2,33
Spring 2019,1/29/2019,Tuesday,6:30 PM,13,2,6,1,0,22
Spring 2019,1/29/2019,Tuesday,7:30 PM,6,1,6,2,0,15
Spring 2019,1/30/2019,Wednesday,7:30 AM,4,0,0,0,0,4
Spring 2019,1/30/2019,Wednesday,8:30 AM,9,3,9,3,5,29
Spring 2019,1/30/2019,Wednesday,9:30 AM,23,4,12,4,3,46
Spring 2019,1/30/2019,Wednesday,10:30 AM,23,8,15,7,5,58
Spring 2019,1/30/2019,Wednesday,11:30 AM,26,8,25,6,3,68
Spring 2019,1/30/2019,Wednesday,12:30 PM,40,21,44,11,13,129
Spring 2019,1/30/2019,Wednesday,1:30 PM,28,9,17,8,2,64
Spring 2019,1/30/2019,Wednesday,2:30 PM,23,6,22,4,7,62
Spring 2019,1/30/2019,Wednesday,3:30 PM,20,5,17,4,5,51
Spring 2019,1/30/2019,Wednesday,4:30 PM,22,5,9,1,4,41
Spring 2019,1/30/2019,Wednesday,5:30 PM,22,6,12,6,0,46
Spring 2019,1/30/2019,Wednesday,6:30 PM,5,5,3,2,0,15
Spring 2019,1/30/2019,Wednesday,7:30 PM,9,5,2,6,0,22
Spring 2019,1/30/2019,Wednesday,8:30 PM,4,4,3,3,0,14
Spring 2019,1/31/2019,Thursday,7:30 AM,4,0,0,0,0,4
Spring 2019,1/31/2019,Thursday,8:30 AM,5,0,7,2,2,16
Spring 2019,1/31/2019,Thursday,9:30 AM,17,3,20,2,1,43
Spring 2019,1/31/2019,Thursday,10:30 AM,29,3,29,8,3,72
Spring 2019,1/31/2019,Thursday,11:30 AM,18,4,20,3,2,47
Spring 2019,1/31/2019,Thursday,12:30 PM,34,5,47,8,5,99
Spring 2019,1/31/2019,Thursday,1:30 PM,10,7,18,1,2,38
Spring 2019,1/31/2019,Thursday,3:30 PM,15,7,13,5,0,40
Spring 2019,1/31/2019,Thursday,4:30 PM,26,8,11,4,0,49
Spring 2019,1/31/2019,Thursday,5:30 PM,11,5,9,4,0,29
Spring 2019,1/31/2019,Thursday,6:30 PM,8,1,1,2,0,12
Spring 2019,1/31/2019,Thursday,7:30 PM,8,0,1,1,0,10
Spring 2019,1/31/2019,Thursday,8:30 PM,8,0,1,1,0,10
Spring 2019,2/1/2019,Friday,7:30 AM,1,0,0,0,0,1
Spring 2019,2/1/2019,Friday,8:30 AM,3,1,0,0,0,4
Spring 2019,2/1/2019,Friday,9:30 AM,2,3,0,0,0,5
Spring 2019,2/1/2019,Friday,11:30 AM,7,2,2,0,1,12
Spring 2019,2/1/2019,Friday,12:30 PM,11,3,6,0,0,20
Spring 2019,2/1/2019,Friday,5:30 PM,9,3,4,2,0,18
Spring 2019,2/1/2019,Friday,6:30 PM,7,3,7,0,0,17
Spring 2019,2/1/2019,Friday,7:30 PM,7,3,6,0,1,17
Spring 2019,2/1/2019,Friday,8:30 PM,1,3,5,0,0,9
Spring 2019,2/2/2019,Saturday,9:30 AM,2,0,2,0,0,4
Spring 2019,2/2/2019,Saturday,10:30 AM,2,0,8,0,0,10
Spring 2019,2/2/2019,Saturday,12:30 PM,17,3,9,2,0,31
Spring 2019,2/2/2019,Saturday,1:30 PM,10,2,9,3,0,24
Spring 2019,2/2/2019,Saturday,2:30 PM,15,2,4,0,0,21
Spring 2019,2/2/2019,Saturday,3:30 PM,14,2,8,0,0,24
Spring 2019,2/2/2019,Saturday,4:30 PM,11,2,9,0,2,24
Spring 2019,2/2/2019,Saturday,5:30 PM,2,0,0,0,0,2
Spring 2019,2/4/2019,Monday,7:30 AM,6,0,0,0,0,6
Spring 2019,2/4/2019,Monday,8:30 AM,11,3,10,1,0,25
Spring 2019,2/4/2019,Monday,9:30 AM,29,3,18,6,0,56
Spring 2019,2/4/2019,Monday,10:30 AM,20,6,26,8,0,60
Spring 2019,2/4/2019,Monday,11:30 AM,23,5,19,3,2,52
Spring 2019,2/4/2019,Monday,12:30 PM,42,13,41,16,10,122
Spring 2019,2/4/2019,Monday,1:30 PM,25,8,20,5,0,58
Spring 2019,2/4/2019,Monday,2:30 PM,24,8,15,4,2,53
Spring 2019,2/4/2019,Monday,3:30 PM,14,4,12,1,2,33
Spring 2019,2/4/2019,Monday,4:30 PM,16,4,13,0,0,33
Spring 2019,2/4/2019,Monday,5:30 PM,26,6,17,4,0,53
Spring 2019,2/4/2019,Monday,6:30 PM,16,5,12,7,0,40
Spring 2019,2/4/2019,Monday,7:30 PM,14,3,11,4,2,34
Spring 2019,2/4/2019,Monday,8:30 PM,16,2,9,2,0,29
Spring 2019,2/5/2019,Tuesday,8:30 AM,11,4,7,3,0,25
Spring 2019,2/5/2019,Tuesday,9:30 AM,13,5,22,6,1,47
Spring 2019,2/5/2019,Tuesday,10:30 AM,29,9,26,10,4,78
Spring 2019,2/5/2019,Tuesday,11:30 AM,14,4,15,6,2,41
Spring 2019,2/5/2019,Tuesday,12:30 PM,33,11,39,7,7,97
Spring 2019,2/5/2019,Tuesday,1:30 PM,19,9,23,2,0,53
Spring 2019,2/5/2019,Tuesday,3:30 PM,18,7,13,8,1,47
Spring 2019,2/5/2019,Tuesday,4:30 PM,23,4,9,5,1,42
Spring 2019,2/5/2019,Tuesday,5:30 PM,11,7,13,5,0,36
Spring 2019,2/5/2019,Tuesday,6:30 PM,7,3,5,2,0,17
Spring 2019,2/5/2019,Tuesday,7:30 PM,7,3,4,3,3,20
Spring 2019,2/5/2019,Tuesday,8:30 PM,4,2,5,0,0,11
Spring 2019,2/6/2019,Wednesday,7:30 AM,2,0,0,0,0,2
Spring 2019,2/6/2019,Wednesday,8:30 AM,16,3,10,3,0,32
Spring 2019,2/6/2019,Wednesday,9:30 AM,30,4,15,7,0,56
Spring 2019,2/6/2019,Wednesday,10:30 AM,33,6,23,9,3,74
Spring 2019,2/6/2019,Wednesday,12:30 PM,22,3,24,7,2,58
Spring 2019,2/6/2019,Wednesday,1:30 PM,22,7,17,2,0,48
Spring 2019,2/6/2019,Wednesday,2:30 PM,21,3,21,4,0,49
Spring 2019,2/6/2019,Wednesday,3:30 PM,21,4,14,1,5,45
Spring 2019,2/6/2019,Wednesday,5:30 PM,16,4,14,4,0,38
Spring 2019,2/6/2019,Wednesday,6:30 PM,14,4,10,4,0,32
Spring 2019,2/6/2019,Wednesday,7:30 PM,4,2,8,1,0,15
Spring 2019,2/6/2019,Wednesday,8:30 PM,9,2,6,2,0,19
Spring 2019,2/7/2019,Thursday,7:30 AM,2,0,0,0,1,3
Spring 2019,2/7/2019,Thursday,8:30 AM,12,2,2,4,0,20
Spring 2019,2/7/2019,Thursday,9:30 AM,18,3,18,1,2,42
Spring 2019,2/7/2019,Thursday,10:30 AM,28,7,30,7,2,74
Spring 2019,2/7/2019,Thursday,12:30 PM,37,12,42,8,7,106
Spring 2019,2/7/2019,Thursday,1:30 PM,20,11,12,5,2,50
Spring 2019,2/7/2019,Thursday,2:30 PM,16,3,16,7,2,44
Spring 2019,2/7/2019,Thursday,3:30 PM,18,4,11,5,0,38
Spring 2019,2/7/2019,Thursday,4:30 PM,10,2,15,5,2,34
Spring 2019,2/7/2019,Thursday,5:30 PM,4,3,10,4,0,21
Spring 2019,2/7/2019,Thursday,6:30 PM,8,4,4,0,0,16
Spring 2019,2/7/2019,Thursday,7:30 PM,10,2,4,2,0,18
Spring 2019,2/7/2019,Thursday,8:30 PM,8,1,1,2,0,12
Spring 2019,2/8/2019,Friday,7:30 AM,1,0,0,0,0,1
Spring 2019,2/8/2019,Friday,8:30 AM,6,0,0,0,0,6
Spring 2019,2/8/2019,Friday,10:30 AM,14,1,3,2,0,20
Spring 2019,2/8/2019,Friday,12:30 PM,11,3,3,0,1,18
Spring 2019,2/8/2019,Friday,1:30 PM,8,3,3,1,2,17
Spring 2019,2/8/2019,Friday,2:30 PM,5,1,5,0,1,12
Spring 2019,2/8/2019,Friday,5:30 PM,8,3,2,3,0,16
Spring 2019,2/8/2019,Friday,6:30 PM,9,3,5,2,0,19
Spring 2019,2/8/2019,Friday,7:30 PM,6,2,4,0,0,12
Spring 2019,2/8/2019,Friday,8:30 PM,7,2,3,0,0,12
Spring 2019,2/9/2019,Saturday,9:30 AM,4,0,1,0,0,5
Spring 2019,2/9/2019,Saturday,10:30 AM,2,0,6,0,0,8
Spring 2019,2/9/2019,Saturday,11:30 AM,4,1,5,0,0,10
Spring 2019,2/9/2019,Saturday,12:30 PM,5,7,7,4,0,23
Spring 2019,2/9/2019,Saturday,2:30 PM,9,3,6,0,0,18
Spring 2019,2/9/2019,Saturday,3:30 PM,10,2,5,1,0,18
Spring 2019,2/9/2019,Saturday,4:30 PM,8,3,5,0,0,16
Spring 2019,2/11/2019,Monday,7:30 AM,3,0,1,0,0,4
Spring 2019,2/11/2019,Monday,8:30 AM,15,1,4,1,0,21
Spring 2019,2/11/2019,Monday,9:30 AM,15,3,11,5,2,36
Spring 2019,2/11/2019,Monday,11:30 AM,25,5,27,16,4,77
Spring 2019,2/11/2019,Monday,1:30 PM,30,6,21,9,3,69
Spring 2019,2/11/2019,Monday,2:30 PM,27,9,28,3,4,71
Spring 2019,2/11/2019,Monday,3:30 PM,14,7,14,2,0,37
Spring 2019,2/11/2019,Monday,4:30 PM,30,5,17,3,0,55
Spring 2019,2/11/2019,Monday,5:30 PM,14,7,15,13,0,49
Spring 2019,2/11/2019,Monday,6:30 PM,6,2,11,1,0,20
Spring 2019,2/11/2019,Monday,7:30 PM,5,1,6,7,0,19
Spring 2019,2/11/2019,Monday,8:30 PM,9,1,12,5,0,27
Spring 2019,2/12/2019,Tuesday,7:30 AM,1,1,0,0,0,2
Spring 2019,2/12/2019,Tuesday,8:30 AM,9,3,4,1,5,22
Spring 2019,2/12/2019,Tuesday,9:30 AM,17,1,20,2,3,43
Spring 2019,2/12/2019,Tuesday,10:30 AM,24,5,34,8,4,75
Spring 2019,2/12/2019,Tuesday,11:30 AM,26,2,31,6,3,68
Spring 2019,2/12/2019,Tuesday,12:30 PM,39,9,43,7,7,105
Spring 2019,2/12/2019,Tuesday,1:30 PM,21,5,12,3,2,43
Spring 2019,2/12/2019,Tuesday,3:30 PM,11,4,13,1,0,29
Spring 2019,2/12/2019,Tuesday,4:30 PM,15,4,11,2,1,33
Spring 2019,2/12/2019,Tuesday,5:30 PM,8,8,8,2,0,26
Spring 2019,2/12/2019,Tuesday,6:30 PM,10,3,2,1,0,16
Spring 2019,2/12/2019,Tuesday,7:30 PM,7,1,2,0,0,10
Spring 2019,2/12/2019,Tuesday,8:30 PM,6,0,3,0,0,9
Spring 2019,2/13/2019,Wednesday,7:30 AM,3,0,0,0,0,3
Spring 2019,2/13/2019,Wednesday,8:30 AM,8,1,10,1,2,22
Spring 2019,2/13/2019,Wednesday,9:30 AM,13,8,10,3,0,34
Spring 2019,2/13/2019,Wednesday,10:30 AM,29,7,24,3,3,66
Spring 2019,2/13/2019,Wednesday,1:30 PM,25,5,24,13,3,70
Spring 2019,2/13/2019,Wednesday,2:30 PM,27,7,17,7,2,60
Spring 2019,2/13/2019,Wednesday,3:30 PM,19,5,16,3,1,44
Spring 2019,2/13/2019,Wednesday,4:30 PM,19,3,9,2,0,33
Spring 2019,2/13/2019,Wednesday,5:30 PM,12,4,17,1,0,34
Spring 2019,2/13/2019,Wednesday,7:30 PM,8,1,7,3,0,19
Spring 2019,2/13/2019,Wednesday,8:30 PM,11,1,6,1,0,19
Spring 2019,2/14/2019,Thursday,7:30 AM,9,2,0,0,3,14
Spring 2019,2/14/2019,Thursday,8:30 AM,19,2,4,3,0,28
Spring 2019,2/14/2019,Thursday,9:30 AM,18,4,20,6,4,52
Spring 2019,2/14/2019,Thursday,10:30 AM,30,6,20,12,5,73
Spring 2019,2/14/2019,Thursday,11:30 AM,25,10,12,4,1,52
Spring 2019,2/14/2019,Thursday,12:30 PM,22,7,28,7,0,64
Spring 2019,2/14/2019,Thursday,1:30 PM,20,5,8,0,2,35
Spring 2019,2/14/2019,Thursday,2:30 PM,22,7,10,9,2,50
Spring 2019,2/14/2019,Thursday,3:30 PM,20,5,15,4,0,44
Spring 2019,2/14/2019,Thursday,4:30 PM,20,3,14,5,0,42
Spring 2019,2/14/2019,Thursday,7:30 PM,9,0,1,4,0,14
Spring 2019,2/14/2019,Thursday,8:30 PM,4,0,0,2,0,6
Spring 2019,2/15/2019,Friday,7:30 AM,1,0,0,0,0,1
Spring 2019,2/15/2019,Friday,8:30 AM,4,0,0,0,0,4
Spring 2019,2/15/2019,Friday,9:30 AM,3,0,1,0,0,4
Spring 2019,2/15/2019,Friday,11:30 AM,6,3,4,0,1,14
Spring 2019,2/15/2019,Friday,12:30 PM,9,4,2,0,1,16
Spring 2019,2/15/2019,Friday,2:30 PM,8,3,1,0,0,12
Spring 2019,2/15/2019,Friday,5:30 PM,5,3,1,3,0,12
Spring 2019,2/15/2019,Friday,6:30 PM,9,1,3,3,0,16
Spring 2019,2/15/2019,Friday,7:30 PM,5,1,3,1,0,10
Spring 2019,2/15/2019,Friday,8:30 PM,2,1,2,0,0,5
Spring 2019,2/16/2019,Saturday,9:30 AM,0,0,2,0,0,2
Spring 2019,2/16/2019,Saturday,10:30 AM,4,2,3,0,1,10
Spring 2019,2/16/2019,Saturday,11:30 AM,7,2,4,0,2,15
Spring 2019,2/16/2019,Saturday,1:30 PM,7,1,2,2,2,14
Spring 2019,2/16/2019,Saturday,2:30 PM,4,1,3,1,0,9
Spring 2019,2/16/2019,Saturday,3:30 PM,8,2,7,2,0,19
Spring 2019,2/16/2019,Saturday,4:30 PM,7,0,3,1,0,11
Spring 2019,2/16/2019,Saturday,5:30 PM,3,0,0,2,0,5
Spring 2019,2/18/2019,Monday,7:30 AM,2,0,0,0,0,2
Spring 2019,2/18/2019,Monday,8:30 AM,9,2,10,2,0,23
Spring 2019,2/18/2019,Monday,9:30 AM,16,6,13,4,0,39
Spring 2019,2/18/2019,Monday,10:30 AM,24,13,28,7,4,76
Spring 2019,2/18/2019,Monday,2:30 PM,34,10,19,1,7,71
Spring 2019,2/18/2019,Monday,3:30 PM,25,7,13,3,3,51
Spring 2019,2/18/2019,Monday,4:30 PM,17,7,15,0,2,41
Spring 2019,2/18/2019,Monday,5:30 PM,24,7,17,0,1,49
Spring 2019,2/18/2019,Monday,7:30 PM,11,2,10,2,6,31
Spring 2019,2/18/2019,Monday,8:30 PM,6,1,9,2,2,20
Spring 2019,2/19/2019,Tuesday,7:30 AM,10,0,1,0,2,13
Spring 2019,2/19/2019,Tuesday,8:30 AM,6,1,9,4,3,23
Spring 2019,2/19/2019,Tuesday,10:30 AM,34,7,25,10,5,81
Spring 2019,2/19/2019,Tuesday,11:30 AM,21,5,27,3,3,59
Spring 2019,2/19/2019,Tuesday,12:30 PM,37,4,39,4,3,87
Spring 2019,2/19/2019,Tuesday,1:30 PM,25,6,14,4,2,51
Spring 2019,2/19/2019,Tuesday,2:30 PM,24,9,14,2,0,49
Spring 2019,2/19/2019,Tuesday,3:30 PM,20,6,12,4,0,42
Spring 2019,2/19/2019,Tuesday,4:30 PM,20,4,9,4,0,37
Spring 2019,2/19/2019,Tuesday,5:30 PM,19,3,9,5,1,37
Spring 2019,2/19/2019,Tuesday,6:30 PM,16,1,5,1,2,25
Spring 2019,2/19/2019,Tuesday,7:30 PM,17,0,6,1,1,25
Spring 2019,2/19/2019,Tuesday,8:30 PM,5,0,0,0,0,5
Spring 2019,2/20/2019,Wednesday,7:30 AM,4,0,0,0,0,4
Spring 2019,2/20/2019,Wednesday,8:30 AM,13,2,13,3,0,31
Spring 2019,2/20/2019,Wednesday,9:30 AM,23,5,12,4,1,45
Spring 2019,2/20/2019,Wednesday,10:30 AM,23,7,14,12,0,56
Spring 2019,2/20/2019,Wednesday,11:30 AM,24,10,24,4,0,62
Spring 2019,2/20/2019,Wednesday,12:30 PM,39,10,39,9,7,104
Spring 2019,2/20/2019,Wednesday,1:30 PM,34,6,15,14,3,72
Spring 2019,2/20/2019,Wednesday,2:30 PM,2,3,7,8,2,22
Spring 2019,2/20/2019,Wednesday,3:30 PM,17,5,10,3,3,38
Spring 2019,2/20/2019,Wednesday,4:30 PM,17,6,13,0,2,38
Spring 2019,2/20/2019,Wednesday,5:30 PM,11,3,12,1,0,27
Spring 2019,2/20/2019,Wednesday,6:30 PM,9,3,8,2,3,25
Spring 2019,2/20/2019,Wednesday,7:30 PM,2,2,10,6,0,20
Spring 2019,2/20/2019,Wednesday,8:30 PM,6,1,6,5,0,18
Spring 2019,2/21/2019,Thursday,8:30 AM,10,0,4,2,1,17
Spring 2019,2/21/2019,Thursday,9:30 AM,17,6,21,7,3,54
Spring 2019,2/21/2019,Thursday,10:30 AM,21,6,26,3,7,63
Spring 2019,2/21/2019,Thursday,11:30 AM,23,8,35,2,3,71
Spring 2019,2/21/2019,Thursday,12:30 PM,34,8,40,4,4,90
Spring 2019,2/21/2019,Thursday,1:30 PM,19,7,17,5,5,53
Spring 2019,2/21/2019,Thursday,2:30 PM,13,4,7,5,0,29
Spring 2019,2/21/2019,Thursday,3:30 PM,26,4,10,3,0,43
Spring 2019,2/21/2019,Thursday,4:30 PM,29,3,13,5,1,51
Spring 2019,2/21/2019,Thursday,5:30 PM,14,3,13,3,0,33
Spring 2019,2/21/2019,Thursday,6:30 PM,15,2,2,2,1,22
Spring 2019,2/21/2019,Thursday,8:30 PM,9,0,1,0,0,10
Spring 2019,2/22/2019,Friday,8:30 AM,3,0,1,1,0,5
Spring 2019,2/22/2019,Friday,9:30 AM,7,0,1,1,1,10
Spring 2019,2/22/2019,Friday,10:30 AM,11,6,3,4,0,24
Spring 2019,2/22/2019,Friday,12:30 PM,14,2,2,1,2,21
Spring 2019,2/22/2019,Friday,2:30 PM,8,1,4,0,0,13
Spring 2019,2/22/2019,Friday,5:30 PM,13,2,3,1,0,19
Spring 2019,2/22/2019,Friday,6:30 PM,5,2,5,1,0,13
Spring 2019,2/22/2019,Friday,7:30 PM,7,0,4,1,0,12
Spring 2019,2/22/2019,Friday,8:30 PM,1,0,0,0,0,1
Spring 2019,2/22/2019,Saturday,9:30 AM,2,0,2,0,0,4
Spring 2019,2/23/2019,Saturday,10:30 AM,4,0,5,0,0,9
Spring 2019,2/23/2019,Saturday,11:30 AM,8,0,5,0,0,13
Spring 2019,2/23/2019,Saturday,12:30 PM,5,1,12,0,0,18
Spring 2019,2/23/2019,Saturday,1:30 PM,9,1,6,0,0,16
Spring 2019,2/23/2019,Saturday,2:30 PM,6,1,5,0,0,12
Spring 2019,2/23/2019,Saturday,3:30 PM,9,3,4,0,0,16
Spring 2019,2/23/2019,Saturday,4:30 PM,9,2,5,0,2,18
Spring 2019,2/23/2019,Saturday,5:30 PM,1,1,0,0,0,2
Spring 2019,2/25/2019,Monday,7:30 AM,4,0,1,0,0,5
Spring 2019,2/25/2019,Monday,8:30 AM,14,3,7,1,0,25
Spring 2019,2/25/2019,Monday,9:30 AM,18,4,13,8,3,46
Spring 2019,2/25/2019,Monday,10:30 AM,20,12,17,11,2,62
Spring 2019,2/25/2019,Monday,11:30 AM,23,6,21,10,4,64
Spring 2019,2/25/2019,Monday,12:30 PM,38,14,33,18,4,107
Spring 2019,2/25/2019,Monday,1:30 PM,25,7,15,5,2,54
Spring 2019,2/25/2019,Monday,2:30 PM,16,7,19,2,1,45
Spring 2019,2/25/2019,Monday,3:30 PM,25,5,10,3,1,44
Spring 2019,2/25/2019,Monday,4:30 PM,24,5,6,5,2,42
Spring 2019,2/25/2019,Monday,5:30 PM,11,7,29,6,4,57
Spring 2019,2/25/2019,Monday,6:30 PM,4,4,8,3,1,20
Spring 2019,2/25/2019,Monday,7:30 PM,7,2,3,2,1,15
Spring 2019,2/25/2019,Monday,8:30 PM,7,2,6,2,1,18
Spring 2019,2/26/2019,Tuesday,7:30 AM,2,1,1,0,0,4
Spring 2019,2/26/2019,Tuesday,8:30 AM,7,2,10,2,1,22
Spring 2019,2/26/2019,Tuesday,10:30 AM,13,5,23,0,2,43
Spring 2019,2/26/2019,Tuesday,11:30 AM,25,7,20,2,2,56
Spring 2019,2/26/2019,Tuesday,1:30 PM,21,6,14,3,4,48
Spring 2019,2/26/2019,Tuesday,3:30 PM,15,2,17,6,0,40
Spring 2019,2/26/2019,Tuesday,4:30 PM,16,4,9,7,0,36
Spring 2019,2/26/2019,Tuesday,5:30 PM,13,4,7,4,1,29
Spring 2019,2/26/2019,Tuesday,6:30 PM,10,0,9,2,0,21
Spring 2019,2/26/2019,Tuesday,7:30 PM,13,0,7,1,0,21
Spring 2019,2/26/2019,Tuesday,8:30 PM,4,1,3,0,0,8
Spring 2019,2/27/2019,Wednesday,7:30 AM,0,0,0,0,0,0
Spring 2019,2/27/2019,Wednesday,8:30 AM,10,2,8,2,1,23
Spring 2019,2/27/2019,Wednesday,9:30 AM,19,4,16,6,2,47
Spring 2019,2/27/2019,Wednesday,11:30 AM,17,6,24,3,3,53
Spring 2019,2/27/2019,Wednesday,12:30 PM,23,11,26,7,2,69
Spring 2019,2/27/2019,Wednesday,1:30 PM,24,9,14,0,3,50
Spring 2019,2/27/2019,Wednesday,2:30 PM,15,7,12,7,3,44
Spring 2019,2/27/2019,Wednesday,3:30 PM,19,5,17,6,0,47
Spring 2019,2/27/2019,Wednesday,4:30 PM,23,5,12,6,0,46
Spring 2019,2/27/2019,Wednesday,6:30 PM,10,1,4,2,2,19
Spring 2019,2/27/2019,Wednesday,7:30 PM,14,1,3,1,0,19
Spring 2019,2/27/2019,Wednesday,8:30 PM,5,0,0,0,0,5
Spring 2019,2/28/2019,Thursday,7:30 AM,1,0,0,0,0,1
Spring 2019,2/28/2019,Thursday,8:30 AM,1,0,2,0,0,3
Spring 2019,2/28/2019,Thursday,9:30 AM,3,0,1,0,0,4
Spring 2019,2/28/2019,Thursday,10:30 AM,3,0,1,0,0,4
Spring 2019,2/28/2019,Thursday,11:30 AM,7,0,1,1,1,10
Spring 2019,2/28/2019,Thursday,12:30 PM,7,0,1,2,2,12
Spring 2019,2/28/2019,Thursday,1:30 PM,2,1,3,1,1,8
Spring 2019,2/28/2019,Thursday,5:30 PM,5,3,6,4,0,18
Spring 2019,2/28/2019,Thursday,6:30 PM,11,3,6,5,0,25
Spring 2019,2/28/2019,Thursday,7:30 PM,5,3,5,1,0,14
Spring 2019,2/28/2019,Thursday,8:30 PM,5,0,0,0,0,5
Spring 2019,3/1/2019,Friday,7:30 AM,1,0,0,0,0,1
Spring 2019,3/1/2019,Friday,8:30 AM,1,0,2,0,0,3
Spring 2019,3/1/2019,Friday,9:30 AM,3,0,11,0,0,14
Spring 2019,3/1/2019,Friday,10:30 AM,3,0,1,0,0,4
Spring 2019,3/1/2019,Friday,11:30 AM,7,0,1,1,1,10
Spring 2019,3/1/2019,Friday,12:30 PM,7,0,1,2,2,12
Spring 2019,3/1/2019,Friday,1:30 PM,2,1,3,1,1,8
Spring 2019,3/1/2019,Friday,5:30 PM,5,3,6,4,0,18
Spring 2019,3/1/2019,Friday,6:30 PM,11,3,6,5,0,25
Spring 2019,3/1/2019,Friday,7:30 PM,5,3,5,1,0,14
Spring 2019,3/1/2019,Friday,8:30 PM,1,2,3,2,0,8
Spring 2019,3/2/2019,Saturday,10:30 AM,3,1,1,0,0,5
Spring 2019,3/2/2019,Saturday,11:30 AM,9,0,3,1,0,13
Spring 2019,3/2/2019,Saturday,12:30 PM,5,1,4,0,0,10
Spring 2019,3/2/2019,Saturday,1:30 PM,7,1,2,0,0,10
Spring 2019,3/2/2019,Saturday,2:30 PM,4,0,3,3,0,10
Spring 2019,3/2/2019,Saturday,3:30 PM,10,0,3,2,0,15
Spring 2019,3/2/2019,Saturday,4:30 PM,12,1,3,6,0,22
Spring 2019,3/4/2019,Monday,10:30 AM,22,5,14,5,0,46
Spring 2019,3/4/2019,Monday,1:30 PM,25,4,14,2,1,46
Spring 2019,3/4/2019,Monday,2:30 PM,28,5,17,4,4,58
Spring 2019,3/4/2019,Monday,3:30 PM,22,3,12,3,2,42
Spring 2019,3/4/2019,Monday,4:30 PM,20,6,15,5,0,46
Spring 2019,3/4/2019,Monday,5:30 PM,12,4,25,11,1,53
Spring 2019,3/4/2019,Monday,6:30 PM,8,4,8,4,2,26
Spring 2019,3/4/2019,Monday,7:30 PM,7,2,10,2,0,21
Spring 2019,3/4/2019,Monday,8:30 PM,9,2,5,2,0,18
Spring 2019,3/5/2019,Tuesday,9:30 AM,15,3,16,3,2,39
Spring 2019,3/5/2019,Tuesday,10:30 AM,24,7,21,3,3,58
Spring 2019,3/5/2019,Tuesday,1:30 PM,23,10,23,4,2,62
Spring 2019,3/5/2019,Tuesday,2:30 PM,20,10,12,1,1,44
Spring 2019,3/5/2019,Tuesday,3:30 PM,15,5,18,3,0,41
Spring 2019,3/5/2019,Tuesday,4:30 PM,13,9,16,4,0,42
Spring 2019,3/5/2019,Tuesday,5:30 PM,10,8,10,0,1,29
Spring 2019,3/5/2019,Tuesday,6:30 PM,16,3,7,2,0,28
Spring 2019,3/5/2019,Tuesday,7:30 PM,9,4,6,2,0,21
Spring 2019,3/5/2019,Tuesday,8:30 PM,10,3,6,0,0,19
Spring 2019,3/6/2019,Wednesday,7:30 AM,1,0,0,0,0,1
Spring 2019,3/6/2019,Wednesday,8:30 AM,17,9,8,3,1,38
Spring 2019,3/6/2019,Wednesday,9:30 AM,21,5,17,5,0,48
Spring 2019,3/6/2019,Wednesday,10:30 AM,32,13,26,13,4,88
Spring 2019,3/6/2019,Wednesday,11:30 AM,24,14,24,12,6,80
Spring 2019,3/6/2019,Wednesday,1:30 PM,30,8,23,8,2,71
Spring 2019,3/6/2019,Wednesday,2:30 PM,31,8,14,2,4,59
Spring 2019,3/6/2019,Wednesday,3:30 PM,21,7,13,3,3,47
Spring 2019,3/6/2019,Wednesday,4:30 PM,18,6,12,4,0,40
Spring 2019,3/6/2019,Wednesday,5:30 PM,16,3,6,4,0,29
Spring 2019,3/6/2019,Wednesday,8:30 PM,9,5,5,1,0,20
Spring 2019,3/7/2019,Thursday,7:30 AM,11,0,1,1,0,13
Spring 2019,3/7/2019,Thursday,8:30 AM,18,1,9,5,0,33
Spring 2019,3/7/2019,Thursday,9:30 AM,14,3,14,3,0,34
Spring 2019,3/7/2019,Thursday,10:30 AM,17,8,24,15,1,65
Spring 2019,3/7/2019,Thursday,11:30 AM,18,4,20,4,1,47
Spring 2019,3/7/2019,Thursday,12:30 PM,33,7,39,8,5,92
Spring 2019,3/7/2019,Thursday,1:30 PM,11,6,9,1,0,27
Spring 2019,3/7/2019,Thursday,2:30 PM,13,7,14,4,0,38
Spring 2019,3/7/2019,Thursday,3:30 PM,27,7,8,2,6,50
Spring 2019,3/7/2019,Thursday,4:30 PM,29,7,12,2,2,52
Spring 2019,3/7/2019,Thursday,5:30 PM,20,3,9,4,0,36
Spring 2019,3/7/2019,Thursday,6:30 PM,14,2,7,3,0,26
Spring 2019,3/7/2019,Thursday,7:30 PM,7,3,4,4,0,18
Spring 2019,3/7/2019,Thursday,8:30 PM,4,2,3,2,0,11
Spring 2019,3/8/2019,Friday,7:30 AM,1,0,1,0,0,2
Spring 2019,3/8/2019,Friday,8:30 AM,5,0,1,1,0,7
Spring 2019,3/8/2019,Friday,9:30 AM,9,1,4,4,1,19
Spring 2019,3/8/2019,Friday,10:30 AM,11,2,4,2,4,23
Spring 2019,3/8/2019,Friday,11:30 AM,6,2,3,1,1,13
Spring 2019,3/8/2019,Friday,12:30 PM,11,4,6,0,0,21
Spring 2019,3/8/2019,Friday,1:30 PM,10,5,6,0,0,21
Spring 2019,3/8/2019,Friday,5:30 PM,5,5,1,3,0,14
Spring 2019,3/8/2019,Friday,6:30 PM,6,3,4,2,0,15
Spring 2019,3/8/2019,Friday,7:30 PM,6,4,6,0,0,16
Spring 2019,3/8/2019,Friday,8:30 PM,6,2,4,0,0,12
Spring 2019,3/9/2019,Saturday,9:30 AM,1,0,0,0,0,1
Spring 2019,3/9/2019,Saturday,10:30 AM,5,0,5,0,0,10
Spring 2019,3/9/2019,Saturday,11:30 AM,6,0,4,0,0,10
Spring 2019,3/9/2019,Saturday,1:30 PM,11,1,3,1,0,16
Spring 2019,3/9/2019,Saturday,2:30 PM,19,1,7,1,0,28
Spring 2019,3/9/2019,Saturday,3:30 PM,10,1,5,1,0,17
Spring 2019,3/9/2019,Saturday,4:30 PM,13,0,3,2,0,18
Spring 2019,3/9/2019,Saturday,5:30 PM,0,0,0,0,0,0
Spring 2019,3/11/2019,Monday,7:30 AM,3,0,0,0,0,3
Spring 2019,3/11/2019,Monday,8:30 AM,9,5,5,2,0,21
Spring 2019,3/11/2019,Monday,9:30 AM,15,5,14,7,0,41
Spring 2019,3/11/2019,Monday,10:30 AM,25,6,19,6,5,61
Spring 2019,3/11/2019,Monday,11:30 AM,22,7,22,12,0,63
Spring 2019,3/11/2019,Monday,12:30 PM,34,13,30,13,1,91
Spring 2019,3/11/2019,Monday,1:30 PM,26,8,14,9,1,58
Spring 2019,3/11/2019,Monday,2:30 PM,26,7,20,3,2,58
Spring 2019,3/11/2019,Monday,3:30 PM,19,8,12,0,2,41
Spring 2019,3/11/2019,Monday,4:30 PM,32,11,9,0,3,55
Spring 2019,3/11/2019,Monday,5:30 PM,26,10,12,2,1,51
Spring 2019,3/12/2019,Tuesday,8:30 AM,4,1,3,2,0,10
Spring 2019,3/12/2019,Tuesday,9:30 AM,13,4,16,0,3,36
Spring 2019,3/12/2019,Tuesday,10:30 AM,27,7,28,8,1,71
Spring 2019,3/12/2019,Tuesday,11:30 AM,23,4,22,6,2,57
Spring 2019,3/12/2019,Tuesday,1:30 PM,14,11,14,3,7,49
Spring 2019,3/12/2019,Tuesday,2:30 PM,11,9,13,3,3,39
Spring 2019,3/12/2019,Tuesday,3:30 PM,19,4,13,4,0,40
Spring 2019,3/12/2019,Tuesday,4:30 PM,14,7,11,3,1,36
Spring 2019,3/12/2019,Tuesday,5:30 PM,19,7,11,8,3,48
Spring 2019,3/12/2019,Tuesday,7:30 PM,15,0,8,4,3,30
Spring 2019,3/12/2019,Tuesday,8:30 PM,11,1,7,0,1,20
Spring 2019,3/13/2019,Wednesday,7:30 AM,3,0,1,0,0,4
Spring 2019,3/13/2019,Wednesday,8:30 AM,10,5,11,1,0,27
Spring 2019,3/13/2019,Wednesday,9:30 AM,14,5,15,3,2,39
Spring 2019,3/13/2019,Wednesday,10:30 AM,28,10,27,10,2,77
Spring 2019,3/13/2019,Wednesday,11:30 AM,17,12,24,9,1,63
Spring 2019,3/13/2019,Wednesday,12:30 PM,26,13,46,15,3,103
Spring 2019,3/13/2019,Wednesday,1:30 PM,16,14,16,9,1,56
Spring 2019,3/13/2019,Wednesday,2:30 PM,25,6,2,4,3,40
Spring 2019,3/13/2019,Wednesday,3:30 PM,25,8,9,2,1,45
Spring 2019,3/13/2019,Wednesday,4:30 PM,28,8,14,1,1,52
Spring 2019,3/13/2019,Wednesday,5:30 PM,12,4,12,2,3,33
Spring 2019,3/13/2019,Wednesday,6:30 PM,14,4,13,1,1,33
Spring 2019,3/13/2019,Wednesday,7:30 PM,17,2,11,1,0,31
Spring 2019,3/13/2019,Wednesday,8:30 PM,9,1,1,2,1,14
Spring 2019,3/14/2019,Thursday,7:30 AM,8,0,0,0,0,8
Spring 2019,3/14/2019,Thursday,8:30 AM,12,1,9,3,0,25
Spring 2019,3/14/2019,Thursday,9:30 AM,15,4,25,2,5,51
Spring 2019,3/14/2019,Thursday,10:30 AM,19,7,25,11,2,64
Spring 2019,3/14/2019,Thursday,11:30 AM,25,7,14,6,3,55
Spring 2019,3/14/2019,Thursday,12:30 PM,22,11,31,5,3,72
Spring 2019,3/14/2019,Thursday,1:30 PM,20,7,17,0,1,45
Spring 2019,3/14/2019,Thursday,2:30 PM,20,4,11,7,0,42
Spring 2019,3/14/2019,Thursday,3:30 PM,22,6,9,6,5,48
Spring 2019,3/14/2019,Thursday,4:30 PM,24,4,5,3,6,42
Spring 2019,3/14/2019,Thursday,5:30 PM,26,2,10,3,4,45
Spring 2019,3/14/2019,Thursday,6:30 PM,9,1,7,1,2,20
Spring 2019,3/14/2019,Thursday,8:30 PM,3,1,0,2,0,6
Spring 2019,3/15/2019,Friday,7:30 AM,1,0,0,0,0,1
Spring 2019,3/15/2019,Friday,8:30 AM,4,0,0,0,0,4
Spring 2019,3/15/2019,Friday,9:30 AM,3,0,0,0,0,3
Spring 2019,3/15/2019,Friday,11:30 AM,9,0,0,0,1,10
Spring 2019,3/15/2019,Friday,12:30 PM,10,0,0,0,1,11
Spring 2019,3/15/2019,Friday,1:30 PM,3,0,2,0,2,7
Spring 2019,3/15/2019,Friday,2:30 PM,7,0,3,0,1,11
Spring 2019,3/15/2019,Friday,5:30 PM,4,0,1,0,1,6
Spring 2019,3/15/2019,Friday,6:30 PM,7,0,2,0,0,9
Spring 2019,3/15/2019,Friday,7:30 PM,5,1,2,0,0,8
Spring 2019,3/15/2019,Friday,8:30 PM,5,0,0,0,0,5
Spring 2019,3/16/2019,Saturday,10:30 AM,3,0,0,1,3,7
Spring 2019,3/16/2019,Saturday,11:30 AM,5,0,0,0,5,10
Spring 2019,3/16/2019,Saturday,12:30 PM,5,0,1,0,4,10
Spring 2019,3/16/2019,Saturday,1:30 PM,9,2,1,0,1,13
Spring 2019,3/16/2019,Saturday,2:30 PM,7,2,0,0,0,9
Spring 2019,3/16/2019,Saturday,3:30 PM,4,1,0,0,0,5
Spring 2019,3/16/2019,Saturday,4:30 PM,3,0,3,0,0,6
Spring 2019,3/16/2019,Saturday,5:30 PM,3,0,0,0,0,3
Spring 2019,3/25/2019,Monday,7:30 AM,7,0,1,0,1,9
Spring 2019,3/25/2019,Monday,8:30 AM,15,3,8,2,0,28
Spring 2019,3/25/2019,Monday,9:30 AM,21,4,14,5,0,44
Spring 2019,3/25/2019,Monday,10:30 AM,22,7,27,7,0,63
Spring 2019,3/25/2019,Monday,11:30 AM,37,4,21,8,0,70
Spring 2019,3/25/2019,Monday,12:30 PM,30,10,30,10,0,80
Spring 2019,3/25/2019,Monday,1:30 PM,39,9,25,11,1,85
Spring 2019,3/25/2019,Monday,2:30 PM,15,7,13,0,0,35
Spring 2019,3/25/2019,Monday,3:30 PM,20,6,8,1,3,38
Spring 2019,3/25/2019,Monday,4:30 PM,31,3,9,0,0,43
Spring 2019,3/25/2019,Monday,6:30 PM,8,2,4,0,1,15
Spring 2019,3/25/2019,Monday,7:30 PM,11,2,5,0,0,18
Spring 2019,3/25/2019,Monday,8:30 PM,7,4,1,0,1,13
Spring 2019,3/26/2019,Tuesday,7:30 AM,2,1,3,0,0,6
Spring 2019,3/26/2019,Tuesday,8:30 AM,4,1,3,0,2,10
Spring 2019,3/26/2019,Tuesday,9:30 AM,18,2,6,3,2,31
Spring 2019,3/26/2019,Tuesday,10:30 AM,20,7,26,10,6,69
Spring 2019,3/26/2019,Tuesday,11:30 AM,42,6,25,3,5,81
Spring 2019,3/26/2019,Tuesday,12:30 PM,44,9,31,7,4,95
Spring 2019,3/26/2019,Tuesday,1:30 PM,34,9,15,3,2,63
Spring 2019,3/26/2019,Tuesday,2:30 PM,29,8,14,7,5,63
Spring 2019,3/26/2019,Tuesday,3:30 PM,23,5,13,2,3,46
Spring 2019,3/26/2019,Tuesday,5:30 PM,12,7,13,3,1,36
Spring 2019,3/26/2019,Tuesday,6:30 PM,6,3,4,3,0,16
Spring 2019,3/26/2019,Tuesday,7:30 PM,8,2,2,2,1,15
Spring 2019,3/26/2019,Tuesday,8:30 PM,6,1,5,2,0,14
Spring 2019,3/27/2019,Wednesday,7:30 AM,3,0,0,0,1,4
Spring 2019,3/27/2019,Wednesday,8:30 AM,11,2,7,1,0,21
Spring 2019,3/27/2019,Wednesday,9:30 AM,14,2,16,4,0,36
Spring 2019,3/27/2019,Wednesday,10:30 AM,22,5,22,7,0,56
Spring 2019,3/27/2019,Wednesday,11:30 AM,18,8,18,8,0,52
Spring 2019,3/27/2019,Wednesday,12:30 PM,28,14,40,5,0,87
Spring 2019,3/27/2019,Wednesday,1:30 PM,23,8,19,4,1,55
Spring 2019,3/27/2019,Wednesday,2:30 PM,24,7,18,0,2,51
Spring 2019,3/27/2019,Wednesday,3:30 PM,16,6,11,1,2,36
Spring 2019,3/27/2019,Wednesday,4:30 PM,18,6,10,1,2,37
Spring 2019,3/27/2019,Wednesday,5:30 PM,16,5,12,1,0,34
Spring 2019,3/27/2019,Wednesday,6:30 PM,9,2,12,1,1,25
Spring 2019,3/27/2019,Wednesday,7:30 PM,10,1,7,1,0,19
Spring 2019,3/27/2019,Wednesday,8:30 PM,9,1,4,1,0,15
Spring 2019,3/28/2019,Thursday,7:30 AM,4,0,2,0,0,6
Spring 2019,3/28/2019,Thursday,8:30 AM,10,0,3,1,1,15
Spring 2019,3/28/2019,Thursday,9:30 AM,7,1,7,4,2,21
Spring 2019,3/28/2019,Thursday,10:30 AM,18,2,24,3,1,48
Spring 2019,3/28/2019,Thursday,11:30 AM,27,6,17,5,3,58
Spring 2019,3/28/2019,Thursday,12:30 PM,34,13,38,9,5,99
Spring 2019,3/28/2019,Thursday,1:30 PM,32,8,20,2,3,65
Spring 2019,3/28/2019,Thursday,2:30 PM,18,6,11,6,0,41
Spring 2019,3/28/2019,Thursday,3:30 PM,24,6,12,4,3,49
Spring 2019,3/28/2019,Thursday,4:30 PM,16,3,16,6,0,41
Spring 2019,3/28/2019,Thursday,6:30 PM,8,3,8,1,0,20
Spring 2019,3/28/2019,Thursday,7:30 PM,6,2,4,0,0,12
Spring 2019,3/28/2019,Thursday,8:30 PM,7,1,2,0,0,10
Spring 2019,3/29/2019,Friday,7:30 AM,0,0,0,0,0,0
Spring 2019,3/29/2019,Friday,8:30 AM,0,1,0,0,0,1
Spring 2019,3/29/2019,Friday,9:30 AM,5,1,2,0,0,8
Spring 2019,3/29/2019,Friday,10:30 AM,6,0,1,0,0,7
Spring 2019,3/29/2019,Friday,11:30 AM,6,2,4,5,2,19
Spring 2019,3/29/2019,Friday,12:30 PM,8,2,7,2,1,20
Spring 2019,3/29/2019,Friday,5:30 PM,5,1,3,0,0,9
Spring 2019,3/29/2019,Friday,6:30 PM,3,3,3,0,0,9
Spring 2019,3/29/2019,Friday,7:30 PM,6,1,5,0,0,12
Spring 2019,3/29/2019,Friday,8:30 PM,2,3,2,0,0,7
Spring 2019,3/30/2019,Saturday,9:30 AM,0,0,0,0,0,0
Spring 2019,3/30/2019,Saturday,10:30 AM,0,0,0,0,0,0
Spring 2019,3/30/2019,Saturday,11:30 AM,8,1,2,0,0,11
Spring 2019,3/30/2019,Saturday,12:30 PM,2,1,3,2,1,9
Spring 2019,3/30/2019,Saturday,1:30 PM,5,0,2,1,0,8
Spring 2019,3/30/2019,Saturday,2:30 PM,4,0,2,3,1,10
Spring 2019,3/30/2019,Saturday,3:30 PM,4,0,3,0,1,8
Spring 2019,3/30/2019,Saturday,4:30 PM,3,0,2,0,0,5
Spring 2019,3/30/2019,Saturday,5:30 PM,0,1,1,0,4,6
Spring 2019,4/1/2019,Monday,7:30 AM,4,0,1,0,0,5
Spring 2019,4/1/2019,Monday,8:30 AM,14,2,7,0,0,23
Spring 2019,4/1/2019,Monday,9:30 AM,25,4,7,5,6,47
Spring 2019,4/1/2019,Monday,10:30 AM,27,7,14,7,3,58
Spring 2019,4/1/2019,Monday,11:30 AM,18,8,15,9,0,50
Spring 2019,4/1/2019,Monday,12:30 PM,43,15,42,18,0,118
Spring 2019,4/1/2019,Monday,1:30 PM,20,4,25,12,1,62
Spring 2019,4/1/2019,Monday,2:30 PM,26,6,27,3,2,64
Spring 2019,4/1/2019,Monday,4:30 PM,27,4,19,2,1,53
Spring 2019,4/1/2019,Monday,5:30 PM,15,8,11,1,1,36
Spring 2019,4/1/2019,Monday,6:30 PM,8,4,10,1,0,23
Spring 2019,4/1/2019,Monday,7:30 PM,10,2,8,1,0,21
Spring 2019,4/1/2019,Monday,8:30 PM,5,3,9,0,3,20
Spring 2019,4/2/2019,Tuesday,7:30 AM,2,0,0,0,0,2
Spring 2019,4/2/2019,Tuesday,8:30 AM,7,1,5,2,1,16
Spring 2019,4/2/2019,Tuesday,9:30 AM,11,1,9,1,1,23
Spring 2019,4/2/2019,Tuesday,10:30 AM,19,6,14,4,1,44
Spring 2019,4/2/2019,Tuesday,11:30 AM,20,11,20,5,0,56
Spring 2019,4/2/2019,Tuesday,12:30 PM,45,14,43,13,0,115
Spring 2019,4/2/2019,Tuesday,1:30 PM,30,6,17,3,3,59
Spring 2019,4/2/2019,Tuesday,2:30 PM,12,8,13,25,3,61
Spring 2019,4/2/2019,Tuesday,3:30 PM,15,5,12,3,1,36
Spring 2019,4/2/2019,Tuesday,4:30 PM,10,4,8,4,0,26
Spring 2019,4/2/2019,Tuesday,5:30 PM,10,6,10,0,1,27
Spring 2019,4/2/2019,Tuesday,6:30 PM,7,4,5,0,0,16
Spring 2019,4/2/2019,Tuesday,7:30 PM,20,5,7,0,2,34
Spring 2019,4/3/2019,Wednesday,7:30 AM,3,0,1,0,0,4
Spring 2019,4/3/2019,Wednesday,8:30 AM,10,2,9,2,0,23
Spring 2019,4/3/2019,Wednesday,9:30 AM,11,7,20,4,5,47
Spring 2019,4/3/2019,Wednesday,10:30 AM,34,7,21,10,0,72
Spring 2019,4/3/2019,Wednesday,11:30 AM,18,10,24,4,1,57
Spring 2019,4/3/2019,Wednesday,12:30 PM,36,14,37,10,2,99
Spring 2019,4/3/2019,Wednesday,1:30 PM,15,8,11,11,2,47
Spring 2019,4/3/2019,Wednesday,2:30 PM,27,7,14,4,2,54
Spring 2019,4/3/2019,Wednesday,3:30 PM,15,5,14,2,1,37
Spring 2019,4/3/2019,Wednesday,4:30 PM,12,3,7,3,0,25
Spring 2019,4/3/2019,Wednesday,6:30 PM,18,3,10,1,2,34
Spring 2019,4/3/2019,Wednesday,7:30 PM,16,3,3,0,2,24
Spring 2019,4/3/2019,Wednesday,8:30 PM,14,1,4,0,0,19
Spring 2019,4/4/2019,Thursday,7:30 AM,4,0,0,0,0,4
Spring 2019,4/4/2019,Thursday,8:30 AM,7,0,7,1,0,15
Spring 2019,4/4/2019,Thursday,9:30 AM,11,2,18,4,1,36
Spring 2019,4/4/2019,Thursday,10:30 AM,30,4,27,2,1,64
Spring 2019,4/4/2019,Thursday,11:30 AM,16,4,14,3,1,38
Spring 2019,4/4/2019,Thursday,12:30 PM,31,7,27,5,2,72
Spring 2019,4/4/2019,Thursday,1:30 PM,15,14,12,1,0,42
Spring 2019,4/4/2019,Thursday,2:30 PM,29,8,12,7,0,56
Spring 2019,4/4/2019,Thursday,3:30 PM,20,6,8,6,0,40
Spring 2019,4/4/2019,Thursday,5:30 PM,22,3,13,4,0,42
Spring 2019,4/4/2019,Thursday,6:30 PM,6,3,9,2,0,20
Spring 2019,4/4/2019,Thursday,7:30 PM,7,4,5,2,0,18
Spring 2019,4/4/2019,Thursday,8:30 PM,4,2,4,1,0,11
Spring 2019,4/5/2019,Friday,7:30 AM,2,0,0,0,0,2
Spring 2019,4/5/2019,Friday,8:30 AM,3,0,0,0,1,4
Spring 2019,4/5/2019,Friday,9:30 AM,9,1,8,1,0,19
Spring 2019,4/5/2019,Friday,10:30 AM,5,0,2,1,0,8
Spring 2019,4/5/2019,Friday,11:30 AM,15,2,0,2,1,20
Spring 2019,4/5/2019,Friday,5:30 PM,10,4,7,1,0,22
Spring 2019,4/5/2019,Friday,6:30 PM,7,1,3,1,0,12
Spring 2019,4/5/2019,Friday,7:30 PM,9,0,4,1,0,14
Spring 2019,4/5/2019,Friday,8:30 PM,4,1,4,2,0,11
Spring 2019,4/6/2019,Saturday,9:30 AM,0,0,0,1,0,1
Spring 2019,4/6/2019,Saturday,10:30 AM,2,1,5,1,0,9
Spring 2019,4/6/2019,Saturday,11:30 AM,2,3,6,0,0,11
Spring 2019,4/6/2019,Saturday,12:30 PM,7,2,5,1,0,15
Spring 2019,4/6/2019,Saturday,1:30 PM,0,4,5,4,0,13
Spring 2019,4/6/2019,Saturday,2:30 PM,8,2,3,0,0,13
Spring 2019,4/6/2019,Saturday,3:30 PM,11,0,3,0,0,14
Spring 2019,4/6/2019,Saturday,4:30 PM,6,0,4,0,0,10
Spring 2019,4/6/2019,Saturday,5:30 PM,2,0,0,0,0,2
Spring 2019,4/8/2019,Monday,7:30 AM,7,0,1,0,0,8
Spring 2019,4/8/2019,Monday,8:30 AM,11,2,6,1,0,20
Spring 2019,4/8/2019,Monday,9:30 AM,17,3,10,3,0,33
Spring 2019,4/8/2019,Monday,10:30 AM,26,3,16,7,0,52
Spring 2019,4/8/2019,Monday,11:30 AM,18,4,21,5,4,52
Spring 2019,4/8/2019,Monday,12:30 PM,34,11,43,13,3,104
Spring 2019,4/8/2019,Monday,1:30 PM,32,5,22,8,2,69
Spring 2019,4/8/2019,Monday,2:30 PM,26,5,16,4,2,53
Spring 2019,4/8/2019,Monday,3:30 PM,18,6,8,1,0,33
Spring 2019,4/8/2019,Monday,4:30 PM,9,7,1,2,0,19
Spring 2019,4/8/2019,Monday,5:30 PM,9,7,1,2,0,19
Spring 2019,4/8/2019,Monday,6:30 PM,8,3,1,0,1,13
Spring 2019,4/8/2019,Monday,7:30 PM,17,0,6,0,0,23
Spring 2019,4/8/2019,Monday,8:30 PM,5,1,3,0,1,10
Spring 2019,4/9/2019,Tuesday,7:30 AM,1,0,0,0,0,1
Spring 2019,4/9/2019,Tuesday,8:30 AM,12,5,8,20,0,45
Spring 2019,4/9/2019,Tuesday,9:30 AM,18,1,11,5,1,36
Spring 2019,4/9/2019,Tuesday,10:30 AM,26,5,19,7,3,60
Spring 2019,4/9/2019,Tuesday,11:30 AM,30,9,23,7,2,71
Spring 2019,4/9/2019,Tuesday,12:30 PM,44,5,33,12,4,98
Spring 2019,4/9/2019,Tuesday,1:30 PM,24,6,15,7,0,52
Spring 2019,4/9/2019,Tuesday,2:30 PM,18,2,12,8,1,41
Spring 2019,4/9/2019,Tuesday,3:30 PM,14,2,11,2,0,29
Spring 2019,4/9/2019,Tuesday,4:30 PM,14,1,8,3,1,27
Spring 2019,4/9/2019,Tuesday,5:30 PM,12,5,12,3,0,32
Spring 2019,4/9/2019,Tuesday,6:30 PM,9,3,7,1,0,20
Spring 2019,4/9/2019,Tuesday,7:30 PM,9,4,11,0,0,24
Spring 2019,4/9/2019,Tuesday,8:30 PM,4,4,11,0,0,19
Spring 2019,4/10/2019,Wednesday,7:30 AM,1,0,1,0,0,2
Spring 2019,4/10/2019,Wednesday,8:30 AM,9,2,9,1,0,21
Spring 2019,4/10/2019,Wednesday,9:30 AM,17,4,12,3,0,36
Spring 2019,4/10/2019,Wednesday,10:30 AM,26,5,31,8,0,70
Spring 2019,4/10/2019,Wednesday,11:30 AM,26,5,21,10,1,63
Spring 2019,4/10/2019,Wednesday,12:30 PM,36,12,34,14,2,98
Spring 2019,4/10/2019,Wednesday,1:30 PM,29,5,17,2,2,55
Spring 2019,4/10/2019,Wednesday,2:30 PM,21,4,14,0,2,41
Spring 2019,4/10/2019,Wednesday,3:30 PM,17,4,10,0,2,33
Spring 2019,4/10/2019,Wednesday,5:30 PM,9,3,11,1,0,24
Spring 2019,4/10/2019,Wednesday,6:30 PM,11,3,10,1,0,25
Spring 2019,4/10/2019,Wednesday,7:30 PM,13,1,5,0,0,19
Spring 2019,4/10/2019,Wednesday,8:30 PM,10,1,5,0,1,17
Spring 2019,4/11/2019,Thursday,7:30 AM,2,1,0,0,2,5
Spring 2019,4/11/2019,Thursday,8:30 AM,11,1,7,2,1,22
Spring 2019,4/11/2019,Thursday,9:30 AM,14,1,14,1,2,32
Spring 2019,4/11/2019,Thursday,10:30 AM,15,3,30,2,1,51
Spring 2019,4/11/2019,Thursday,11:30 AM,37,4,24,2,5,72
Spring 2019,4/11/2019,Thursday,12:30 PM,34,7,41,7,2,91
Spring 2019,4/11/2019,Thursday,1:30 PM,26,6,10,2,0,44
Spring 2019,4/11/2019,Thursday,4:30 PM,16,5,12,4,2,39
Spring 2019,4/11/2019,Thursday,5:30 PM,15,2,14,2,1,34
Spring 2019,4/11/2019,Thursday,6:30 PM,11,0,8,0,0,19
Spring 2019,4/11/2019,Thursday,7:30 PM,8,0,3,1,0,12
Spring 2019,4/11/2019,Thursday,8:30 PM,5,0,2,2,0,9
Spring 2019,4/12/2019,Friday,7:30 AM,0,0,0,0,0,0
Spring 2019,4/12/2019,Friday,8:30 AM,2,0,2,0,0,4
Spring 2019,4/12/2019,Friday,9:30 AM,6,1,4,0,0,11
Spring 2019,4/12/2019,Friday,10:30 AM,11,2,4,0,0,17
Spring 2019,4/12/2019,Friday,12:30 PM,7,1,7,2,1,18
Spring 2019,4/12/2019,Friday,1:30 PM,8,4,5,1,3,21
Spring 2019,4/12/2019,Friday,4:30 PM,10,2,5,0,0,17
Spring 2019,4/12/2019,Friday,5:30 PM,13,2,4,2,2,23
Spring 2019,4/12/2019,Friday,6:30 PM,12,4,8,0,0,24
Spring 2019,4/12/2019,Friday,7:30 PM,10,2,4,0,2,18
Spring 2019,4/12/2019,Friday,8:30 PM,3,2,3,0,0,8
Spring 2019,4/13/2019,Saturday,9:30 AM,3,0,0,0,0,3
Spring 2019,4/13/2019,Saturday,10:30 AM,4,0,1,0,0,5
Spring 2019,4/13/2019,Saturday,11:30 AM,3,0,1,0,0,4
Spring 2019,4/13/2019,Saturday,12:30 PM,10,0,3,0,1,14
Spring 2019,4/13/2019,Saturday,1:30 PM,12,0,2,1,0,15
Spring 2019,4/13/2019,Saturday,4:30 PM,8,0,1,1,0,10
Spring 2019,4/15/2019,Monday,7:30 AM,2,0,1,0,1,4
Spring 2019,4/15/2019,Monday,8:30 AM,19,7,8,1,0,35
Spring 2019,4/15/2019,Monday,9:30 AM,24,7,13,10,0,54
Spring 2019,4/15/2019,Monday,10:30 AM,21,7,17,9,0,54
Spring 2019,4/15/2019,Monday,11:30 AM,25,12,29,7,2,75
Spring 2019,4/15/2019,Monday,12:30 PM,41,18,39,8,5,111
Spring 2019,4/15/2019,Monday,1:30 PM,22,6,20,6,2,56
Spring 2019,4/15/2019,Monday,2:30 PM,23,9,11,3,2,48
Spring 2019,4/15/2019,Monday,3:30 PM,25,10,15,6,3,59
Spring 2019,4/15/2019,Monday,4:30 PM,20,9,13,4,2,48
Spring 2019,4/15/2019,Monday,5:30 PM,30,5,13,1,0,49
Spring 2019,4/15/2019,Monday,6:30 PM,25,3,15,1,2,46
Spring 2019,4/15/2019,Monday,7:30 PM,14,2,12,0,0,28
Spring 2019,4/15/2019,Monday,8:30 PM,12,1,4,0,2,19
Spring 2019,4/16/2019,Tuesday,10:30 AM,34,6,26,5,3,74
Spring 2019,4/16/2019,Tuesday,11:30 AM,32,7,29,7,5,80
Spring 2019,4/16/2019,Tuesday,12:30 PM,44,10,38,7,2,101
Spring 2019,4/16/2019,Tuesday,1:30 PM,21,8,17,5,2,53
Spring 2019,4/16/2019,Tuesday,2:30 PM,28,6,15,5,0,54
Spring 2019,4/16/2019,Tuesday,3:30 PM,26,5,16,7,0,54
Spring 2019,4/16/2019,Tuesday,4:30 PM,21,5,7,7,1,41
Spring 2019,4/16/2019,Tuesday,5:30 PM,18,3,6,0,2,29
Spring 2019,4/16/2019,Tuesday,6:30 PM,17,4,10,1,0,32
Spring 2019,4/16/2019,Tuesday,7:30 PM,13,2,7,1,0,23
Spring 2019,4/17/2019,Wednesday,7:30 AM,5,0,3,0,0,8
Spring 2019,4/17/2019,Wednesday,8:30 AM,10,5,4,1,1,21
Spring 2019,4/17/2019,Wednesday,9:30 AM,19,5,12,5,3,44
Spring 2019,4/17/2019,Wednesday,10:30 AM,22,9,18,7,0,56
Spring 2019,4/17/2019,Wednesday,11:30 AM,16,7,20,8,1,52
Spring 2019,4/17/2019,Wednesday,12:30 PM,40,13,36,14,3,106
Spring 2019,4/18/2019,Thursday,7:30 AM,3,1,0,0,0,4
Spring 2019,4/18/2019,Thursday,8:30 AM,6,3,3,1,1,14
Spring 2019,4/18/2019,Thursday,10:30 AM,25,5,20,9,1,60
Spring 2019,4/18/2019,Thursday,8:30 AM,6,3,3,1,1,14
Spring 2019,4/18/2019,Thursday,9:30 AM,21,3,12,9,0,45
Spring 2019,4/18/2019,Thursday,10:30 AM,25,5,20,9,1,60
Spring 2019,4/18/2019,Thursday,11:30 AM,24,9,29,6,1,69
Spring 2019,4/18/2019,Thursday,12:30 PM,37,4,35,8,3,87
Spring 2019,4/18/2019,Thursday,1:30 PM,31,4,16,3,3,57
Spring 2019,4/18/2019,Thursday,2:30 PM,15,7,8,3,2,35
Spring 2019,4/18/2019,Thursday,3:30 PM,15,6,8,3,3,35
Spring 2019,4/18/2019,Thursday,4:30 PM,17,5,5,1,0,28
Spring 2019,4/18/2019,Thursday,5:30 PM,14,5,13,0,0,32
Spring 2019,4/18/2019,Thursday,6:30 PM,11,3,3,1,0,18
Spring 2019,4/18/2019,Thursday,7:30 PM,7,3,6,1,0,17
Spring 2019,4/19/2019,Friday,7:30 AM,2,0,0,0,0,2
Spring 2019,4/19/2019,Friday,8:30 AM,3,0,0,0,0,3
Spring 2019,4/19/2019,Friday,9:30 AM,2,1,0,0,0,3
Spring 2019,4/19/2019,Friday,10:30 AM,7,1,5,0,0,13
Spring 2019,4/19/2019,Friday,11:30 AM,9,2,4,2,0,17
Spring 2019,4/19/2019,Friday,12:30 PM,15,6,4,4,1,30
Spring 2019,4/19/2019,Friday,1:30 PM,10,2,3,0,0,15
Spring 2019,4/19/2019,Friday,5:30 PM,6,0,1,0,0,7
Spring 2019,4/19/2019,Friday,6:30 PM,12,1,1,0,0,14
Spring 2019,4/19/2019,Friday,7:30 PM,8,1,1,0,0,10
Spring 2019,4/19/2019,Friday,8:30 PM,6,1,1,0,0,8
Spring 2019,4/20/2019,Saturday,9:30 AM,0,0,1,0,0,1
Spring 2019,4/20/2019,Saturday,10:30 AM,1,0,2,0,0,3
Spring 2019,4/20/2019,Saturday,11:30 AM,3,0,3,0,0,6
Spring 2019,4/20/2019,Saturday,12:30 PM,3,0,1,0,0,4
Spring 2019,4/20/2019,Saturday,1:30 PM,6,0,4,0,0,10
Spring 2019,4/20/2019,Saturday,2:30 PM,15,0,5,2,0,22
Spring 2019,4/20/2019,Saturday,3:30 PM,16,0,6,3,0,25
Spring 2019,4/20/2019,Saturday,4:30 PM,7,0,4,2,0,13
Spring 2019,4/20/2019,Saturday,5:30 PM,1,0,0,0,0,1
Spring 2019,4/22/2019,Monday,7:30 AM,7,0,0,0,0,7
Spring 2019,4/22/2019,Monday,8:30 AM,12,1,11,1,0,25
Spring 2019,4/22/2019,Monday,9:30 AM,14,4,20,6,0,44
Spring 2019,4/22/2019,Monday,10:30 AM,20,6,20,4,0,50
Spring 2019,4/22/2019,Monday,11:30 AM,22,6,18,6,3,55
Spring 2019,4/22/2019,Monday,12:30 PM,34,10,28,17,9,98
Spring 2019,4/22/2019,Monday,1:30 PM,30,8,15,4,3,60
Spring 2019,4/22/2019,Monday,3:30 PM,21,7,12,5,2,47
Spring 2019,4/22/2019,Monday,4:30 PM,23,9,9,2,2,45
Spring 2019,4/22/2019,Monday,5:30 PM,20,5,11,2,0,38
Spring 2019,4/22/2019,Monday,6:30 PM,12,3,6,2,0,23
Spring 2019,4/22/2019,Monday,7:30 PM,14,4,6,1,0,25
Spring 2019,4/23/2019,Tuesday,7:30 AM,3,0,0,0,0,3
Spring 2019,4/23/2019,Tuesday,8:30 AM,14,3,15,3,0,35
Spring 2019,4/23/2019,Tuesday,9:30 AM,16,5,9,1,0,31
Spring 2019,4/23/2019,Tuesday,10:30 AM,24,9,20,11,0,64
Spring 2019,4/23/2019,Tuesday,11:30 AM,27,6,29,1,0,63
Spring 2019,4/23/2019,Tuesday,12:30 PM,39,9,37,3,1,89
Spring 2019,4/23/2019,Tuesday,1:30 PM,19,8,24,8,2,61
Spring 2019,4/23/2019,Tuesday,2:30 PM,22,6,13,7,2,50
Spring 2019,4/23/2019,Tuesday,3:30 PM,16,5,17,4,3,45
Spring 2019,4/23/2019,Tuesday,5:30 PM,16,9,8,4,0,37
Spring 2019,4/23/2019,Tuesday,6:30 PM,15,5,5,1,0,26
Spring 2019,4/23/2019,Tuesday,7:30 PM,14,3,7,0,0,24
Spring 2019,4/23/2019,Tuesday,8:30 PM,11,3,2,0,0,16
Spring 2019,4/24/2019,Wednesday,7:30 AM,3,0,0,0,0,3
Spring 2019,4/24/2019,Wednesday,8:30 AM,11,3,10,0,1,25
Spring 2019,4/24/2019,Wednesday,9:30 AM,20,8,15,6,0,49
Spring 2019,4/24/2019,Wednesday,10:30 AM,24,5,22,11,0,62
Spring 2019,4/24/2019,Wednesday,11:30 AM,16,5,17,6,2,46
Spring 2019,4/24/2019,Wednesday,1:30 PM,32,8,20,0,2,62
Spring 2019,4/24/2019,Wednesday,2:30 PM,33,2,14,5,2,56
Spring 2019,4/24/2019,Wednesday,3:30 PM,26,3,13,2,1,45
Spring 2019,4/24/2019,Wednesday,4:30 PM,25,2,13,7,3,50
Spring 2019,4/24/2019,Wednesday,5:30 PM,26,5,21,2,0,54
Spring 2019,4/24/2019,Wednesday,6:30 PM,13,4,9,0,1,27
Spring 2019,4/24/2019,Wednesday,7:30 PM,9,1,11,0,2,23
Spring 2019,4/25/2019,Thursday,7:30 AM,1,0,0,0,0,1
Spring 2019,4/25/2019,Thursday,8:30 AM,8,1,7,0,0,16
Spring 2019,4/25/2019,Thursday,9:30 AM,11,2,16,4,1,34
Spring 2019,4/25/2019,Thursday,10:30 AM,20,4,27,7,1,59
Spring 2019,4/25/2019,Thursday,11:30 AM,24,11,21,5,2,63
Spring 2019,4/25/2019,Thursday,12:30 PM,28,12,42,4,2,88
Spring 2019,4/25/2019,Thursday,1:30 PM,14,10,15,4,0,43
Spring 2019,4/25/2019,Thursday,2:30 PM,13,6,20,5,2,46
Spring 2019,4/25/2019,Thursday,3:30 PM,29,4,15,6,0,54
Spring 2019,4/25/2019,Thursday,4:30 PM,27,3,12,7,0,49
Spring 2019,4/25/2019,Thursday,5:30 PM,18,3,12,1,0,34
Spring 2019,4/25/2019,Thursday,6:30 PM,8,2,8,1,0,19
Spring 2019,4/25/2019,Thursday,7:30 PM,6,0,9,0,3,18
Spring 2019,4/25/2019,Thursday,8:30 PM,7,1,5,0,0,13
Spring 2019,4/26/2019,Friday,7:30 AM,2,0,0,0,0,2
Spring 2019,4/26/2019,Friday,8:30 AM,4,0,0,0,1,5
Spring 2019,4/26/2019,Friday,9:30 AM,5,0,1,0,1,7
Spring 2019,4/26/2019,Friday,10:30 AM,7,2,2,0,0,11
Spring 2019,4/26/2019,Friday,11:30 AM,11,1,1,0,1,14
Spring 2019,4/26/2019,Friday,12:30 PM,13,2,3,3,2,23
Spring 2019,4/26/2019,Friday,3:30 PM,10,2,2,1,0,15
Spring 2019,4/26/2019,Friday,5:30 PM,10,4,7,1,0,22
Spring 2019,4/26/2019,Friday,6:30 PM,9,1,3,0,0,13
Spring 2019,4/26/2019,Friday,7:30 PM,6,0,2,3,0,11
Spring 2019,4/26/2019,Friday,8:30 PM,2,0,2,1,0,5
Spring 2019,4/27/2019,Saturday,9:30 AM,2,0,0,0,2,4
Spring 2019,4/27/2019,Saturday,10:30 AM,1,0,3,0,0,4
Spring 2019,4/27/2019,Saturday,11:30 AM,4,0,3,0,1,8
Spring 2019,4/27/2019,Saturday,12:30 PM,5,0,4,0,1,10
Spring 2019,4/27/2019,Saturday,1:30 PM,6,0,5,0,1,12
Spring 2019,4/27/2019,Saturday,2:30 PM,12,0,3,1,0,16
Spring 2019,4/27/2019,Saturday,4:30 PM,11,0,5,0,0,16
Spring 2019,4/27/2019,Saturday,5:30 PM,2,0,0,0,0,2
Spring 2019,4/29/2019,Monday,7:30 AM,4,0,2,0,0,6
Spring 2019,4/29/2019,Monday,8:30 AM,13,7,7,1,0,28
Spring 2019,4/29/2019,Monday,9:30 AM,20,7,7,7,0,41
Spring 2019,4/29/2019,Monday,10:30 AM,20,7,30,6,0,63
Spring 2019,4/29/2019,Monday,11:30 AM,26,6,20,8,0,60
Spring 2019,4/29/2019,Monday,12:30 PM,45,10,36,17,5,113
Spring 2019,4/29/2019,Monday,1:30 PM,22,7,25,6,3,63
Spring 2019,4/29/2019,Monday,2:30 PM,27,8,19,4,2,60
Spring 2019,4/29/2019,Monday,3:30 PM,26,8,24,0,2,60
Spring 2019,4/29/2019,Monday,4:30 PM,19,5,17,0,1,42
Spring 2019,4/29/2019,Monday,5:30 PM,16,3,14,2,0,35
Spring 2019,4/29/2019,Monday,6:30 PM,22,6,10,0,0,38
Spring 2019,4/29/2019,Monday,7:30 PM,13,5,8,0,0,26
Spring 2019,4/29/2019,Monday,8:30 PM,6,3,2,2,0,13
Spring 2019,4/30/2019,Tuesday,7:30 AM,6,1,0,0,0,7
Spring 2019,4/30/2019,Tuesday,8:30 AM,10,1,4,1,0,16
Spring 2019,4/30/2019,Tuesday,9:30 AM,16,1,10,7,2,36
Spring 2019,4/30/2019,Tuesday,10:30 AM,27,2,16,1,0,46
Spring 2019,4/30/2019,Tuesday,11:30 AM,24,6,17,1,0,48
Spring 2019,4/30/2019,Tuesday,12:30 PM,33,10,47,7,7,104
Spring 2019,4/30/2019,Tuesday,1:30 PM,19,7,15,8,0,49
Spring 2019,4/30/2019,Tuesday,2:30 PM,14,5,15,4,0,38
Spring 2019,4/30/2019,Tuesday,3:30 PM,18,3,12,4,1,38
Spring 2019,4/30/2019,Tuesday,4:30 PM,22,2,8,2,1,35
Spring 2019,4/30/2019,Tuesday,5:30 PM,17,2,13,1,0,33
Spring 2019,4/30/2019,Tuesday,6:30 PM,13,1,4,0,0,18
Spring 2019,4/30/2019,Tuesday,7:30 PM,13,2,2,0,0,17
Spring 2019,4/30/2019,Tuesday,8:30 PM,12,1,0,3,0,16
Spring 2019,5/1/2019,Wednesday,7:30 AM,1,0,1,0,2,4
Spring 2019,5/1/2019,Wednesday,8:30 AM,12,2,8,4,1,27
Spring 2019,5/1/2019,Wednesday,9:30 AM,21,4,10,4,0,39
Spring 2019,5/1/2019,Wednesday,10:30 AM,32,10,25,7,0,74
Spring 2019,5/1/2019,Wednesday,11:30 AM,37,4,31,7,0,79
Spring 2019,5/1/2019,Wednesday,12:30 PM,36,6,36,12,7,97
Spring 2019,5/1/2019,Wednesday,1:30 PM,26,8,24,1,3,62
Spring 2019,5/1/2019,Wednesday,2:30 PM,23,4,20,1,2,50
Spring 2019,5/1/2019,Wednesday,3:30 PM,40,6,21,3,2,72
Spring 2019,5/1/2019,Wednesday,4:30 PM,20,4,12,2,1,39
Spring 2019,5/1/2019,Wednesday,5:30 PM,23,4,13,3,1,44
Spring 2019,5/1/2019,Wednesday,6:30 PM,11,2,6,0,0,19
Spring 2019,5/1/2019,Wednesday,7:30 PM,13,2,8,2,0,25
Spring 2019,5/1/2019,Wednesday,8:30 PM,10,1,4,2,0,17
Spring 2019,5/2/2019,Thursday,10:30 AM,26,5,5,5,4,45
Spring 2019,5/2/2019,Thursday,11:30 AM,39,7,4,4,3,57
Spring 2019,5/2/2019,Thursday,12:30 PM,47,6,15,15,3,86
Spring 2019,5/2/2019,Thursday,1:30 PM,26,7,7,7,3,50
Spring 2019,5/2/2019,Thursday,2:30 PM,26,3,6,6,0,41
Spring 2019,5/2/2019,Thursday,3:30 PM,24,5,5,5,2,41
Spring 2019,5/2/2019,Thursday,4:30 PM,23,4,7,7,1,42
Spring 2019,5/2/2019,Thursday,5:30 PM,25,2,0,0,1,28
Spring 2019,5/2/2019,Thursday,6:30 PM,16,1,0,0,0,17
Spring 2019,5/2/2019,Thursday,7:30 PM,10,2,0,0,0,12
Spring 2019,5/2/2019,Thursday,8:30 PM,8,2,0,0,0,10
Spring 2019,5/3/2019,Friday,7:30 AM,4,0,3,0,0,7
Spring 2019,5/3/2019,Friday,9:30 AM,6,0,3,0,0,9
Spring 2019,5/3/2019,Friday,10:30 AM,6,1,3,1,0,11
Spring 2019,5/3/2019,Friday,11:30 AM,11,1,7,1,2,22
Spring 2019,5/3/2019,Friday,12:30 PM,15,1,6,2,2,26
Spring 2019,5/3/2019,Friday,1:30 PM,10,2,5,2,1,20
Spring 2019,5/3/2019,Friday,2:30 PM,9,1,4,0,1,15
Spring 2019,5/3/2019,Friday,5:30 PM,7,1,5,0,1,14
Spring 2019,5/3/2019,Friday,6:30 PM,7,0,4,0,0,11
Spring 2019,5/3/2019,Friday,8:30 PM,4,0,0,0,0,4
Spring 2019,5/4/2019,Saturday,9:30 AM,1,0,0,0,0,1
Spring 2019,5/4/2019,Saturday,10:30 AM,3,1,7,0,0,11
Spring 2019,5/4/2019,Saturday,12:30 PM,6,1,11,3,0,21
Spring 2019,5/4/2019,Saturday,1:30 PM,8,2,12,2,0,24
Spring 2019,5/4/2019,Saturday,2:30 PM,9,1,11,0,0,21
Spring 2019,5/4/2019,Saturday,3:30 PM,9,2,8,0,0,19
Spring 2019,5/4/2019,Saturday,4:30 PM,8,2,5,1,0,16
Spring 2019,5/4/2019,Saturday,5:30 PM,2,2,1,0,0,5
Spring 2019,5/6/2019,Monday,7:30 AM,6,1,0,0,0,7
Spring 2019,5/6/2019,Monday,8:30 AM,9,1,3,0,0,13
Spring 2019,5/6/2019,Monday,9:30 AM,13,5,9,3,1,31
Spring 2019,5/6/2019,Monday,10:30 AM,13,5,14,5,3,40
Spring 2019,5/6/2019,Monday,11:30 AM,19,9,30,4,0,62
Spring 2019,5/6/2019,Monday,12:30 PM,27,8,28,9,5,77
Spring 2019,5/6/2019,Monday,1:30 PM,35,8,33,6,3,85
Spring 2019,5/6/2019,Monday,2:30 PM,27,8,18,5,2,60
Spring 2019,5/6/2019,Monday,3:30 PM,22,5,18,4,1,50
Spring 2019,5/6/2019,Monday,4:30 PM,24,6,12,3,1,46
Spring 2019,5/6/2019,Monday,5:30 PM,27,4,18,1,0,50
Spring 2019,5/6/2019,Monday,6:30 PM,20,4,9,2,3,38
Spring 2019,5/6/2019,Monday,7:30 PM,19,5,9,5,3,41
Spring 2019,5/6/2019,Monday,8:30 PM,11,5,4,3,3,26
Spring 2019,5/7/2019,Tuesday,7:30 AM,2,1,3,0,0,6
Spring 2019,5/7/2019,Tuesday,8:30 AM,3,0,3,0,1,7
Spring 2019,5/7/2019,Tuesday,9:30 AM,12,3,17,2,2,36
Spring 2019,5/7/2019,Tuesday,10:30 AM,23,9,23,6,3,64
Spring 2019,5/7/2019,Tuesday,11:30 AM,22,5,18,9,2,56
Spring 2019,5/7/2019,Tuesday,12:30 PM,25,9,19,8,3,64
Spring 2019,5/7/2019,Tuesday,1:30 PM,18,8,34,8,2,70
Spring 2019,5/7/2019,Tuesday,2:30 PM,21,10,25,6,2,64
Spring 2019,5/7/2019,Tuesday,3:30 PM,21,8,25,9,0,63
Spring 2019,5/7/2019,Tuesday,4:30 PM,18,5,13,3,0,39
Spring 2019,5/7/2019,Tuesday,5:30 PM,23,6,11,2,1,43
Spring 2019,5/7/2019,Tuesday,6:30 PM,27,2,6,3,2,40
Spring 2019,5/7/2019,Tuesday,7:30 PM,16,0,4,0,0,20
Spring 2019,5/7/2019,Tuesday,8:30 PM,3,1,2,0,0,6
Spring 2019,5/8/2019,Wednesday,7:30 AM,2,0,0,0,0,2
Spring 2019,5/8/2019,Wednesday,8:30 AM,10,2,8,0,0,20
Spring 2019,5/8/2019,Wednesday,9:30 AM,19,5,8,2,1,35
Spring 2019,5/8/2019,Wednesday,10:30 AM,37,11,28,10,1,87
Spring 2019,5/8/2019,Wednesday,11:30 AM,23,7,17,3,2,52
Spring 2019,5/8/2019,Wednesday,12:30 PM,28,8,39,4,0,79
Spring 2019,5/8/2019,Wednesday,1:30 PM,22,5,16,5,4,52
Spring 2019,5/8/2019,Wednesday,2:30 PM,18,6,11,1,2,38
Spring 2019,5/8/2019,Wednesday,3:30 PM,13,3,8,3,0,27
Spring 2019,5/8/2019,Wednesday,4:30 PM,16,2,17,3,0,38
Spring 2019,5/8/2019,Wednesday,5:30 PM,19,4,15,4,3,45
Spring 2019,5/8/2019,Wednesday,6:30 PM,10,3,9,3,2,27
Spring 2019,5/8/2019,Wednesday,7:30 PM,12,4,11,4,2,33
Spring 2019,5/8/2019,Wednesday,8:30 PM,7,1,7,0,0,15
Spring 2019,5/9/2019,Thursday,7:30 AM,2,1,1,0,0,4
Spring 2019,5/9/2019,Thursday,8:30 AM,8,3,11,3,1,26
Spring 2019,5/9/2019,Thursday,9:30 AM,9,3,14,4,0,30
Spring 2019,5/9/2019,Thursday,10:30 AM,20,7,30,5,4,66
Summer Intersession 2019,5/13/2019,Monday,8:30 AM,0,0,0,1,0,1
Summer Intersession 2019,5/13/2019,Monday,9:30 AM,1,0,0,1,0,2
Summer Intersession 2019,5/13/2019,Monday,10:30 AM,1,0,0,0,0,1
Summer Intersession 2019,5/13/2019,Monday,11:30 AM,1,0,0,0,0,1
Summer Intersession 2019,5/13/2019,Monday,12:30 PM,0,0,0,0,0,0
Summer Intersession 2019,5/13/2019,Monday,1:30 PM,0,0,0,0,0,0
Summer Intersession 2019,5/14/2019,Tuesday,9:30 AM,1,0,0,1,0,2
Summer Intersession 2019,5/14/2019,Tuesday,9:30 AM,1,0,0,0,0,1
Summer Intersession 2019,5/14/2019,Tuesday,10:30 AM,1,0,0,0,0,1
Summer Intersession 2019,5/14/2019,Tuesday,12:30 PM,0,0,0,1,0,1
Summer Intersession 2019,5/14/2019,Tuesday,12:30 PM,0,0,0,1,0,1
Summer Intersession 2019,5/14/2019,Tuesday,1:30 PM,0,0,0,1,0,1
Summer Intersession 2019,5/14/2019,Tuesday,2:30 PM,0,0,0,1,1,2
Summer Intersession 2019,5/14/2019,Tuesday,3:30 PM,0,0,0,1,1,2
Summer Intersession 2019,5/15/2019,Wednesday,9:30 AM,0,0,0,0,0,0
Summer Intersession 2019,5/15/2019,Wednesday,9:30 AM,1,0,0,0,0,1
Summer Intersession 2019,5/15/2019,Wednesday,9:30 AM,0,0,0,0,0,0
Summer Intersession 2019,5/15/2019,Wednesday,9:30 AM,0,0,0,1,0,1
Summer Intersession 2019,5/15/2019,Wednesday,2:30 PM,0,0,0,0,1,1
Summer Intersession 2019,5/15/2019,Wednesday,3:30 PM,0,0,0,3,1,4
Summer Intersession 2019,5/15/2019,Wednesday,4:30 PM,0,0,0,4,0,4
Summer Intersession 2019,5/15/2019,Wednesday,5:30 PM,0,0,0,2,3,5
Summer Intersession 2019,5/16/2019,Thursday,9:30 AM,0,0,0,0,0,0
Summer Intersession 2019,5/16/2019,Thursday,10:30 AM,3,0,0,5,0,8
Summer Intersession 2019,5/16/2019,Thursday,11:30 AM,1,0,0,5,0,6
Summer Intersession 2019,5/16/2019,Thursday,12:30 PM,0,0,0,0,0,0
Summer Intersession 2019,5/16/2019,Thursday,1:30 PM,0,0,0,0,0,0
Summer Intersession 2019,5/16/2019,Thursday,2:30 PM,0,0,0,4,2,6
Summer Intersession 2019,5/16/2019,Thursday,3:30 PM,0,0,0,2,2,4
Summer Intersession 2019,5/16/2019,Thursday,4:30 PM,0,0,0,0,1,1
Summer Intersession 2019,5/16/2019,Thursday,5:30 PM,0,0,0,0,0,0
Summer Intersession 2019,5/17/2019,Friday,9:30 AM,3,0,0,0,0,3
Summer Intersession 2019,5/17/2019,Friday,10:30 AM,2,0,0,0,0,2
Summer Intersession 2019,5/17/2019,Friday,11:30 AM,2,0,0,0,0,2
Summer Intersession 2019,5/17/2019,Friday,12:30 PM,3,0,1,0,0,4
Summer Intersession 2019,5/17/2019,Friday,1:30 PM,2,0,1,0,0,3
Summer Intersession 2019,5/17/2019,Friday,2:30 PM,2,1,0,0,0,3
Summer Intersession 2019,5/17/2019,Friday,3:30 PM,4,1,2,0,0,7
Summer Intersession 2019,5/17/2019,Friday,4:30 PM,3,1,2,0,0,6
Summer Intersession 2019,5/17/2019,Friday,5:30 PM,4,1,0,0,1,6
Summer Intersession 2019,5/20/2019,Monday,7:30 AM,1,0,0,0,0,1
Summer Intersession 2019,5/20/2019,Monday,8:30 AM,3,0,0,0,0,3
Summer Intersession 2019,5/20/2019,Monday,9:30 AM,2,0,1,0,0,3
Summer Intersession 2019,5/21/2019,Tuesday,10:30 AM,1,0,0,0,0,1
Summer Intersession 2019,5/21/2019,Tuesday,11:30 AM,1,0,0,0,0,1
Summer Intersession 2019,5/21/2019,Tuesday,12:30 PM,2,0,0,0,0,2
Summer Intersession 2019,5/21/2019,Tuesday,1:30 PM,4,1,0,0,0,5
Summer Intersession 2019,5/21/2019,Tuesday,2:30 PM,6,0,0,0,0,6
Summer Intersession 2019,5/21/2019,Tuesday,3:30 PM,4,2,0,0,0,6
Summer Intersession 2019,5/21/2019,Tuesday,4:30 PM,1,0,0,0,0,1
Summer Intersession 2019,5/21/2019,Tuesday,5:30 PM,2,0,2,0,0,4
Summer Intersession 2019,5/22/2019,Wednesday,7:30 AM,1,0,0,0,0,1
Summer Intersession 2019,5/22/2019,Wednesday,8:30 AM,3,0,0,0,0,3
Summer Intersession 2019,5/22/2019,Wednesday,9:30 AM,2,0,0,0,0,2
Summer Intersession 2019,5/21/2019,Tuesday,2:30 PM,3,1,0,0,0,4
Summer Intersession 2019,5/21/2019,Tuesday,3:30 PM,8,1,2,0,0,11
Summer Intersession 2019,5/22/2019,Wednesday,12:30 PM,3,1,1,0,0,5
Summer Intersession 2019,5/21/2019,Tuesday,4:30 PM,6,0,0,0,0,6
Summer Intersession 2019,5/22/2019,Wednesday,1:30 PM,6,0,0,0,0,6
Summer Intersession 2019,5/22/2019,Wednesday,2:30 PM,1,0,3,0,0,4
Summer Intersession 2019,5/22/2019,Wednesday,3:30 PM,2,0,2,0,0,4
Summer Intersession 2019,5/22/2019,Wednesday,4:30 PM,1,0,3,0,0,4
Summer Intersession 2019,5/22/2019,Wednesday,5:30 PM,2,1,2,0,0,5
Summer Intersession 2019,5/23/2019,Thursday,7:30 AM,1,0,0,0,0,1
Summer Intersession 2019,5/23/2019,Thursday,8:30 AM,2,0,0,0,0,2
Summer Intersession 2019,5/23/2019,Thursday,10:30 AM,2,0,0,0,0,2
Summer Intersession 2019,5/23/2019,Thursday,11:30 AM,2,1,5,0,0,8
Summer Intersession 2019,5/23/2019,Thursday,12:30 PM,1,1,4,0,0,6
Summer Intersession 2019,5/23/2019,Thursday,1:30 PM,1,1,4,0,0,6
Summer Intersession 2019,5/23/2019,Thursday,2:30 PM,3,1,1,0,0,5
Summer Intersession 2019,5/23/2019,Thursday,3:30 PM,2,0,1,0,0,3
Summer Intersession 2019,5/23/2019,Thursday,4:30 PM,2,0,1,0,0,3
Summer Intersession 2019,5/23/2019,Thursday,5:30 PM,2,0,1,0,0,3
Summer Intersession 2019,5/24/2019,Friday,7:30 AM,0,0,0,0,0,0
Summer Intersession 2019,5/24/2019,Friday,8:30 AM,2,0,0,0,0,2
Summer Intersession 2019,5/24/2019,Friday,9:30 AM,3,0,0,0,0,3
Summer Intersession 2019,5/24/2019,Friday,10:30 AM,1,0,0,0,0,1
Summer Intersession 2019,5/24/2019,Friday,11:30 AM,4,1,0,0,0,5
Summer Intersession 2019,5/24/2019,Friday,12:30 PM,2,1,0,0,0,3
Summer Intersession 2019,5/24/2019,Friday,2:30 PM,3,1,2,0,0,6
Summer Intersession 2019,5/24/2019,Friday,3:30 PM,0,0,2,0,0,2
Summer Intersession 2019,5/24/2019,Friday,5:30 PM,0,1,0,0,0,1
Summer Intersession 2019,5/28/2019,Tuesday,7:30 AM,0,0,0,0,0,0
Summer Intersession 2019,5/28/2019,Tuesday,8:30 AM,0,0,0,0,0,0
Summer Intersession 2019,5/28/2019,Tuesday,9:30 AM,1,0,0,0,0,1
Summer Intersession 2019,5/28/2019,Tuesday,10:30 AM,4,0,0,0,0,4
Summer Intersession 2019,5/28/2019,Tuesday,11:30 AM,1,1,1,0,0,3
Summer Intersession 2019,5/28/2019,Tuesday,12:30 PM,3,1,4,0,0,8
Summer Intersession 2019,5/28/2019,Tuesday,1:30 PM,2,1,2,0,0,5
Summer Intersession 2019,5/28/2019,Tuesday,2:30 PM,2,0,1,0,0,3
Summer Intersession 2019,5/28/2019,Tuesday,4:30 PM,3,1,1,0,0,5
Summer Intersession 2019,5/28/2019,Tuesday,5:30 PM,1,1,0,0,0,2
Summer Intersession 2019,5/29/2019,Wednesday,7:30 AM,2,0,0,0,0,2
Summer Intersession 2019,5/29/2019,Wednesday,10:30 AM,2,0,1,0,1,4
Summer Intersession 2019,5/29/2019,Wednesday,10:30 AM,4,1,1,0,0,6
Summer Intersession 2019,5/29/2019,Wednesday,11:30 AM,4,1,0,0,0,5
Summer Intersession 2019,5/29/2019,Wednesday,12:30 PM,7,2,1,0,3,13
Summer Intersession 2019,5/29/2019,Wednesday,1:30 PM,6,1,1,0,0,8
Summer Intersession 2019,5/29/2019,Wednesday,2:30 PM,2,0,1,0,0,3
Summer Intersession 2019,5/29/2019,Wednesday,3:30 PM,4,1,0,0,0,5
Summer Intersession 2019,5/29/2019,Wednesday,5:30 PM,4,0,1,0,0,5
Summer Intersession 2019,5/30/2019,Thursday,7:30 AM,1,0,0,0,0,1
Summer Intersession 2019,5/30/2019,Thursday,8:30 AM,0,1,0,0,0,1
Summer Intersession 2019,5/30/2019,Thursday,9:30 AM,1,0,0,0,0,1
Summer Intersession 2019,5/30/2019,Thursday,10:30 AM,6,0,0,0,2,8
Summer Intersession 2019,5/30/2019,Thursday,11:30 AM,6,0,0,0,0,6
Summer Intersession 2019,5/30/2019,Thursday,12:30 PM,3,1,0,0,4,8
Summer Intersession 2019,5/30/2019,Thursday,1:30 PM,3,1,0,0,0,4
Summer Intersession 2019,5/30/2019,Thursday,3:30 PM,4,3,0,0,0,7
Summer Intersession 2019,5/30/2019,Thursday,4:30 PM,1,1,0,0,0,2
Summer Intersession 2019,5/30/2019,Thursday,5:30 PM,0,2,0,0,0,2
Summer Intersession 2019,5/31/2019,Friday,7:30 AM,1,0,0,0,0,1
Summer Intersession 2019,5/31/2019,Friday,8:30 AM,2,0,0,0,0,2
Summer Intersession 2019,5/31/2019,Friday,9:30 AM,5,0,1,0,0,6
Summer Intersession 2019,5/31/2019,Friday,10:30 AM,4,0,0,0,0,4
Summer Intersession 2019,5/31/2019,Friday,11:30 AM,5,0,0,0,0,5
Summer Intersession 2019,5/31/2019,Friday,12:30 PM,2,0,1,0,0,3
Summer Intersession 2019,5/31/2019,Friday,1:30 PM,3,1,1,0,0,5
Summer Intersession 2019,5/31/2019,Friday,3:30 PM,3,0,5,0,0,8
Summer Intersession 2019,5/31/2019,Friday,4:30 PM,2,0,1,0,0,3
Summer Intersession 2019,5/31/2019,Friday,5:30 PM,1,1,0,0,0,2
Summer 2019,6/3/2019,Monday,8:30 AM,2,0,1,0,2,5
Summer 2019,6/3/2019,Monday,9:30 AM,5,3,4,0,2,14
Summer 2019,6/3/2019,Monday,10:30 AM,22,2,4,2,0,30
Summer 2019,6/3/2019,Monday,11:30 AM,9,1,4,2,0,16
Summer 2019,6/3/2019,Monday,1:30 PM,13,4,7,0,0,24
Summer 2019,6/3/2019,Monday,2:30 PM,8,1,8,0,0,17
Summer 2019,6/3/2019,Monday,3:30 PM,11,3,9,0,0,23
Summer 2019,6/3/2019,Monday,4:30 PM,12,2,5,0,0,19
Summer 2019,6/3/2019,Monday,5:30 PM,8,1,2,0,0,11
Summer 2019,6/3/2019,Monday,6:30 PM,3,1,1,0,0,5
Summer 2019,6/3/2019,Monday,7:30 PM,6,1,0,0,0,7
Summer 2019,6/4/2019,Tuesday,8:30 AM,5,1,0,0,0,6
Summer 2019,6/4/2019,Tuesday,10:30 AM,7,2,5,0,0,14
Summer 2019,6/4/2019,Tuesday,11:30 AM,11,1,3,0,0,15
Summer 2019,6/4/2019,Tuesday,12:30 PM,16,2,2,0,0,20
Summer 2019,6/4/2019,Tuesday,1:30 PM,11,3,5,0,0,19
Summer 2019,6/4/2019,Tuesday,2:30 PM,5,0,1,1,0,7
Summer 2019,6/4/2019,Tuesday,3:30 PM,7,0,4,1,0,12
Summer 2019,6/4/2019,Tuesday,4:30 PM,10,1,2,1,0,14
Summer 2019,6/4/2019,Tuesday,5:30 PM,4,1,2,1,0,8
Summer 2019,6/4/2019,Tuesday,7:30 PM,4,1,1,2,0,8
Summer 2019,6/4/2019,Tuesday,8:30 PM,1,0,1,0,0,2
Summer 2019,6/5/2019,Wednesday,10:30 AM,6,1,5,0,0,12
Summer 2019,6/5/2019,Wednesday,11:30 AM,5,0,5,3,0,13
Summer 2019,6/5/2019,Wednesday,12:30 PM,8,1,7,1,2,19
Summer 2019,6/5/2019,Wednesday,1:30 PM,11,1,3,1,0,16
Summer 2019,6/5/2019,Wednesday,2:30 PM,8,1,5,0,0,14
Summer 2019,6/5/2019,Wednesday,3:30 PM,6,2,5,0,0,13
Summer 2019,6/5/2019,Wednesday,4:30 PM,12,1,7,0,0,20
Summer 2019,6/5/2019,Wednesday,5:30 PM,12,0,8,0,0,20
Summer 2019,6/5/2019,Wednesday,6:30 PM,4,0,2,0,0,6
Summer 2019,6/5/2019,Wednesday,7:30 PM,5,0,2,0,0,7
Summer 2019,6/5/2019,Wednesday,8:30 PM,2,0,1,0,0,3
Summer 2019,6/6/2019,Thursday,7:30 AM,0,0,1,0,0,1
Summer 2019,6/6/2019,Thursday,8:30 AM,1,0,9,2,0,12
Summer 2019,6/6/2019,Thursday,9:30 AM,4,0,4,2,2,12
Summer 2019,6/6/2019,Thursday,10:30 AM,5,0,4,2,0,11
Summer 2019,6/6/2019,Thursday,11:30 AM,9,0,4,2,0,15
Summer 2019,6/6/2019,Thursday,12:30 PM,12,2,6,0,0,20
Summer 2019,6/6/2019,Thursday,1:30 PM,8,1,3,0,0,12
Summer 2019,6/6/2019,Thursday,2:30 PM,7,1,3,2,0,13
Summer 2019,6/6/2019,Thursday,3:30 PM,7,1,5,1,0,14
Summer 2019,6/6/2019,Thursday,4:30 PM,6,2,6,1,0,15
Summer 2019,6/6/2019,Thursday,5:30 PM,6,0,7,0,1,14
Summer 2019,6/6/2019,Thursday,6:30 PM,3,1,3,2,0,9
Summer 2019,6/6/2019,Thursday,7:30 PM,4,1,2,0,0,7
Summer 2019,6/6/2019,Thursday,8:30 PM,4,0,0,0,0,4
Summer 2019,6/7/2019,Friday,7:30 AM,1,0,0,0,0,1
Summer 2019,6/7/2019,Friday,8:30 AM,2,0,1,1,0,4
Summer 2019,6/7/2019,Friday,9:30 AM,5,0,1,0,0,6
Summer 2019,6/7/2019,Friday,10:30 AM,8,1,2,0,0,11
Summer 2019,6/7/2019,Friday,11:30 AM,9,1,3,0,0,13
Summer 2019,6/7/2019,Friday,12:30 PM,7,1,9,0,0,17
Summer 2019,6/10/2019,Monday,8:30 AM,7,1,2,0,0,10
Summer 2019,6/10/2019,Monday,9:30 AM,6,1,3,0,0,10
Summer 2019,6/10/2019,Monday,10:30 AM,4,1,2,0,0,7
Summer 2019,6/10/2019,Monday,11:30 AM,5,1,9,2,0,17
Summer 2019,6/10/2019,Monday,12:30 PM,15,7,12,4,0,38
Summer 2019,6/10/2019,Monday,1:30 PM,9,3,8,4,0,24
Summer 2019,6/10/2019,Monday,2:30 PM,9,2,5,0,1,17
Summer 2019,6/10/2019,Monday,4:30 PM,6,3,5,0,0,14
Summer 2019,6/10/2019,Monday,5:30 PM,7,0,7,3,0,17
Summer 2019,6/10/2019,Monday,6:30 PM,1,0,3,0,0,4
Summer 2019,6/10/2019,Monday,7:30 PM,2,0,4,0,0,6
Summer 2019,6/10/2019,Monday,8:30 PM,3,1,3,0,0,7
Summer 2019,6/11/2019,Tuesday,7:30 AM,0,0,0,0,0,0
Summer 2019,6/11/2019,Tuesday,8:30 AM,4,1,2,0,0,7
Summer 2019,6/11/2019,Tuesday,9:30 AM,8,2,2,0,0,12
Summer 2019,6/11/2019,Tuesday,10:30 AM,6,1,5,0,0,12
Summer 2019,6/11/2019,Tuesday,11:30 AM,9,1,3,1,2,16
Summer 2019,6/11/2019,Tuesday,12:30 PM,19,1,4,1,0,25
Summer 2019,6/11/2019,Tuesday,1:30 PM,3,0,2,1,0,6
Summer 2019,6/11/2019,Tuesday,2:30 PM,7,0,3,2,0,12
Summer 2019,6/11/2019,Tuesday,4:30 PM,10,0,2,0,1,13
Summer 2019,6/11/2019,Tuesday,5:30 PM,11,0,3,0,0,14
Summer 2019,6/11/2019,Tuesday,7:30 PM,2,3,0,0,0,5
Summer 2019,6/11/2019,Tuesday,8:30 PM,5,0,1,0,0,6
Summer 2019,6/12/2019,Wednesday,7:30 AM,2,1,0,0,0,3
Summer 2019,6/12/2019,Wednesday,8:30 AM,3,0,0,1,0,4
Summer 2019,6/12/2019,Wednesday,9:30 AM,8,0,3,2,0,13
Summer 2019,6/12/2019,Wednesday,9:30 AM,8,0,2,3,0,13
Summer 2019,6/12/2019,Wednesday,11:30 AM,22,1,2,1,0,26
Summer 2019,6/12/2019,Wednesday,12:30 PM,11,2,5,3,4,25
Summer 2019,6/12/2019,Wednesday,1:30 PM,4,2,1,1,2,10
Summer 2019,6/12/2019,Wednesday,2:30 PM,2,1,1,0,0,4
Summer 2019,6/12/2019,Wednesday,4:30 PM,10,2,8,0,0,20
Summer 2019,6/12/2019,Wednesday,5:30 PM,7,2,6,0,0,15
Summer 2019,6/12/2019,Wednesday,6:30 PM,3,1,5,0,1,10
Summer 2019,6/12/2019,Wednesday,7:30 PM,5,1,7,0,0,13
Summer 2019,6/12/2019,Wednesday,8:30 PM,5,1,1,0,1,8
Summer 2019,6/13/2019,Thursday,7:30 AM,0,0,0,0,0,0
Summer 2019,6/13/2019,Thursday,8:30 AM,6,0,6,0,0,12
Summer 2019,6/13/2019,Thursday,9:30 AM,3,1,4,2,0,10
Summer 2019,6/13/2019,Thursday,10:30 AM,8,0,2,2,0,12
Summer 2019,6/13/2019,Thursday,11:30 AM,8,0,6,6,0,20
Summer 2019,6/13/2019,Thursday,12:30 PM,16,1,3,3,0,23
Summer 2019,6/13/2019,Thursday,1:30 PM,5,2,1,1,0,9
Summer 2019,6/13/2019,Thursday,2:30 PM,8,1,2,2,0,13
Summer 2019,6/13/2019,Thursday,4:30 PM,10,2,3,1,0,16
Summer 2019,6/13/2019,Thursday,6:30 PM,5,1,1,0,0,7
Summer 2019,6/13/2019,Thursday,8:30 PM,4,1,0,0,0,5
Summer 2019,6/14/2019,Friday,7:30 AM,2,0,0,0,0,2
Summer 2019,6/14/2019,Friday,8:30 AM,2,0,1,0,0,3
Summer 2019,6/14/2019,Friday,9:30 AM,4,0,2,0,0,6
Summer 2019,6/14/2019,Friday,9:30 AM,11,1,2,0,0,14
Summer 2019,6/14/2019,Friday,11:30 AM,10,1,1,0,0,12
Summer 2019,6/14/2019,Friday,12:30 PM,11,2,0,0,3,16
Summer 2019,6/17/2019,Monday,7:30 AM,1,0,0,0,0,1
Summer 2019,6/17/2019,Monday,8:30 AM,6,2,4,1,0,13
Summer 2019,6/17/2019,Monday,9:30 AM,8,2,7,1,0,18
Summer 2019,6/17/2019,Monday,10:30 AM,9,2,6,1,0,18
Summer 2019,6/17/2019,Monday,11:30 AM,5,4,6,2,1,18
Summer 2019,6/17/2019,Monday,12:30 PM,14,2,9,1,1,27
Summer 2019,6/17/2019,Monday,1:30 PM,8,4,4,0,4,20
Summer 2019,6/17/2019,Monday,2:30 PM,9,3,7,0,0,19
Summer 2019,6/17/2019,Monday,5:30 PM,9,4,7,7,1,28
Summer 2019,6/17/2019,Monday,6:30 PM,5,1,5,2,0,13
Summer 2019,6/17/2019,Monday,7:30 PM,3,1,6,0,0,10
Summer 2019,6/18/2019,Tuesday,7:30 AM,1,0,0,0,0,1
Summer 2019,6/18/2019,Tuesday,8:30 AM,5,0,3,2,1,11
Summer 2019,6/18/2019,Tuesday,9:30 AM,5,0,3,0,0,8
Summer 2019,6/18/2019,Tuesday,10:30 AM,1,2,7,2,0,12
Summer 2019,6/18/2019,Tuesday,11:30 AM,8,2,3,3,0,16
Summer 2019,6/18/2019,Tuesday,12:30 PM,22,2,6,4,2,36
Summer 2019,6/18/2019,Tuesday,1:30 PM,11,4,7,2,2,26
Summer 2019,6/18/2019,Tuesday,2:30 PM,8,1,3,2,0,14
Summer 2019,6/18/2019,Tuesday,4:30 PM,12,1,6,0,0,19
Summer 2019,6/18/2019,Tuesday,5:30 PM,9,3,6,2,0,20
Summer 2019,6/18/2019,Tuesday,6:30 PM,3,0,3,3,0,9
Summer 2019,6/18/2019,Tuesday,7:30 PM,2,0,2,3,1,8
Summer 2019,6/18/2019,Tuesday,8:30 PM,0,0,3,0,6,9
Summer 2019,6/19/2019,Wednesday,7:30 AM,1,2,0,0,2,5
Summer 2019,6/19/2019,Wednesday,8:30 AM,2,0,1,0,0,3
Summer 2019,6/19/2019,Wednesday,9:30 AM,10,2,15,1,1,29
Summer 2019,6/19/2019,Wednesday,10:30 AM,6,1,1,2,0,10
Summer 2019,6/19/2019,Wednesday,11:30 AM,12,2,8,1,0,23
Summer 2019,6/19/2019,Wednesday,12:30 PM,16,1,10,4,1,32
Summer 2019,6/19/2019,Wednesday,2:30 PM,9,1,6,2,0,18
Summer 2019,6/19/2019,Wednesday,6:30 PM,3,2,5,0,0,10
Summer 2019,6/19/2019,Wednesday,7:30 PM,1,1,3,3,0,8
Summer 2019,6/19/2019,Wednesday,8:30 PM,2,1,1,0,0,4
Summer 2019,6/20/2019,Thursday,7:30 AM,3,0,0,0,1,4
Summer 2019,6/20/2019,Thursday,8:30 AM,2,0,1,2,0,5
Summer 2019,6/20/2019,Thursday,9:30 AM,4,1,6,0,1,12
Summer 2019,6/20/2019,Thursday,10:30 AM,1,1,2,0,2,6
Summer 2019,6/20/2019,Thursday,12:30 PM,18,3,13,6,3,43
Summer 2019,6/20/2019,Thursday,1:30 PM,13,3,5,3,0,24
Summer 2019,6/20/2019,Thursday,2:30 PM,8,3,3,3,0,17
Summer 2019,6/20/2019,Thursday,5:30 PM,13,1,3,0,0,17
Summer 2019,6/20/2019,Thursday,6:30 PM,0,1,1,0,0,2
Summer 2019,6/20/2019,Thursday,7:30 PM,2,0,1,0,0,3
Summer 2019,6/21/2019,Friday,7:30 AM,1,0,0,0,0,1
Summer 2019,6/21/2019,Friday,8:30 AM,2,0,0,2,0,4
Summer 2019,6/21/2019,Friday,9:30 AM,3,0,1,2,2,8
Summer 2019,6/21/2019,Friday,10:30 AM,9,2,1,2,0,14
Summer 2019,6/21/2019,Friday,11:30 AM,9,3,0,0,0,12
Summer 2019,6/21/2019,Friday,12:30 PM,8,3,0,0,0,11
Summer 2019,6/24/2019,Monday,7:30 AM,2,0,1,0,0,3
Summer 2019,6/24/2019,Monday,8:30 AM,6,1,1,0,1,9
Summer 2019,6/24/2019,Monday,9:30 AM,6,2,4,1,0,13
Summer 2019,6/24/2019,Monday,10:30 AM,12,2,2,2,0,18
Summer 2019,6/24/2019,Monday,11:30 AM,9,0,8,1,0,18
Summer 2019,6/24/2019,Monday,12:30 PM,20,5,9,2,0,36
Summer 2019,6/24/2019,Monday,1:30 PM,14,0,3,0,0,17
Summer 2019,6/24/2019,Monday,2:30 PM,5,1,7,1,0,14
Summer 2019,6/24/2019,Monday,5:30 PM,9,2,4,0,0,15
Summer 2019,6/24/2019,Monday,6:30 PM,5,0,5,1,0,11
Summer 2019,6/24/2019,Monday,7:30 PM,6,0,1,0,0,7
Summer 2019,6/24/2019,Monday,8:30 PM,4,0,0,0,0,4
Summer 2019,6/25/2019,Tuesday,7:30 AM,0,0,0,0,0,0
Summer 2019,6/25/2019,Tuesday,8:30 AM,3,0,1,0,0,4
Summer 2019,6/25/2019,Tuesday,9:30 AM,2,0,4,0,0,6
Summer 2019,6/25/2019,Tuesday,10:30 AM,4,3,4,0,0,11
Summer 2019,6/25/2019,Tuesday,11:30 AM,6,3,3,1,0,13
Summer 2019,6/25/2019,Tuesday,12:30 PM,13,3,4,1,0,21
Summer 2019,6/25/2019,Tuesday,1:30 PM,13,3,0,3,0,19
Summer 2019,6/25/2019,Tuesday,2:30 PM,9,2,6,1,0,18
Summer 2019,6/25/2019,Tuesday,4:30 PM,6,0,4,4,0,14
Summer 2019,6/25/2019,Tuesday,5:30 PM,9,1,5,3,0,18
Summer 2019,6/25/2019,Tuesday,8:30 PM,5,0,0,0,0,5
Summer 2019,6/26/2019,Wednesday,7:30 AM,1,0,0,0,0,1
Summer 2019,6/26/2019,Wednesday,8:30 AM,5,0,2,0,0,7
Summer 2019,6/26/2019,Wednesday,9:30 AM,7,1,3,1,0,12
Summer 2019,6/26/2019,Wednesday,10:30 AM,4,2,5,1,2,14
Summer 2019,6/26/2019,Wednesday,11:30 AM,4,2,15,0,2,23
Summer 2019,6/26/2019,Wednesday,12:30 PM,10,3,16,0,3,32
Summer 2019,6/26/2019,Wednesday,1:30 PM,6,2,4,0,0,12
Summer 2019,6/26/2019,Wednesday,4:30 PM,15,1,1,1,0,18
Summer 2019,6/26/2019,Wednesday,5:30 PM,10,2,6,1,0,19
Summer 2019,6/26/2019,Wednesday,6:30 PM,2,2,3,1,0,8
Summer 2019,6/26/2019,Wednesday,8:30 PM,3,1,3,0,0,7
Summer 2019,6/27/2019,Thursday,7:30 AM,0,0,0,0,0,0
Summer 2019,6/27/2019,Thursday,8:30 AM,5,0,10,0,0,15
Summer 2019,6/27/2019,Thursday,9:30 AM,3,1,2,0,1,7
Summer 2019,6/27/2019,Thursday,10:30 AM,4,1,2,0,0,7
Summer 2019,6/27/2019,Thursday,11:30 AM,11,0,5,2,1,19
Summer 2019,6/27/2019,Thursday,12:30 PM,15,2,7,2,2,28
Summer 2019,6/27/2019,Thursday,1:30 PM,4,1,1,1,1,8
Summer 2019,6/27/2019,Thursday,2:30 PM,6,0,5,1,0,12
Summer 2019,6/27/2019,Thursday,4:30 PM,7,1,8,1,0,17
Summer 2019,6/27/2019,Thursday,5:30 PM,9,2,5,1,0,17
Summer 2019,6/27/2019,Thursday,6:30 PM,8,0,3,1,0,12
Summer 2019,6/27/2019,Thursday,7:30 PM,11,0,1,1,0,13
Summer 2019,6/27/2019,Thursday,8:30 PM,8,1,0,1,0,10
Summer 2019,6/28/2019,Friday,7:30 AM,1,0,0,0,0,1
Summer 2019,6/28/2019,Friday,8:30 AM,3,0,0,1,0,4
Summer 2019,6/28/2019,Friday,9:30 AM,3,0,0,0,0,3
Summer 2019,6/28/2019,Friday,10:30 AM,1,1,3,1,1,7
Summer 2019,6/28/2019,Friday,11:30 AM,6,1,2,0,0,9
Summer 2019,6/28/2019,Friday,12:30 PM,7,1,3,0,0,11
Summer 2019,7/1/2019,Monday,7:30 AM,3,0,1,0,0,4
Summer 2019,7/1/2019,Monday,8:30 AM,3,1,0,1,1,6
Summer 2019,7/1/2019,Monday,9:30 AM,10,1,4,1,3,19
Summer 2019,7/1/2019,Monday,10:30 AM,8,1,2,1,0,12
Summer 2019,7/1/2019,Monday,11:30 AM,7,1,5,0,2,15
Summer 2019,7/1/2019,Monday,12:30 PM,18,3,7,0,0,28
Summer 2019,7/1/2019,Monday,1:30 PM,11,2,3,2,4,22
Summer 2019,7/1/2019,Monday,2:30 PM,9,2,9,8,1,29
Summer 2019,7/1/2019,Monday,4:30 PM,8,2,6,1,0,17
Summer 2019,7/1/2019,Monday,5:30 PM,13,1,7,1,1,23
Summer 2019,7/1/2019,Monday,6:30 PM,8,1,3,1,0,13
Summer 2019,7/1/2019,Monday,7:30 PM,5,0,4,1,0,10
Summer 2019,7/1/2019,Monday,8:30 PM,3,0,1,0,0,4
Summer 2019,7/2/2019,Tuesday,7:30 AM,0,0,0,0,0,0
Summer 2019,7/2/2019,Tuesday,8:30 AM,3,1,2,0,0,6
Summer 2019,7/2/2019,Tuesday,9:30 AM,6,2,1,2,1,12
Summer 2019,7/2/2019,Tuesday,10:30 AM,16,1,1,8,1,27
Summer 2019,7/2/2019,Tuesday,11:30 AM,10,0,1,2,0,13
Summer 2019,7/2/2019,Tuesday,12:30 PM,13,1,5,1,1,21
Summer 2019,7/2/2019,Tuesday,1:30 PM,7,0,4,1,0,12
Summer 2019,7/2/2019,Tuesday,2:30 PM,7,0,9,1,0,17
Summer 2019,7/2/2019,Tuesday,4:30 PM,10,1,6,4,0,21
Summer 2019,7/2/2019,Tuesday,5:30 PM,10,2,10,3,0,25
Summer 2019,7/2/2019,Tuesday,7:30 PM,5,0,2,1,0,8
Summer 2019,7/2/2019,Tuesday,8:30 PM,3,0,1,0,0,4
Summer 2019,7/3/2019,Wednesday,7:30 AM,0,0,0,0,0,0
Summer 2019,7/3/2019,Wednesday,8:30 AM,5,1,1,0,0,7
Summer 2019,7/3/2019,Wednesday,9:30 AM,6,0,2,2,1,11
Summer 2019,7/3/2019,Wednesday,10:30 AM,7,3,2,7,0,19
Summer 2019,7/3/2019,Wednesday,11:30 AM,6,2,3,5,0,16
Summer 2019,7/3/2019,Wednesday,12:30 PM,9,0,9,0,0,18
Summer 2019,7/3/2019,Wednesday,1:30 PM,3,2,4,2,0,11
Summer 2019,7/3/2019,Wednesday,2:30 PM,7,2,3,1,0,13
Summer 2019,7/3/2019,Wednesday,5:30 PM,6,1,4,1,0,12
Summer 2019,7/3/2019,Wednesday,6:30 PM,2,1,2,1,0,6
Summer 2019,7/3/2019,Wednesday,8:30 PM,5,0,2,0,0,7
Summer 2019,7/5/2019,Friday,7:30 AM,1,0,0,0,0,1
Summer 2019,7/5/2019,Friday,8:30 AM,2,0,0,1,0,3
Summer 2019,7/5/2019,Friday,9:30 AM,3,1,1,1,0,6
Summer 2019,7/5/2019,Friday,10:30 AM,4,1,1,1,0,7
Summer 2019,7/5/2019,Friday,11:30 AM,3,1,0,0,0,4
Summer 2019,7/5/2019,Friday,12:30 PM,2,2,1,0,0,5
Summer 2019,7/8/2019,Monday,7:30 AM,1,0,0,0,0,1
Summer 2019,7/8/2019,Monday,8:30 AM,3,1,0,2,0,6
Summer 2019,7/8/2019,Monday,9:30 AM,10,1,4,3,4,22
Summer 2019,7/8/2019,Monday,9:30 AM,26,2,6,3,2,39
Summer 2019,7/8/2019,Monday,11:30 AM,8,2,9,0,1,20
Summer 2019,7/8/2019,Monday,12:30 PM,20,2,12,0,3,37
Summer 2019,7/8/2019,Monday,1:30 PM,8,2,3,1,2,16
Summer 2019,7/8/2019,Monday,2:30 PM,15,4,9,0,0,28
Summer 2019,7/9/2019,Tuesday,7:30 AM,1,0,0,0,0,1
Summer 2019,7/9/2019,Tuesday,8:30 AM,6,1,0,1,0,8
Summer 2019,7/9/2019,Tuesday,9:30 AM,5,0,3,0,0,8
Summer 2019,7/9/2019,Tuesday,9:30 AM,5,0,3,0,0,8
Summer 2019,7/9/2019,Tuesday,10:30 AM,14,0,5,3,0,22
Summer 2019,7/9/2019,Tuesday,11:30 AM,12,1,3,2,0,18
Summer 2019,7/9/2019,Tuesday,12:30 PM,11,2,5,2,0,20
Summer 2019,7/9/2019,Tuesday,1:30 PM,10,1,5,1,0,17
Summer 2019,7/10/2019,Wednesday,7:30 AM,1,0,0,0,0,1
Summer 2019,7/10/2019,Wednesday,8:30 AM,3,1,0,0,0,4
Summer 2019,7/10/2019,Wednesday,9:30 AM,9,1,3,1,0,14
Summer 2019,7/10/2019,Wednesday,10:30 AM,10,0,5,3,0,18
Summer 2019,7/10/2019,Wednesday,11:30 AM,8,1,6,1,0,16
Summer 2019,7/10/2019,Wednesday,12:30 PM,18,1,14,0,0,33
Summer 2019,7/10/2019,Wednesday,1:30 PM,7,3,7,0,0,17
Summer 2019,7/10/2019,Wednesday,2:30 PM,10,5,11,0,0,26
Summer 2019,7/11/2019,Thursday,7:30 AM,0,0,0,0,0,0
Summer 2019,7/11/2019,Thursday,8:30 AM,7,0,13,0,0,20
Summer 2019,7/11/2019,Thursday,9:30 AM,6,1,3,0,0,10
Summer 2019,7/11/2019,Thursday,10:30 AM,11,2,5,0,0,18
Summer 2019,7/11/2019,Thursday,11:30 AM,10,1,9,3,1,24
Summer 2019,7/11/2019,Thursday,12:30 PM,14,2,6,0,1,23
Summer 2019,7/11/2019,Thursday,1:30 PM,10,1,4,2,0,17
Summer 2019,7/11/2019,Thursday,4:30 PM,6,2,2,2,0,12
Summer 2019,7/11/2019,Thursday,5:30 PM,9,1,1,1,0,12
Summer 2019,7/11/2019,Thursday,6:30 PM,7,0,1,1,0,9
Summer 2019,7/11/2019,Thursday,7:30 PM,3,0,1,1,0,5
Summer 2019,7/11/2019,Thursday,8:30 PM,4,0,2,0,0,6
Summer 2019,7/12/2019,Friday,7:30 AM,1,0,0,0,0,1
Summer 2019,7/12/2019,Friday,8:30 AM,3,0,0,1,0,4
Summer 2019,7/12/2019,Friday,10:30 AM,11,1,4,6,0,22
Summer 2019,7/12/2019,Friday,11:30 AM,8,1,5,0,0,14
Summer 2019,7/15/2019,Monday,7:30 AM,3,0,2,1,0,6
Summer 2019,7/15/2019,Monday,8:30 AM,6,2,0,1,0,9
Summer 2019,7/15/2019,Monday,9:30 AM,3,1,6,1,0,11
Summer 2019,7/15/2019,Monday,10:30 AM,9,3,5,4,0,21
Summer 2019,7/15/2019,Monday,11:30 AM,14,4,10,2,0,30
Summer 2019,7/15/2019,Monday,12:30 PM,20,5,9,0,0,34
Summer 2019,7/15/2019,Monday,1:30 PM,12,2,3,1,0,18
Summer 2019,7/15/2019,Monday,2:30 PM,14,2,7,0,0,23
Summer 2019,7/15/2019,Monday,4:30 PM,14,4,11,2,0,31
Summer 2019,7/15/2019,Monday,5:30 PM,11,2,4,6,1,24
Summer 2019,7/15/2019,Monday,6:30 PM,9,2,1,5,1,18
Summer 2019,7/15/2019,Monday,7:30 PM,6,1,1,5,0,13
Summer 2019,7/15/2019,Monday,8:30 PM,3,0,2,1,0,6
Summer 2019,7/16/2019,Tuesday,7:30 AM,1,0,0,0,0,1
Summer 2019,7/16/2019,Tuesday,8:30 AM,5,0,2,0,0,7
Summer 2019,7/16/2019,Tuesday,9:30 AM,5,0,3,0,1,9
Summer 2019,7/16/2019,Tuesday,10:30 AM,8,1,7,5,0,21
Summer 2019,7/16/2019,Tuesday,4:30 PM,10,1,6,2,0,19
Summer 2019,7/16/2019,Tuesday,5:30 PM,10,1,5,2,0,18
Summer 2019,7/16/2019,Tuesday,6:30 PM,8,0,4,2,0,14
Summer 2019,7/16/2019,Tuesday,7:30 PM,1,0,2,0,1,4
Summer 2019,7/16/2019,Tuesday,8:30 PM,3,0,1,0,0,4
Summer 2019,7/17/2019,Wednesday,7:30 AM,1,0,0,0,1,2
Summer 2019,7/17/2019,Wednesday,8:30 AM,7,1,0,1,1,10
Summer 2019,7/17/2019,Wednesday,9:30 AM,6,3,1,1,0,11
Summer 2019,7/17/2019,Wednesday,10:30 AM,6,3,5,6,0,20
Summer 2019,7/17/2019,Wednesday,11:30 AM,8,1,13,9,0,31
Summer 2019,7/17/2019,Wednesday,12:30 PM,9,2,11,4,0,26
Summer 2019,7/17/2019,Wednesday,1:30 PM,10,4,14,8,0,36
Summer 2019,7/17/2019,Wednesday,2:30 PM,7,4,16,6,0,33
Summer 2019,7/17/2019,Wednesday,5:30 PM,12,0,5,2,0,19
Summer 2019,7/17/2019,Wednesday,6:30 PM,10,0,4,2,0,16
Summer 2019,7/17/2019,Wednesday,7:30 PM,6,2,3,2,0,13
Summer 2019,7/17/2019,Wednesday,8:30 PM,3,2,2,0,0,7
Summer 2019,7/18/2019,Thursday,7:30 AM,0,0,0,0,0,0
Summer 2019,7/18/2019,Thursday,8:30 AM,3,2,1,0,0,6
Summer 2019,7/18/2019,Thursday,9:30 AM,5,0,1,0,0,6
Summer 2019,7/18/2019,Thursday,10:30 AM,5,2,5,0,0,12
Summer 2019,7/18/2019,Thursday,11:30 AM,9,2,11,3,0,25
Summer 2019,7/18/2019,Thursday,12:30 PM,11,0,10,2,3,26
Summer 2019,7/18/2019,Thursday,1:30 PM,5,1,9,1,3,19
Summer 2019,7/18/2019,Thursday,2:30 PM,7,2,11,2,0,22
Summer 2019,7/18/2019,Thursday,3:30 PM,7,1,7,1,0,16
Summer 2019,7/18/2019,Thursday,4:30 PM,8,1,5,1,0,15
Summer 2019,7/18/2019,Thursday,5:30 PM,5,3,1,0,2,11
Summer 2019,7/18/2019,Thursday,6:30 PM,2,1,0,0,0,3
Summer 2019,7/18/2019,Thursday,7:30 PM,2,0,1,0,0,3
Summer 2019,7/18/2019,Thursday,8:30 PM,1,0,0,0,2,3
Summer 2019,7/19/2019,Friday,7:30 AM,1,0,0,0,0,1
Summer 2019,7/19/2019,Friday,8:30 AM,2,0,1,0,0,3
Summer 2019,7/19/2019,Friday,9:30 AM,3,0,0,7,1,11
Summer 2019,7/19/2019,Friday,10:30 AM,5,1,5,8,0,19
Summer 2019,7/19/2019,Friday,11:30 AM,6,3,6,5,1,21
Summer 2019,7/22/2019,Monday,7:30 AM,2,0,2,0,0,4
Summer 2019,7/22/2019,Monday,8:30 AM,5,0,7,4,0,16
Summer 2019,7/22/2019,Monday,9:30 AM,5,2,4,0,5,16
Summer 2019,7/22/2019,Monday,10:30 AM,6,3,3,1,0,13
Summer 2019,7/22/2019,Monday,11:30 AM,28,3,7,0,0,38
Summer 2019,7/22/2019,Monday,12:30 PM,21,2,11,6,2,42
Summer 2019,7/22/2019,Monday,1:30 PM,10,2,3,0,2,17
Summer 2019,7/22/2019,Monday,2:30 PM,12,5,6,0,0,23
Summer 2019,7/22/2019,Monday,4:30 PM,13,0,6,0,0,19
Summer 2019,7/22/2019,Monday,6:30 PM,16,1,4,1,0,22
Summer 2019,7/22/2019,Monday,8:30 PM,6,1,1,0,0,8
Summer 2019,7/23/2019,Tuesday,7:30 AM,1,0,0,0,0,1
Summer 2019,7/23/2019,Tuesday,8:30 AM,5,0,3,1,0,9
Summer 2019,7/23/2019,Tuesday,9:30 AM,5,0,4,2,1,12
Summer 2019,7/23/2019,Tuesday,10:30 AM,8,0,4,0,0,12
Summer 2019,7/23/2019,Tuesday,11:30 AM,10,3,5,1,0,19
Summer 2019,7/23/2019,Tuesday,12:30 PM,17,3,6,3,0,29
Summer 2019,7/23/2019,Tuesday,1:30 PM,13,1,3,2,0,19
Summer 2019,7/23/2019,Tuesday,2:30 PM,14,1,6,2,3,26
Summer 2019,7/23/2019,Tuesday,4:30 PM,10,2,6,1,0,19
Summer 2019,7/23/2019,Tuesday,5:30 PM,16,3,8,0,1,28
Summer 2019,7/23/2019,Tuesday,7:30 PM,3,2,6,2,0,13
Summer 2019,7/23/2019,Tuesday,8:30 PM,4,0,5,0,0,9
Summer 2019,7/24/2019,Wednesday,7:30 AM,1,0,0,0,0,1
Summer 2019,7/24/2019,Wednesday,8:30 AM,10,0,8,1,0,19
Summer 2019,7/24/2019,Wednesday,9:30 AM,5,1,3,1,2,12
Summer 2019,7/24/2019,Wednesday,10:30 AM,9,1,7,2,0,19
Summer 2019,7/24/2019,Wednesday,11:30 AM,10,3,6,0,0,19
Summer 2019,7/24/2019,Wednesday,12:30 PM,16,2,8,0,0,26
Summer 2019,7/24/2019,Wednesday,1:30 PM,9,3,1,0,0,13
Summer 2019,7/24/2019,Wednesday,2:30 PM,10,3,3,0,0,16
Summer 2019,7/24/2019,Wednesday,5:30 PM,16,2,6,0,0,24
Summer 2019,7/24/2019,Wednesday,6:30 PM,16,2,5,1,2,26
Summer 2019,7/24/2019,Wednesday,8:30 PM,6,1,3,4,0,14
Summer 2019,7/25/2019,Thursday,7:30 AM,0,0,0,0,0,0
Summer 2019,7/25/2019,Thursday,8:30 AM,3,0,4,0,0,7
Summer 2019,7/25/2019,Thursday,9:30 AM,1,0,1,0,0,2
Summer 2019,7/25/2019,Thursday,10:30 AM,7,2,6,0,0,15
Summer 2019,7/25/2019,Thursday,11:30 AM,12,1,4,2,0,19
Summer 2019,7/25/2019,Thursday,12:30 PM,14,2,8,1,0,25
Summer 2019,7/25/2019,Thursday,1:30 PM,6,0,5,1,0,12
Summer 2019,7/25/2019,Thursday,2:30 PM,10,1,4,6,1,22
Summer 2019,7/25/2019,Thursday,4:30 PM,8,0,9,4,0,21
Summer 2019,7/25/2019,Thursday,6:30 PM,6,1,2,0,0,9
Summer 2019,7/25/2019,Thursday,7:30 PM,6,0,4,0,0,10
Summer 2019,7/25/2019,Thursday,8:30 PM,2,0,4,0,0,6
Summer 2019,7/26/2019,Friday,8:30 AM,1,0,2,0,0,3
Summer 2019,7/26/2019,Friday,9:30 AM,4,0,3,0,0,7
Summer 2019,7/26/2019,Friday,10:30 AM,4,0,1,2,0,7
Summer 2019,7/26/2019,Friday,11:30 AM,3,0,2,2,0,7
Summer 2019,7/26/2019,Friday,12:30 PM,7,2,2,0,0,11
Fall Intersession 2019,7/29/2019,Monday,7:30 AM,1,0,0,0,0,1
Fall Intersession 2019,7/29/2019,Monday,8:30 AM,1,0,0,0,1,2
Fall Intersession 2019,7/29/2019,Monday,9:30 AM,5,0,1,3,0,9
Fall Intersession 2019,7/29/2019,Monday,10:30 AM,3,0,1,2,0,6
Fall Intersession 2019,7/29/2019,Monday,3:30 PM,1,0,2,0,0,3
Fall Intersession 2019,7/29/2019,Monday,2:30 PM,2,0,2,0,0,4
Fall Intersession 2019,7/29/2019,Monday,4:30 PM,1,1,2,0,0,4
Fall Intersession 2019,7/29/2019,Monday,5:30 PM,1,1,1,0,1,4
Fall Intersession 2019,7/30/2019,Tuesday,7:30 AM,0,0,0,0,0,0
Fall Intersession 2019,7/30/2019,Tuesday,8:30 AM,1,0,0,1,0,2
Fall Intersession 2019,7/30/2019,Tuesday,11:30 AM,4,0,0,0,0,4
Fall Intersession 2019,7/30/2019,Tuesday,12:30 PM,2,0,1,0,0,3
Fall Intersession 2019,7/30/2019,Tuesday,1:30 PM,5,5,4,0,0,14
Fall Intersession 2019,7/30/2019,Tuesday,2:30 PM,6,0,3,0,0,9
Fall Intersession 2019,7/30/2019,Tuesday,4:30 PM,4,0,3,0,0,7
Fall Intersession 2019,7/30/2019,Tuesday,5:30 PM,2,2,2,0,0,6
Fall Intersession 2019,7/31/2019,Wednesday,7:30 AM,1,0,0,0,0,1
Fall Intersession 2019,7/31/2019,Wednesday,8:30 AM,1,0,0,0,0,1
Fall Intersession 2019,7/31/2019,Wednesday,10:30 AM,5,1,2,0,0,8
Fall Intersession 2019,7/31/2019,Wednesday,11:30 AM,2,0,0,0,0,2
Fall Intersession 2019,7/31/2019,Wednesday,12:30 PM,4,1,3,1,0,9
Fall Intersession 2019,7/31/2019,Wednesday,1:30 PM,2,1,4,0,0,7
Fall Intersession 2019,7/31/2019,Wednesday,2:30 PM,3,1,1,0,0,5
Fall Intersession 2019,7/31/2019,Wednesday,5:30 PM,1,0,0,0,0,1
Fall Intersession 2019,8/1/2019,Thursday,7:30 AM,0,0,0,0,0,0
Fall Intersession 2019,8/1/2019,Thursday,9:30 AM,1,2,1,0,0,4
Fall Intersession 2019,8/1/2019,Thursday,11:30 AM,4,4,4,0,0,12
Fall Intersession 2019,8/1/2019,Thursday,12:30 PM,1,1,4,0,0,6
Fall Intersession 2019,8/1/2019,Thursday,1:30 PM,3,1,3,0,0,7
Fall Intersession 2019,8/1/2019,Thursday,2:30 PM,3,1,4,0,0,8
Fall Intersession 2019,8/1/2019,Thursday,4:30 PM,1,0,1,0,0,2
Fall Intersession 2019,8/1/2019,Thursday,5:30 PM,2,0,1,0,0,3
Fall Intersession 2019,8/2/2019,Friday,7:30 AM,0,0,0,0,0,0
Fall Intersession 2019,8/2/2019,Friday,8:30 AM,2,0,0,0,0,2
Fall Intersession 2019,8/2/2019,Friday,9:30 AM,4,0,0,0,0,4
Fall Intersession 2019,8/2/2019,Friday,10:30 AM,4,0,0,0,0,4
Fall Intersession 2019,8/2/2019,Friday,11:30 AM,4,1,2,0,0,7
Fall Intersession 2019,8/2/2019,Friday,12:30 PM,4,1,2,0,0,7
Fall Intersession 2019,8/2/2019,Friday,1:30 PM,3,0,3,0,0,6
Fall Intersession 2019,8/5/2019,Monday,7:30 AM,1,0,0,0,0,1
Fall Intersession 2019,8/5/2019,Monday,8:30 AM,2,1,2,0,0,5
Fall Intersession 2019,8/5/2019,Monday,9:30 AM,1,1,2,0,0,4
Fall Intersession 2019,8/5/2019,Monday,10:30 AM,8,2,0,0,0,10
Fall Intersession 2019,8/5/2019,Monday,11:30 AM,5,2,2,0,0,9
Fall Intersession 2019,8/5/2019,Monday,12:30 PM,4,2,4,0,0,10
Fall Intersession 2019,8/5/2019,Monday,1:30 PM,2,2,4,0,0,8
Fall Intersession 2019,8/5/2019,Monday,2:30 PM,5,0,3,0,0,8
Fall Intersession 2019,8/5/2019,Monday,4:30 PM,1,2,1,1,0,5
Fall Intersession 2019,8/6/2019,Tuesday,7:30 AM,1,0,0,0,0,1
Fall Intersession 2019,8/6/2019,Tuesday,8:30 AM,1,0,0,0,0,1
Fall Intersession 2019,8/6/2019,Tuesday,9:30 AM,1,0,0,0,0,1
Fall Intersession 2019,8/6/2019,Tuesday,10:30 AM,2,0,0,0,0,2
Fall Intersession 2019,8/6/2019,Tuesday,11:30 AM,6,2,1,0,0,9
Fall Intersession 2019,8/6/2019,Tuesday,12:30 PM,3,0,3,0,0,6
Fall Intersession 2019,8/6/2019,Tuesday,2:30 PM,4,1,1,0,0,6
Fall Intersession 2019,8/6/2019,Tuesday,4:30 PM,3,1,3,0,0,7
Fall Intersession 2019,8/6/2019,Tuesday,5:30 PM,4,1,2,0,0,7
Fall Intersession 2019,8/7/2019,Wednesday,7:30 AM,2,0,0,0,0,2
Fall Intersession 2019,8/7/2019,Wednesday,8:30 AM,2,0,0,0,0,2
Fall Intersession 2019,8/7/2019,Wednesday,9:30 AM,2,0,0,0,0,2
Fall Intersession 2019,8/7/2019,Wednesday,10:30 AM,2,0,1,0,0,3
Fall Intersession 2019,8/7/2019,Wednesday,11:30 AM,2,0,0,0,0,2
Fall Intersession 2019,8/7/2019,Wednesday,12:30 PM,3,1,3,0,0,7
Fall Intersession 2019,8/7/2019,Wednesday,1:30 PM,1,1,2,0,0,4
Fall Intersession 2019,8/7/2019,Wednesday,2:30 PM,1,1,2,0,0,4
Fall Intersession 2019,8/7/2019,Wednesday,4:30 PM,1,3,3,0,0,7
Fall Intersession 2019,8/7/2019,Wednesday,5:30 PM,3,0,3,0,0,6
Fall Intersession 2019,8/8/2019,Thursday,7:30 AM,0,0,0,0,0,0
Fall Intersession 2019,8/8/2019,Thursday,8:30 AM,0,0,0,0,0,0
Fall Intersession 2019,8/8/2019,Thursday,9:30 AM,0,0,0,0,0,0
Fall Intersession 2019,8/8/2019,Thursday,10:30 AM,3,0,0,0,0,3
Fall Intersession 2019,8/8/2019,Thursday,10:30 AM,3,0,0,0,0,3
Fall Intersession 2019,8/8/2019,Thursday,11:30 AM,5,0,0,0,0,5
Fall Intersession 2019,8/8/2019,Thursday,12:30 PM,5,0,1,0,0,6
Fall Intersession 2019,8/8/2019,Thursday,1:30 PM,6,0,0,0,0,6
Fall Intersession 2019,8/8/2019,Thursday,2:30 PM,7,1,2,0,0,10
Fall Intersession 2019,8/8/2019,Thursday,1:30 PM,3,1,3,0,4,11
Fall Intersession 2019,8/8/2019,Thursday,2:30 PM,3,0,2,0,0,5
Fall Intersession 2019,8/8/2019,Thursday,5:30 PM,2,0,1,0,0,3
Fall Intersession 2019,8/9/2019,Friday,7:30 AM,1,0,0,0,0,1
Fall Intersession 2019,8/9/2019,Friday,8:30 AM,1,0,0,0,0,1
Fall Intersession 2019,8/9/2019,Friday,9:30 AM,2,0,0,0,0,2
Fall Intersession 2019,8/9/2019,Friday,10:30 AM,4,0,0,0,0,4
Fall Intersession 2019,8/9/2019,Friday,11:30 AM,5,0,1,0,0,6
Fall Intersession 2019,8/9/2019,Friday,12:30 PM,5,1,2,0,0,8
Fall Intersession 2019,8/9/2019,Friday,1:30 PM,3,2,1,0,0,6
Fall Intersession 2019,8/9/2019,Friday,2:30 PM,1,1,1,0,0,3
Fall Intersession 2019,8/9/2019,Friday,4:30 PM,3,0,0,0,0,3
Fall Intersession 2019,8/12/2019,Monday,7:30 AM,1,0,0,0,0,1
Fall Intersession 2019,8/12/2019,Monday,7:30 AM,0,0,0,0,0,0
Fall Intersession 2019,8/12/2019,Monday,8:30 AM,2,0,2,0,0,4
Fall Intersession 2019,8/12/2019,Monday,9:30 AM,3,1,2,0,0,6
Fall Intersession 2019,8/12/2019,Monday,10:30 AM,9,1,1,0,0,11
Fall Intersession 2019,8/12/2019,Monday,11:30 AM,10,3,2,0,2,17
Fall Intersession 2019,8/12/2019,Monday,12:30 PM,4,0,4,0,0,8
Fall Intersession 2019,8/12/2019,Monday,12:30 PM,9,1,8,0,0,18
Fall Intersession 2019,8/12/2019,Monday,1:30 PM,9,1,7,0,0,17
Fall Intersession 2019,8/12/2019,Monday,2:30 PM,7,3,3,0,0,13
Fall Intersession 2019,8/13/2019,Tuesday,7:30 AM,0,0,0,0,0,0
Fall Intersession 2019,8/13/2019,Tuesday,8:30 AM,0,0,0,0,0,0
Fall Intersession 2019,8/13/2019,Tuesday,9:30 AM,3,0,0,0,0,3
Fall Intersession 2019,8/13/2019,Tuesday,10:30 AM,5,1,3,0,0,9
Fall Intersession 2019,8/13/2019,Tuesday,10:30 AM,5,1,3,0,0,9
Fall Intersession 2019,8/13/2019,Tuesday,11:30 AM,4,0,1,0,0,5
Fall Intersession 2019,8/13/2019,Tuesday,12:30 PM,5,0,1,0,0,6
Fall Intersession 2019,8/13/2019,Tuesday,2:30 PM,11,0,1,0,0,12
Fall Intersession 2019,8/13/2019,Tuesday,4:30 PM,13,0,2,0,0,15
Fall Intersession 2019,8/14/2019,Wednesday,7:30 AM,1,0,0,0,0,1
Fall Intersession 2019,8/14/2019,Wednesday,8:30 AM,2,0,0,0,0,2
Fall Intersession 2019,8/14/2019,Wednesday,9:30 AM,3,0,1,0,0,4
Fall Intersession 2019,8/14/2019,Wednesday,10:30 AM,5,2,3,0,0,10
Fall Intersession 2019,8/14/2019,Wednesday,11:30 AM,6,0,3,0,0,9
Fall Intersession 2019,8/14/2019,Wednesday,12:30 PM,11,0,1,0,0,12
Fall Intersession 2019,8/14/2019,Wednesday,2:30 PM,12,0,2,1,0,15
Fall Intersession 2019,8/14/2019,Wednesday,3:30 PM,8,1,2,1,0,12
Fall Intersession 2019,8/15/2019,Thursday,7:30 AM,0,0,0,0,0,0
Fall Intersession 2019,8/15/2019,Thursday,8:30 AM,0,0,0,0,0,0
Fall Intersession 2019,8/15/2019,Thursday,9:30 AM,4,0,3,0,0,7
Fall Intersession 2019,8/15/2019,Thursday,10:30 AM,5,1,3,0,0,9
Fall Intersession 2019,8/15/2019,Thursday,11:30 AM,13,1,1,0,0,15
Fall Intersession 2019,8/15/2019,Thursday,12:30 PM,9,1,2,0,0,12
Fall Intersession 2019,8/15/2019,Thursday,1:30 PM,12,0,0,0,0,12
Fall Intersession 2019,8/15/2019,Thursday,2:30 PM,16,1,1,4,0,22
Fall Intersession 2019,8/15/2019,Thursday,4:30 PM,11,0,0,2,0,13
Fall Intersession 2019,8/16/2019,Friday,7:30 AM,2,0,0,0,0,2
Fall Intersession 2019,8/16/2019,Friday,8:30 AM,3,0,1,0,0,4
Fall Intersession 2019,8/16/2019,Friday,9:30 AM,4,1,1,0,0,6
Fall Intersession 2019,8/16/2019,Friday,10:30 AM,14,0,0,0,0,14
Fall Intersession 2019,8/16/2019,Friday,1:30 PM,8,0,4,0,0,12
Fall Intersession 2019,8/16/2019,Friday,3:30 PM,6,0,0,0,0,6
Fall Intersession 2019,8/16/2019,Friday,4:30 PM,7,0,1,0,0,8
Fall 2019,8/19/2019,Monday,7:30 AM,6,0,0,0,0,6
Fall 2019,8/19/2019,Monday,8:30 AM,15,1,2,0,0,18
Fall 2019,8/19/2019,Monday,9:30 AM,18,3,4,2,4,31
Fall 2019,8/19/2019,Monday,10:30 AM,22,3,12,2,0,39
Fall 2019,8/19/2019,Monday,11:30 AM,18,7,14,2,0,41
Fall 2019,8/19/2019,Monday,12:30 PM,21,9,36,8,0,74
Fall 2019,8/19/2019,Monday,1:30 PM,26,4,14,1,0,45
Fall 2019,8/19/2019,Monday,3:30 PM,31,7,12,1,2,53
Fall 2019,8/19/2019,Monday,4:30 PM,9,6,6,3,2,26
Fall 2019,8/19/2019,Monday,5:30 PM,11,3,8,1,4,27
Fall 2019,8/19/2019,Monday,6:30 PM,5,3,3,1,1,13
Fall 2019,8/19/2019,Monday,7:30 PM,7,1,5,2,0,15
Fall 2019,8/19/2019,Monday,8:30 PM,4,0,0,0,1,5
Fall 2019,8/20/2019,Tuesday,7:30 AM,0,0,0,0,0,0
Fall 2019,8/20/2019,Tuesday,8:30 AM,8,2,3,0,0,13
Fall 2019,8/20/2019,Tuesday,9:30 AM,14,2,7,2,0,25
Fall 2019,8/20/2019,Tuesday,10:30 AM,16,3,24,1,0,44
Fall 2019,8/20/2019,Tuesday,11:30 AM,23,7,19,3,2,54
Fall 2019,8/20/2019,Tuesday,1:30 PM,26,4,14,1,0,45
Fall 2019,8/20/2019,Tuesday,2:30 PM,17,5,9,1,4,36
Fall 2019,8/20/2019,Tuesday,3:30 PM,25,8,14,0,3,50
Fall 2019,8/20/2019,Tuesday,4:30 PM,9,6,6,3,2,26
Fall 2019,8/20/2019,Tuesday,5:30 PM,10,6,13,2,0,31
Fall 2019,8/20/2019,Tuesday,6:30 PM,8,2,12,1,0,23
Fall 2019,8/20/2019,Tuesday,7:30 PM,6,2,5,2,0,15
Fall 2019,8/20/2019,Tuesday,8:30 PM,3,0,4,0,0,7
Fall 2019,8/21/2019,Wednesday,7:30 AM,5,0,1,0,0,6
Fall 2019,8/21/2019,Wednesday,8:30 AM,5,2,1,1,0,9
Fall 2019,8/21/2019,Wednesday,9:30 AM,17,4,8,0,2,31
Fall 2019,8/21/2019,Wednesday,10:30 AM,25,5,16,0,3,49
Fall 2019,8/21/2019,Wednesday,11:30 AM,22,6,18,2,0,48
Fall 2019,8/21/2019,Wednesday,12:30 PM,40,9,50,5,0,104
Fall 2019,8/21/2019,Wednesday,1:30 PM,31,5,18,0,0,54
Fall 2019,8/21/2019,Wednesday,5:30 PM,13,3,6,4,2,28
Fall 2019,8/21/2019,Wednesday,7:30 PM,11,4,3,3,0,21
Fall 2019,8/21/2019,Wednesday,8:30 PM,5,1,0,0,0,6
Fall 2019,8/22/2019,Thursday,7:30 AM,1,0,0,0,0,1
Fall 2019,8/22/2019,Thursday,8:30 AM,12,3,10,0,0,25
Fall 2019,8/22/2019,Thursday,9:30 AM,20,4,4,0,0,28
Fall 2019,8/22/2019,Thursday,10:30 AM,23,1,13,7,3,47
Fall 2019,8/22/2019,Thursday,11:30 AM,27,7,18,5,0,57
Fall 2019,8/22/2019,Thursday,12:30 PM,37,7,45,9,5,103
Fall 2019,8/22/2019,Thursday,1:30 PM,20,5,18,1,3,47
Fall 2019,8/22/2019,Thursday,2:30 PM,25,7,22,2,0,56
Fall 2019,8/22/2019,Thursday,3:30 PM,12,1,15,5,1,34
Fall 2019,8/22/2019,Thursday,3:30 PM,23,3,18,3,4,51
Fall 2019,8/22/2019,Thursday,4:30 PM,21,3,17,4,4,49
Fall 2019,8/22/2019,Thursday,5:30 PM,11,3,11,7,2,34
Fall 2019,8/22/2019,Thursday,6:30 PM,12,3,12,3,0,30
Fall 2019,8/22/2019,Thursday,7:30 PM,27,1,5,2,0,35
Fall 2019,8/22/2019,Thursday,8:30 PM,6,1,4,0,0,11
Fall 2019,8/23/2019,Friday,7:30 AM,2,0,0,0,0,2
Fall 2019,8/23/2019,Friday,8:30 AM,4,1,1,0,0,6
Fall 2019,8/23/2019,Friday,9:30 AM,11,0,2,1,1,15
Fall 2019,8/23/2019,Friday,10:30 AM,18,1,3,2,0,24
Fall 2019,8/23/2019,Friday,5:30 PM,6,2,4,2,0,14
Fall 2019,8/23/2019,Friday,6:30 PM,7,2,2,0,0,11
Fall 2019,8/23/2019,Friday,7:30 PM,4,1,0,0,0,5
Fall 2019,8/24/2019,Saturday,10:30 AM,2,0,5,1,0,8
Fall 2019,8/24/2019,Saturday,11:30 AM,5,0,6,2,0,13
Fall 2019,8/24/2019,Saturday,12:30 PM,10,0,9,0,0,19
Fall 2019,8/24/2019,Saturday,1:30 PM,11,0,6,0,0,17
Fall 2019,8/24/2019,Saturday,2:30 PM,11,0,7,0,0,18
Fall 2019,8/24/2019,Saturday,4:30 PM,8,1,7,0,0,16
Fall 2019,8/26/2019,Monday,7:30 AM,4,0,0,0,2,6
Fall 2019,8/26/2019,Monday,8:30 AM,12,2,6,0,4,24
Fall 2019,8/26/2019,Monday,9:30 AM,27,4,19,2,3,55
Fall 2019,8/26/2019,Monday,10:30 AM,21,6,33,5,0,65
Fall 2019,8/26/2019,Monday,11:30 AM,26,7,23,10,2,68
Fall 2019,8/26/2019,Monday,1:30 PM,25,8,22,6,0,61
Fall 2019,8/26/2019,Monday,2:30 PM,22,4,20,5,0,51
Fall 2019,8/26/2019,Monday,3:30 PM,16,10,18,5,5,54
Fall 2019,8/26/2019,Monday,4:30 PM,19,8,17,5,4,53
Fall 2019,8/26/2019,Monday,5:30 PM,25,6,16,4,0,51
Fall 2019,8/26/2019,Monday,6:30 PM,8,3,4,2,0,17
Fall 2019,8/26/2019,Monday,7:30 PM,8,1,5,2,0,16
Fall 2019,8/26/2019,Monday,8:30 PM,7,0,4,0,0,11
Fall 2019,8/27/2019,Tuesday,7:30 AM,4,0,0,0,0,4
Fall 2019,8/27/2019,Tuesday,8:30 AM,8,3,5,0,0,16
Fall 2019,8/27/2019,Tuesday,9:30 AM,16,7,13,3,0,39
Fall 2019,8/27/2019,Tuesday,10:30 AM,17,6,19,1,0,43
Fall 2019,8/27/2019,Tuesday,11:30 AM,18,7,20,3,0,48
Fall 2019,8/27/2019,Tuesday,12:30 PM,34,9,30,7,1,81
Fall 2019,8/27/2019,Tuesday,3:30 PM,27,7,29,4,0,67
Fall 2019,8/27/2019,Tuesday,4:30 PM,20,4,12,3,2,41
Fall 2019,8/27/2019,Tuesday,5:30 PM,17,7,15,6,0,45
Fall 2019,8/27/2019,Tuesday,6:30 PM,6,2,4,2,0,14
Fall 2019,8/27/2019,Tuesday,7:30 PM,9,4,5,2,2,22
Fall 2019,8/27/2019,Tuesday,8:30 PM,5,2,3,0,0,10
Fall 2019,8/28/2019,Wednesday,7:30 AM,3,0,0,0,0,3
Fall 2019,8/28/2019,Wednesday,8:30 AM,7,3,3,0,0,13
Fall 2019,8/28/2019,Wednesday,9:30 AM,17,5,15,0,0,37
Fall 2019,8/28/2019,Wednesday,10:30 AM,26,6,20,0,3,55
Fall 2019,8/28/2019,Wednesday,11:30 AM,24,3,17,3,3,50
Fall 2019,8/28/2019,Wednesday,12:30 PM,27,8,46,1,4,86
Fall 2019,8/28/2019,Wednesday,1:30 PM,23,7,20,0,0,50
Fall 2019,8/28/2019,Wednesday,4:30 PM,17,4,14,0,2,37
Fall 2019,8/28/2019,Wednesday,6:30 PM,11,6,4,4,0,25
Fall 2019,8/28/2019,Wednesday,7:30 PM,9,6,11,4,0,30
Fall 2019,8/28/2019,Wednesday,8:30 PM,11,2,5,0,0,18
Fall 2019,8/29/2019,Thursday,7:30 AM,3,0,1,0,0,4
Fall 2019,8/29/2019,Thursday,8:30 AM,11,1,5,2,0,19
Fall 2019,8/29/2019,Thursday,9:30 AM,17,3,6,1,0,27
Fall 2019,8/29/2019,Thursday,10:30 AM,24,6,19,5,0,54
Fall 2019,8/29/2019,Thursday,12:30 PM,29,8,30,9,0,76
Fall 2019,8/29/2019,Thursday,1:30 PM,22,6,22,3,2,55
Fall 2019,8/29/2019,Thursday,3:30 PM,25,7,12,7,0,51
Fall 2019,8/29/2019,Thursday,5:30 PM,14,5,13,3,2,37
Fall 2019,8/29/2019,Thursday,6:30 PM,10,2,7,2,0,21
Fall 2019,8/29/2019,Thursday,7:30 PM,5,3,4,1,1,14
Fall 2019,8/29/2019,Thursday,8:30 PM,7,2,1,0,0,10
Fall 2019,8/30/2019,Friday,7:30 AM,2,0,0,0,0,2
Fall 2019,8/30/2019,Friday,8:30 AM,10,0,2,0,0,12
Fall 2019,8/30/2019,Friday,9:30 AM,8,0,1,2,0,11
Fall 2019,8/30/2019,Friday,10:30 AM,7,1,2,3,0,13
Fall 2019,8/30/2019,Friday,11:30 AM,10,2,1,3,0,16
Fall 2019,8/30/2019,Friday,1:30 PM,13,1,3,2,1,20
Fall 2019,8/30/2019,Friday,12:30 PM,8,1,6,1,2,18
Fall 2019,8/30/2019,Friday,6:30 PM,11,1,5,1,0,18
Fall 2019,8/30/2019,Friday,7:30 PM,5,1,0,0,0,6
Fall 2019,8/30/2019,Friday,8:30 PM,4,1,0,0,0,5
Fall 2019,8/31/2019,Saturday,10:30 AM,2,0,1,3,3,9
Fall 2019,8/31/2019,Saturday,11:30 AM,7,0,1,4,0,12
Fall 2019,8/31/2019,Saturday,12:30 PM,9,0,3,0,0,12
Fall 2019,8/31/2019,Saturday,1:30 PM,7,1,2,0,0,10
Fall 2019,8/31/2019,Saturday,1:30 PM,5,0,4,0,0,9
Fall 2019,8/31/2019,Saturday,2:30 PM,4,0,5,0,0,9
Fall 2019,8/31/2019,Saturday,3:30 PM,6,0,6,0,0,12
Fall 2019,8/31/2019,Saturday,4:30 PM,7,0,4,0,0,11
Fall 2019,9/4/2019,Wednesday,7:30 AM,7,0,0,0,0,7
Fall 2019,9/4/2019,Wednesday,8:30 AM,9,3,5,1,2,20
Fall 2019,9/4/2019,Wednesday,9:30 AM,28,6,13,0,10,57
Fall 2019,9/4/2019,Wednesday,10:30 AM,25,6,26,2,0,59
Fall 2019,9/4/2019,Wednesday,11:30 AM,25,7,21,1,0,54
Fall 2019,9/4/2019,Wednesday,12:30 PM,52,11,50,2,0,115
Fall 2019,9/4/2019,Wednesday,1:30 PM,25,9,20,4,0,58
Fall 2019,9/4/2019,Wednesday,3:30 PM,20,6,16,4,6,52
Fall 2019,9/4/2019,Wednesday,5:30 PM,17,5,13,3,2,40
Fall 2019,9/4/2019,Wednesday,7:30 PM,15,5,6,1,0,27
Fall 2019,9/4/2019,Wednesday,8:30 PM,6,1,4,0,0,11
Fall 2019,9/5/2019,Thursday,7:30 AM,1,0,1,0,0,2
Fall 2019,9/5/2019,Thursday,8:30 AM,16,4,9,0,0,29
Fall 2019,9/5/2019,Thursday,9:30 AM,19,5,18,2,0,44
Fall 2019,9/5/2019,Thursday,10:30 AM,30,8,20,5,0,63
Fall 2019,9/5/2019,Thursday,11:30 AM,22,8,18,6,0,54
Fall 2019,9/5/2019,Thursday,1:30 PM,22,3,26,6,0,57
Fall 2019,9/5/2019,Thursday,2:30 PM,18,8,20,2,3,51
Fall 2019,9/5/2019,Thursday,3:30 PM,19,8,18,3,2,50
Fall 2019,9/5/2019,Thursday,5:30 PM,15,6,21,6,0,48
Fall 2019,9/5/2019,Thursday,7:30 PM,10,5,8,2,0,25
Fall 2019,9/6/2019,Friday,7:30 AM,4,0,0,0,0,4
Fall 2019,9/6/2019,Friday,8:30 AM,5,1,1,0,0,7
Fall 2019,9/6/2019,Friday,10:30 AM,4,1,8,2,0,15
Fall 2019,9/6/2019,Friday,11:30 AM,13,4,2,1,0,20
Fall 2019,9/6/2019,Friday,12:30 PM,9,2,8,0,1,20
Fall 2019,9/6/2019,Friday,6:30 PM,8,2,8,3,0,21
Fall 2019,9/6/2019,Friday,7:30 PM,4,3,9,1,1,18
Fall 2019,9/6/2019,Friday,8:30 PM,0,4,3,1,0,8
Fall 2019,9/7/2019,Saturday,9:30 AM,1,0,0,0,1,2
Fall 2019,9/7/2019,Saturday,10:30 AM,8,2,2,0,0,12
Fall 2019,9/7/2019,Saturday,11:30 AM,8,2,8,0,0,18
Fall 2019,9/7/2019,Saturday,12:30 PM,9,2,7,0,0,18
Fall 2019,9/7/2019,Saturday,1:30 PM,12,2,8,0,0,22
Fall 2019,9/7/2019,Saturday,2:30 PM,10,3,7,0,0,20
Fall 2019,9/7/2019,Saturday,4:30 PM,7,1,5,0,0,13
Fall 2019,9/9/2019,Monday,7:30 AM,5,0,1,0,4,10
Fall 2019,9/9/2019,Monday,8:30 AM,11,1,7,0,0,19
Fall 2019,9/9/2019,Monday,9:30 AM,24,7,16,3,3,53
Fall 2019,9/9/2019,Monday,11:30 AM,19,8,25,0,0,52
Fall 2019,9/9/2019,Monday,12:30 PM,37,16,60,5,0,118
Fall 2019,9/9/2019,Monday,1:30 PM,31,12,14,1,0,58
Fall 2019,9/9/2019,Monday,2:30 PM,21,8,20,2,3,54
Fall 2019,9/9/2019,Monday,2:30 PM,21,8,20,2,3,54
Fall 2019,9/9/2019,Monday,3:30 PM,23,7,16,1,2,49
Fall 2019,9/9/2019,Monday,4:30 PM,18,10,12,3,0,43
Fall 2019,9/9/2019,Monday,5:30 PM,22,6,21,5,0,54
Fall 2019,9/10/2019,Tuesday,7:30 AM,3,0,0,0,0,3
Fall 2019,9/10/2019,Tuesday,8:30 AM,6,4,5,0,1,16
Fall 2019,9/10/2019,Tuesday,9:30 AM,22,5,19,4,0,50
Fall 2019,9/10/2019,Tuesday,10:30 AM,30,10,27,3,0,70
Fall 2019,9/10/2019,Tuesday,10:30 AM,24,9,23,6,2,64
Fall 2019,9/10/2019,Tuesday,1:30 PM,25,4,16,7,3,55
Fall 2019,9/10/2019,Tuesday,2:30 PM,35,5,20,5,3,68
Fall 2019,9/10/2019,Tuesday,3:30 PM,15,7,32,5,3,62
Fall 2019,9/10/2019,Tuesday,5:30 PM,15,5,18,4,1,43
Fall 2019,9/10/2019,Tuesday,6:30 PM,16,6,8,6,1,37
Fall 2019,9/10/2019,Tuesday,7:30 PM,13,5,12,4,0,34
Fall 2019,9/10/2019,Tuesday,8:30 PM,3,2,8,0,0,13
Fall 2019,9/11/2019,Wednesday,7:30 AM,7,0,4,0,0,11
Fall 2019,9/11/2019,Wednesday,8:30 AM,14,3,8,4,0,29
Fall 2019,9/11/2019,Wednesday,9:30 AM,24,9,17,2,4,56
Fall 2019,9/11/2019,Wednesday,10:30 AM,30,7,32,2,4,75
Fall 2019,9/11/2019,Wednesday,12:30 PM,45,12,39,6,1,103
Fall 2019,9/11/2019,Wednesday,1:30 PM,29,10,21,7,0,67
Fall 2019,9/11/2019,Wednesday,2:30 PM,16,7,15,10,5,53
Fall 2019,9/11/2019,Wednesday,4:30 PM,23,7,11,8,0,49
Fall 2019,9/11/2019,Wednesday,5:30 PM,21,9,13,2,0,45
Fall 2019,9/11/2019,Wednesday,7:30 PM,13,5,7,0,0,25
Fall 2019,9/11/2019,Wednesday,8:30 PM,19,4,7,0,0,30
Fall 2019,9/12/2019,Thursday,7:30 AM,9,0,2,0,0,11
Fall 2019,9/12/2019,Thursday,8:30 AM,17,4,5,1,0,27
Fall 2019,9/12/2019,Thursday,9:30 AM,20,4,15,4,0,43
Fall 2019,9/12/2019,Thursday,10:30 AM,29,8,25,6,3,71
Fall 2019,9/12/2019,Thursday,11:30 AM,25,9,25,7,0,66
Fall 2019,9/12/2019,Thursday,12:30 PM,41,10,38,11,0,100
Fall 2019,9/12/2019,Thursday,1:30 PM,15,7,15,7,0,44
Fall 2019,9/12/2019,Thursday,1:30 PM,15,7,15,7,0,44
Fall 2019,9/12/2019,Thursday,3:30 PM,29,6,13,6,3,57
Fall 2019,9/12/2019,Thursday,4:30 PM,17,5,7,3,2,34
Fall 2019,9/12/2019,Thursday,5:30 PM,16,5,10,3,1,35
Fall 2019,9/12/2019,Thursday,6:30 PM,8,5,10,1,0,24
Fall 2019,9/13/2019,Friday,7:30 AM,3,0,0,0,0,3
Fall 2019,9/13/2019,Friday,8:30 AM,4,0,2,1,0,7
Fall 2019,9/13/2019,Friday,9:30 AM,4,0,1,3,0,8
Fall 2019,9/13/2019,Friday,10:30 AM,9,0,6,0,0,15
Fall 2019,9/13/2019,Friday,12:30 PM,19,3,11,1,1,35
Fall 2019,9/13/2019,Friday,5:30 PM,14,4,8,3,0,29
Fall 2019,9/13/2019,Friday,6:30 PM,8,5,4,0,0,17
Fall 2019,9/13/2019,Friday,7:30 PM,6,4,5,1,0,16
Fall 2019,9/14/2019,Saturday,9:30 AM,4,1,1,0,0,6
Fall 2019,9/14/2019,Saturday,10:30 AM,9,1,4,0,0,14
Fall 2019,9/14/2019,Saturday,11:30 AM,9,2,4,0,0,15
Fall 2019,9/14/2019,Saturday,12:30 PM,8,2,3,1,0,14
Fall 2019,9/14/2019,Saturday,1:30 PM,8,3,5,1,0,17
Fall 2019,9/14/2019,Saturday,1:30 PM,8,3,4,3,0,18
Fall 2019,9/14/2019,Saturday,2:30 PM,6,3,10,4,0,23
Fall 2019,9/14/2019,Saturday,3:30 PM,8,2,12,1,0,23
Fall 2019,9/14/2019,Saturday,4:30 PM,9,1,5,0,1,16
Fall 2019,9/16/2019,Monday,7:30 AM,4,1,2,0,0,7
Fall 2019,9/16/2019,Monday,8:30 AM,10,7,7,3,1,28
Fall 2019,9/16/2019,Monday,9:30 AM,26,7,23,2,4,62
Fall 2019,9/16/2019,Monday,10:30 AM,28,8,25,4,2,67
Fall 2019,9/16/2019,Monday,12:30 PM,37,16,48,3,0,104
Fall 2019,9/16/2019,Monday,1:30 PM,19,8,20,6,2,55
Fall 2019,9/16/2019,Monday,2:30 PM,26,10,20,2,0,58
Fall 2019,9/16/2019,Monday,3:30 PM,21,6,18,8,0,53
Fall 2019,9/16/2019,Monday,5:30 PM,13,6,24,6,0,49
Fall 2019,9/16/2019,Monday,6:30 PM,10,4,10,3,0,27
Fall 2019,9/16/2019,Monday,7:30 PM,10,7,11,5,1,34
Fall 2019,9/16/2019,Monday,8:30 PM,5,5,2,5,0,17
Fall 2019,9/17/2019,Tuesday,7:30 AM,4,0,0,0,0,4
Fall 2019,9/17/2019,Tuesday,8:30 AM,8,6,4,0,0,18
Fall 2019,9/17/2019,Tuesday,9:30 AM,15,3,20,3,0,41
Fall 2019,9/17/2019,Tuesday,10:30 AM,25,10,18,4,0,57
Fall 2019,9/17/2019,Tuesday,11:30 AM,29,9,25,5,0,68
Fall 2019,9/17/2019,Tuesday,12:30 PM,37,13,25,11,3,89
Fall 2019,9/17/2019,Tuesday,1:30 PM,19,7,17,3,0,46
Fall 2019,9/17/2019,Tuesday,5:30 PM,21,5,8,2,0,36
Fall 2019,9/17/2019,Tuesday,7:30 PM,29,0,7,0,0,36
Fall 2019,9/17/2019,Tuesday,8:30 PM,11,1,6,0,0,18
Fall 2019,9/18/2019,Wednesday,7:30 AM,3,1,1,0,4,9
Fall 2019,9/18/2019,Wednesday,8:30 AM,11,2,8,2,3,26
Fall 2019,9/18/2019,Wednesday,12:30 PM,31,15,51,11,0,108
Fall 2019,9/18/2019,Wednesday,1:30 PM,16,8,17,6,0,47
Fall 2019,9/18/2019,Wednesday,3:30 PM,22,9,11,11,0,53
Fall 2019,9/18/2019,Wednesday,4:30 PM,18,6,12,7,0,43
Fall 2019,9/18/2019,Wednesday,6:30 PM,6,3,5,3,0,17
Fall 2019,9/18/2019,Wednesday,7:30 PM,8,5,5,1,0,19
Fall 2019,9/18/2019,Wednesday,8:30 PM,9,0,5,0,0,14
Fall 2019,9/19/2019,Thursday,7:30 AM,2,0,1,0,0,3
Fall 2019,9/19/2019,Thursday,8:30 AM,16,7,15,3,0,41
Fall 2019,9/19/2019,Thursday,9:30 AM,13,3,13,5,0,34
Fall 2019,9/19/2019,Thursday,10:30 AM,35,7,20,10,2,74
Fall 2019,9/19/2019,Thursday,11:30 AM,28,8,17,2,0,55
Fall 2019,9/19/2019,Thursday,2:30 PM,24,5,21,4,3,57
Fall 2019,9/19/2019,Thursday,3:30 PM,23,9,14,2,2,50
Fall 2019,9/19/2019,Thursday,4:30 PM,14,3,9,2,1,29
Fall 2019,9/19/2019,Thursday,6:30 PM,8,0,4,0,0,12
Fall 2019,9/19/2019,Thursday,7:30 PM,25,2,1,2,0,30
Fall 2019,9/19/2019,Thursday,8:30 PM,6,2,3,0,0,11
Fall 2019,9/20/2019,Friday,8:30 AM,9,1,2,1,1,14
Fall 2019,9/20/2019,Friday,9:30 AM,8,2,1,1,0,12
Fall 2019,9/20/2019,Friday,10:30 AM,9,2,3,0,0,14
Fall 2019,9/20/2019,Friday,11:30 AM,10,3,8,3,0,24
Fall 2019,9/20/2019,Friday,12:30 PM,14,3,9,0,1,27
Fall 2019,9/20/2019,Friday,1:30 PM,11,3,9,0,3,26
Fall 2019,9/20/2019,Friday,5:30 PM,5,1,2,1,0,9
Fall 2019,9/20/2019,Friday,8:30 PM,2,2,0,2,0,6
Fall 2019,9/21/2019,Saturday,9:30 AM,2,0,0,0,0,2
Fall 2019,9/21/2019,Saturday,10:30 AM,6,1,1,0,0,8
Fall 2019,9/21/2019,Saturday,11:30 AM,4,1,2,1,0,8
Fall 2019,9/21/2019,Saturday,12:30 PM,10,2,3,1,0,16
Fall 2019,9/21/2019,Saturday,1:30 PM,6,2,4,1,0,13
Fall 2019,9/21/2019,Saturday,2:30 PM,6,4,5,2,1,18
Fall 2019,9/21/2019,Saturday,3:30 PM,8,2,7,0,0,17
Fall 2019,9/21/2019,Saturday,4:30 PM,4,3,2,0,0,9
Fall 2019,9/23/2019,Monday,7:30 AM,2,0,1,0,0,3
Fall 2019,9/23/2019,Monday,8:30 AM,16,1,6,2,1,26
Fall 2019,9/23/2019,Monday,9:30 AM,41,3,23,5,3,75
Fall 2019,9/23/2019,Monday,10:30 AM,41,3,23,2,4,73
Fall 2019,9/23/2019,Monday,11:30 AM,29,4,23,3,2,61
Fall 2019,9/23/2019,Monday,12:30 PM,31,13,50,4,0,98
Fall 2019,9/23/2019,Monday,1:30 PM,37,10,25,5,2,79
Fall 2019,9/23/2019,Monday,2:30 PM,18,8,11,3,4,44
Fall 2019,9/23/2019,Monday,3:30 PM,18,8,8,1,1,36
Fall 2019,9/23/2019,Monday,4:30 PM,17,7,14,8,0,46
Fall 2019,9/23/2019,Monday,5:30 PM,20,9,15,8,1,53
Fall 2019,9/23/2019,Monday,6:30 PM,5,6,8,0,0,19
Fall 2019,9/23/2019,Monday,7:30 PM,11,3,6,0,0,20
Fall 2019,9/23/2019,Monday,8:30 PM,5,1,5,3,0,14
Fall 2019,9/24/2019,Tuesday,7:30 AM,3,0,0,0,0,3
Fall 2019,9/24/2019,Tuesday,8:30 AM,5,4,3,0,0,12
Fall 2019,9/24/2019,Tuesday,9:30 AM,10,2,14,0,0,26
Fall 2019,9/24/2019,Tuesday,10:30 AM,28,9,31,4,0,72
Fall 2019,9/24/2019,Tuesday,11:30 AM,28,5,17,2,0,52
Fall 2019,9/24/2019,Tuesday,12:30 PM,46,14,40,16,0,116
Fall 2019,9/24/2019,Tuesday,1:30 PM,23,10,17,4,2,56
Fall 2019,9/24/2019,Tuesday,2:30 PM,21,4,15,3,2,45
Fall 2019,9/24/2019,Tuesday,3:30 PM,27,5,21,4,3,60
Fall 2019,9/24/2019,Tuesday,5:30 PM,24,6,11,2,4,47
Fall 2019,9/24/2019,Tuesday,6:30 PM,7,4,11,2,0,24
Fall 2019,9/24/2019,Tuesday,7:30 PM,3,1,8,3,0,15
Fall 2019,9/24/2019,Tuesday,8:30 PM,7,1,2,3,0,13
Fall 2019,9/25/2019,Wednesday,7:30 AM,4,1,3,0,0,8
Fall 2019,9/25/2019,Wednesday,8:30 AM,15,4,17,1,3,40
Fall 2019,9/25/2019,Wednesday,9:30 AM,22,6,15,3,1,47
Fall 2019,9/25/2019,Wednesday,10:30 AM,28,7,24,3,2,64
Fall 2019,9/25/2019,Wednesday,11:30 AM,25,6,17,4,0,52
Fall 2019,9/25/2019,Wednesday,12:30 PM,42,15,52,8,0,117
Fall 2019,9/25/2019,Wednesday,1:30 PM,17,10,22,2,0,51
Fall 2019,9/25/2019,Wednesday,2:30 PM,23,10,14,4,0,51
Fall 2019,9/25/2019,Wednesday,3:30 PM,22,8,20,13,2,65
Fall 2019,9/25/2019,Wednesday,4:30 PM,20,5,15,3,0,43
Fall 2019,9/25/2019,Wednesday,6:30 PM,10,4,10,6,2,32
Fall 2019,9/25/2019,Wednesday,8:30 PM,16,2,16,4,4,42
Fall 2019,9/26/2019,Thursday,7:30 AM,2,0,4,0,0,6
Fall 2019,9/26/2019,Thursday,8:30 AM,13,3,16,0,0,32
Fall 2019,9/26/2019,Thursday,10:30 AM,27,4,20,4,0,55
Fall 2019,9/26/2019,Thursday,11:30 AM,28,7,18,5,0,58
Fall 2019,9/26/2019,Thursday,12:30 PM,37,11,38,22,0,108
Fall 2019,9/26/2019,Thursday,1:30 PM,25,8,22,4,3,62
Fall 2019,9/26/2019,Thursday,2:30 PM,27,4,19,4,2,56
Fall 2019,9/26/2019,Thursday,3:30 PM,28,3,16,2,2,51
Fall 2019,9/26/2019,Thursday,5:30 PM,15,5,11,4,0,35
Fall 2019,9/26/2019,Thursday,6:30 PM,17,1,6,6,0,30
Fall 2019,9/26/2019,Thursday,7:30 PM,9,1,7,7,0,24
Fall 2019,9/26/2019,Thursday,8:30 PM,6,1,4,0,0,11
Fall 2019,9/27/2019,Friday,7:30 AM,0,0,0,0,0,0
Fall 2019,9/27/2019,Friday,9:30 AM,5,2,1,3,0,11
Fall 2019,9/27/2019,Friday,10:30 AM,15,3,6,1,0,25
Fall 2019,9/27/2019,Friday,12:30 PM,14,3,9,1,4,31
Fall 2019,9/27/2019,Friday,1:30 PM,10,2,4,1,1,18
Fall 2019,9/27/2019,Friday,5:30 PM,10,3,4,2,4,23
Fall 2019,9/27/2019,Friday,6:30 PM,6,2,4,3,0,15
Fall 2019,9/27/2019,Friday,7:30 PM,6,3,5,2,0,16
Fall 2019,9/27/2019,Friday,8:30 PM,5,0,3,2,0,10
Fall 2019,9/28/2019,Saturday,9:30 AM,3,0,0,0,0,3
Fall 2019,9/28/2019,Saturday,10:30 AM,2,1,0,0,0,3
Fall 2019,9/28/2019,Saturday,11:30 AM,7,2,6,2,1,18
Fall 2019,9/28/2019,Saturday,12:30 PM,6,1,3,1,2,13
Fall 2019,9/28/2019,Saturday,1:30 PM,4,1,7,1,0,13
Fall 2019,9/28/2019,Saturday,1:30 PM,8,0,12,0,0,20
Fall 2019,9/28/2019,Saturday,2:30 PM,8,1,9,0,0,18
Fall 2019,9/28/2019,Saturday,3:30 PM,10,1,4,0,0,15
Fall 2019,9/28/2019,Saturday,4:30 PM,6,1,4,3,0,14
Fall 2019,9/30/2019,Monday,7:30 AM,3,0,0,0,0,3
Fall 2019,9/30/2019,Monday,8:30 AM,13,1,12,1,1,28
Fall 2019,9/30/2019,Monday,10:30 AM,30,5,26,2,1,64
Fall 2019,9/30/2019,Monday,11:30 AM,35,6,17,4,3,65
Fall 2019,9/30/2019,Monday,12:30 PM,44,13,40,4,0,101
Fall 2019,9/30/2019,Monday,1:30 PM,20,12,16,3,0,51
Fall 2019,10/1/2019,Tuesday,7:30 AM,2,1,0,0,0,3
Fall 2019,10/1/2019,Tuesday,8:30 AM,12,3,11,2,0,28
Fall 2019,10/1/2019,Tuesday,9:30 AM,10,3,11,2,0,26
Fall 2019,10/1/2019,Tuesday,10:30 AM,20,5,22,0,0,47
Fall 2019,10/1/2019,Tuesday,11:30 AM,24,8,15,2,0,49
Fall 2019,10/1/2019,Tuesday,1:30 PM,25,7,11,2,0,45
Fall 2019,10/1/2019,Tuesday,2:30 PM,17,9,14,1,3,44
Fall 2019,10/1/2019,Tuesday,3:30 PM,15,7,13,3,2,40
Fall 2019,10/1/2019,Tuesday,5:30 PM,19,6,9,6,0,40
Fall 2019,10/1/2019,Tuesday,6:30 PM,7,5,4,6,0,22
Fall 2019,10/1/2019,Tuesday,7:30 PM,6,3,6,4,0,19
Fall 2019,10/2/2019,Wednesday,7:30 AM,4,0,2,0,0,6
Fall 2019,10/2/2019,Wednesday,8:30 AM,27,1,11,1,1,41
Fall 2019,10/2/2019,Wednesday,9:30 AM,17,9,17,0,0,43
Fall 2019,10/2/2019,Wednesday,10:30 AM,27,9,20,3,2,61
Fall 2019,10/2/2019,Wednesday,11:30 AM,28,10,25,4,0,67
Fall 2019,10/2/2019,Wednesday,12:30 PM,32,13,37,7,0,89
Fall 2019,10/2/2019,Wednesday,1:30 PM,17,8,11,5,0,41
Fall 2019,10/2/2019,Wednesday,5:30 PM,24,7,13,5,0,49
Fall 2019,10/2/2019,Wednesday,6:30 PM,10,3,6,3,0,22
Fall 2019,10/2/2019,Wednesday,7:30 PM,10,3,10,2,0,25
Fall 2019,10/2/2019,Wednesday,8:30 PM,13,1,13,2,0,29
Fall 2019,10/3/2019,Thursday,7:30 AM,3,0,0,0,0,3
Fall 2019,10/3/2019,Thursday,8:30 AM,10,4,3,3,0,20
Fall 2019,10/3/2019,Thursday,9:30 AM,22,5,13,2,0,42
Fall 2019,10/3/2019,Thursday,10:30 AM,37,6,22,10,0,75
Fall 2019,10/3/2019,Thursday,11:30 AM,30,7,14,9,1,61
Fall 2019,10/3/2019,Thursday,12:30 PM,29,13,37,5,2,86
Fall 2019,10/3/2019,Thursday,2:30 PM,22,5,14,0,3,44
Fall 2019,10/3/2019,Thursday,3:30 PM,19,8,16,1,2,46
Fall 2019,10/3/2019,Thursday,5:30 PM,15,5,9,4,2,35
Fall 2019,10/3/2019,Thursday,6:30 PM,6,4,5,2,0,17
Fall 2019,10/3/2019,Thursday,7:30 PM,5,2,4,1,0,12
Fall 2019,10/3/2019,Thursday,8:30 PM,3,1,5,2,0,11
Fall 2019,10/4/2019,Friday,10:30 AM,11,1,4,5,3,24
Fall 2019,10/4/2019,Friday,11:30 AM,16,4,10,3,5,38
Fall 2019,10/4/2019,Friday,11:30 AM,9,2,3,1,1,16
Fall 2019,10/4/2019,Friday,12:30 PM,14,3,6,0,2,25
Fall 2019,10/4/2019,Friday,1:30 PM,8,3,7,2,2,22
Fall 2019,10/4/2019,Friday,5:30 PM,11,4,2,1,0,18
Fall 2019,10/4/2019,Friday,6:30 PM,8,2,4,1,0,15
Fall 2019,10/4/2019,Friday,7:30 PM,7,1,4,1,0,13
Fall 2019,10/4/2019,Friday,8:30 PM,4,1,3,0,0,8
Fall 2019,10/5/2019,Saturday,9:30 AM,1,0,0,0,0,1
Fall 2019,10/5/2019,Saturday,10:30 AM,4,2,3,1,0,10
Fall 2019,10/5/2019,Saturday,11:30 AM,6,1,3,1,0,11
Fall 2019,10/5/2019,Saturday,12:30 PM,5,0,7,0,0,12
Fall 2019,10/5/2019,Saturday,2:30 PM,8,4,5,0,0,17
Fall 2019,10/5/2019,Saturday,3:30 PM,10,2,7,0,0,19
Fall 2019,10/5/2019,Saturday,4:30 PM,4,3,4,0,0,11
Fall 2019,10/7/2019,Monday,7:30 AM,3,0,2,0,0,5
Fall 2019,10/7/2019,Monday,8:30 AM,17,3,12,1,2,35
Fall 2019,10/7/2019,Monday,9:30 AM,18,11,23,0,2,54
Fall 2019,10/7/2019,Monday,10:30 AM,19,12,27,1,1,60
Fall 2019,10/7/2019,Monday,12:30 PM,43,12,38,14,0,107
Fall 2019,10/7/2019,Monday,1:30 PM,19,9,20,4,0,52
Fall 2019,10/7/2019,Monday,2:30 PM,15,9,14,4,2,44
Fall 2019,10/7/2019,Monday,4:30 PM,20,7,15,9,1,52
Fall 2019,10/7/2019,Monday,5:30 PM,17,6,18,6,0,47
Fall 2019,10/7/2019,Monday,6:30 PM,11,6,9,2,0,28
Fall 2019,10/7/2019,Monday,7:30 PM,13,3,6,4,0,26
Fall 2019,10/7/2019,Monday,8:30 PM,10,1,6,3,0,20
Fall 2019,10/8/2019,Tuesday,7:30 AM,3,0,2,0,0,5
Fall 2019,10/8/2019,Tuesday,10:30 AM,25,7,26,4,0,62
Fall 2019,10/8/2019,Tuesday,11:30 AM,22,10,23,8,0,63
Fall 2019,10/8/2019,Tuesday,12:30 PM,29,9,35,14,2,89
Fall 2019,10/8/2019,Tuesday,1:30 PM,19,5,23,10,0,57
Fall 2019,10/8/2019,Tuesday,2:30 PM,12,5,15,1,2,35
Fall 2019,10/8/2019,Tuesday,3:30 PM,15,4,16,4,3,42
Fall 2019,10/8/2019,Tuesday,5:30 PM,23,10,16,7,1,57
Fall 2019,10/8/2019,Tuesday,6:30 PM,9,6,7,4,0,26
Fall 2019,10/8/2019,Tuesday,7:30 PM,9,3,4,3,0,19
Fall 2019,10/8/2019,Tuesday,8:30 PM,5,2,4,0,0,11
Fall 2019,10/9/2019,Wednesday,9:30 AM,28,5,15,7,5,60
Fall 2019,10/9/2019,Wednesday,10:30 AM,35,5,19,3,0,62
Fall 2019,10/9/2019,Wednesday,11:30 AM,25,9,18,2,0,54
Fall 2019,10/9/2019,Wednesday,1:30 PM,18,8,22,13,1,62
Fall 2019,10/9/2019,Wednesday,5:30 PM,15,9,25,6,1,56
Fall 2019,10/9/2019,Wednesday,6:30 PM,10,6,17,6,0,39
Fall 2019,10/9/2019,Wednesday,7:30 PM,4,6,17,3,0,30
Fall 2019,10/9/2019,Wednesday,8:30 PM,9,3,5,0,0,17
Fall 2019,10/10/2019,Thursday,7:30 AM,5,0,5,0,0,10
Fall 2019,10/10/2019,Thursday,8:30 AM,7,4,4,2,0,17
Fall 2019,10/10/2019,Thursday,10:30 AM,21,3,17,10,2,53
Fall 2019,10/10/2019,Thursday,11:30 AM,21,5,12,6,0,44
Fall 2019,10/10/2019,Thursday,12:30 PM,29,11,32,9,0,81
Fall 2019,10/10/2019,Thursday,1:30 PM,17,6,14,4,2,43
Fall 2019,10/10/2019,Thursday,2:30 PM,23,8,15,4,1,51
Fall 2019,10/10/2019,Thursday,3:30 PM,21,8,19,4,3,55
Fall 2019,10/10/2019,Thursday,4:30 PM,16,5,13,4,1,39
Fall 2019,10/10/2019,Thursday,5:30 PM,20,4,23,4,0,51
Fall 2019,10/10/2019,Thursday,6:30 PM,10,1,12,25,0,48
Fall 2019,10/10/2019,Thursday,7:30 PM,10,0,10,5,2,27
Fall 2019,10/10/2019,Thursday,8:30 PM,6,0,4,0,0,10
Fall 2019,10/11/2019,Friday,7:30 AM,1,0,0,0,0,1
Fall 2019,10/11/2019,Friday,8:30 AM,7,3,2,1,0,13
Fall 2019,10/11/2019,Friday,9:30 AM,5,2,7,3,0,17
Fall 2019,10/11/2019,Friday,10:30 AM,7,2,8,2,0,19
Fall 2019,10/11/2019,Friday,1:30 PM,15,0,6,0,1,22
Fall 2019,10/11/2019,Friday,5:30 PM,13,2,8,5,0,28
Fall 2019,10/11/2019,Friday,6:30 PM,7,4,4,3,0,18
Fall 2019,10/11/2019,Friday,7:30 PM,4,4,5,4,0,17
Fall 2019,10/11/2019,Friday,8:30 PM,4,1,2,0,0,7
Fall 2019,10/12/2019,Saturday,9:30 AM,3,0,1,0,0,4
Fall 2019,10/12/2019,Saturday,10:30 AM,4,1,3,1,0,9
Fall 2019,10/12/2019,Saturday,11:30 AM,3,2,1,0,0,6
Fall 2019,10/12/2019,Saturday,12:30 PM,5,1,1,0,0,7
Fall 2019,10/12/2019,Saturday,1:30 PM,11,0,1,1,0,13
Fall 2019,10/12/2019,Saturday,3:30 PM,5,1,3,0,0,9
Fall 2019,10/12/2019,Saturday,4:30 PM,2,0,4,0,0,6
Fall 2019,10/14/2019,Monday,7:30 AM,3,0,1,0,0,4
Fall 2019,10/14/2019,Monday,8:30 AM,15,6,4,1,0,26
Fall 2019,10/14/2019,Monday,10:30 AM,29,9,13,3,2,56
Fall 2019,10/14/2019,Monday,11:30 AM,25,13,23,5,0,66
Fall 2019,10/14/2019,Monday,12:30 PM,41,10,49,7,2,109
Fall 2019,10/14/2019,Monday,1:30 PM,28,7,15,5,2,57
Fall 2019,10/14/2019,Monday,2:30 PM,26,2,15,9,3,55
Fall 2019,10/14/2019,Monday,3:30 PM,19,3,15,5,4,46
Fall 2019,10/14/2019,Monday,4:30 PM,20,10,11,4,0,45
Fall 2019,10/14/2019,Monday,5:30 PM,18,10,16,3,2,49
Fall 2019,10/14/2019,Monday,6:30 PM,9,6,11,6,0,32
Fall 2019,10/14/2019,Monday,7:30 PM,5,6,7,4,0,22
Fall 2019,10/15/2019,Tuesday,7:30 AM,2,1,0,0,0,3
Fall 2019,10/15/2019,Tuesday,9:30 AM,20,8,11,1,2,42
Fall 2019,10/15/2019,Tuesday,10:30 AM,39,3,13,4,5,64
Fall 2019,10/15/2019,Tuesday,11:30 AM,26,6,10,7,1,50
Fall 2019,10/15/2019,Tuesday,12:30 PM,36,9,23,8,3,79
Fall 2019,10/15/2019,Tuesday,1:30 PM,25,9,8,4,1,47
Fall 2019,10/15/2019,Tuesday,2:30 PM,24,7,8,2,2,43
Fall 2019,10/15/2019,Tuesday,3:30 PM,29,7,11,0,1,48
Fall 2019,10/15/2019,Tuesday,6:30 PM,8,3,11,1,0,23
Fall 2019,10/15/2019,Tuesday,7:30 PM,8,3,10,1,0,22
Fall 2019,10/15/2019,Tuesday,8:30 PM,5,1,7,2,0,15
Fall 2019,10/16/2019,Wednesday,7:30 AM,4,0,2,0,0,6
Fall 2019,10/16/2019,Wednesday,8:30 AM,12,2,6,0,1,21
Fall 2019,10/16/2019,Wednesday,9:30 AM,35,4,14,1,3,57
Fall 2019,10/16/2019,Wednesday,11:30 AM,22,7,22,7,1,59
Fall 2019,10/16/2019,Wednesday,12:30 PM,40,19,34,13,9,115
Fall 2019,10/16/2019,Wednesday,1:30 PM,22,9,15,8,0,54
Fall 2019,10/16/2019,Wednesday,2:30 PM,17,7,18,5,1,48
Fall 2019,10/16/2019,Wednesday,3:30 PM,28,12,16,6,1,63
Fall 2019,10/16/2019,Wednesday,4:30 PM,19,9,13,5,2,48
Fall 2019,10/16/2019,Wednesday,6:30 PM,22,3,7,2,0,34
Fall 2019,10/16/2019,Wednesday,7:30 PM,13,4,4,3,0,24
Fall 2019,10/16/2019,Wednesday,8:30 PM,0,3,2,1,0,6
Fall 2019,10/17/2019,Thursday,7:30 AM,2,0,1,0,1,4
Fall 2019,10/17/2019,Thursday,8:30 AM,14,2,4,0,0,20
Fall 2019,10/17/2019,Thursday,10:30 AM,24,8,20,6,2,60
Fall 2019,10/17/2019,Thursday,11:30 AM,23,7,25,6,0,61
Fall 2019,10/17/2019,Thursday,12:30 PM,30,10,32,11,3,86
Fall 2019,10/17/2019,Thursday,1:30 PM,10,7,20,2,0,39
Fall 2019,10/17/2019,Thursday,2:30 PM,25,6,22,4,2,59
Fall 2019,10/17/2019,Thursday,3:30 PM,26,6,16,1,2,51
Fall 2019,10/17/2019,Thursday,5:30 PM,19,3,6,7,2,37
Fall 2019,10/17/2019,Thursday,6:30 PM,6,4,7,4,0,21
Fall 2019,10/17/2019,Thursday,7:30 PM,0,0,0,0,0,0
Fall 2019,10/17/2019,Thursday,7:30 PM,9,3,5,3,0,20
Fall 2019,10/17/2019,Thursday,8:30 PM,5,2,2,3,0,12
Fall 2019,10/18/2019,Friday,7:30 AM,1,0,0,0,1,2
Fall 2019,10/18/2019,Friday,8:30 AM,4,0,0,0,0,4
Fall 2019,10/18/2019,Friday,9:30 AM,7,1,1,1,0,10
Fall 2019,10/18/2019,Friday,9:30 AM,7,1,1,1,1,11
Fall 2019,10/18/2019,Friday,10:30 AM,6,0,1,0,0,7
Fall 2019,10/18/2019,Friday,5:30 PM,9,4,10,0,0,23
Fall 2019,10/18/2019,Friday,6:30 PM,5,3,5,0,1,14
Fall 2019,10/18/2019,Friday,7:30 PM,7,4,6,1,0,18
Fall 2019,10/18/2019,Friday,8:30 PM,3,3,0,1,0,7
Fall 2019,10/19/2019,Saturday,10:30 AM,3,3,3,0,1,10
Fall 2019,10/19/2019,Saturday,2:30 PM,6,4,6,1,1,18
Fall 2019,10/19/2019,Saturday,3:30 PM,7,4,4,0,0,15
Fall 2019,10/19/2019,Saturday,4:30 PM,4,4,2,0,0,10
Fall 2019,10/21/2019,Monday,7:30 AM,3,0,0,0,0,3
Fall 2019,10/21/2019,Monday,8:30 AM,11,3,4,0,0,18
Fall 2019,10/21/2019,Monday,9:30 AM,23,7,12,8,1,51
Fall 2019,10/21/2019,Monday,11:30 AM,28,7,16,2,1,54
Fall 2019,10/21/2019,Monday,12:30 PM,45,15,49,8,0,117
Fall 2019,10/21/2019,Monday,1:30 PM,20,11,11,11,1,54
Fall 2019,10/21/2019,Monday,2:30 PM,27,5,13,8,1,54
Fall 2019,10/21/2019,Monday,5:30 PM,15,8,17,6,4,50
Fall 2019,10/21/2019,Monday,6:30 PM,13,6,6,2,1,28
Fall 2019,10/21/2019,Monday,7:30 PM,14,4,10,2,0,30
Fall 2019,10/21/2019,Monday,8:30 PM,16,3,4,1,0,24
Fall 2019,10/22/2019,Tuesday,9:30 AM,11,6,6,3,2,28
Fall 2019,10/22/2019,Tuesday,1:30 PM,12,10,16,4,2,44
Fall 2019,10/22/2019,Tuesday,2:30 PM,21,5,15,4,3,48
Fall 2019,10/22/2019,Tuesday,3:30 PM,20,4,22,5,2,53
Fall 2019,10/22/2019,Tuesday,4:30 PM,18,6,22,4,2,52
Fall 2019,10/22/2019,Tuesday,5:30 PM,21,7,16,4,0,48
Fall 2019,10/22/2019,Tuesday,6:30 PM,9,6,8,1,0,24
Fall 2019,10/22/2019,Tuesday,8:30 PM,2,2,4,1,1,10
Fall 2019,10/23/2019,Wednesday,7:30 AM,3,0,0,0,0,3
Fall 2019,10/23/2019,Wednesday,8:30 AM,11,4,9,3,0,27
Fall 2019,10/23/2019,Wednesday,9:30 AM,24,7,19,1,0,51
Fall 2019,10/23/2019,Wednesday,10:30 AM,40,6,38,1,4,89
Fall 2019,10/23/2019,Wednesday,11:30 AM,25,7,36,5,2,75
Fall 2019,10/23/2019,Wednesday,12:30 PM,44,8,40,4,8,104
Fall 2019,10/23/2019,Wednesday,1:30 PM,18,4,8,3,0,33
Fall 2019,10/23/2019,Wednesday,2:30 PM,13,4,14,2,2,35
Fall 2019,10/23/2019,Wednesday,3:30 PM,14,5,12,1,2,34
Fall 2019,10/23/2019,Wednesday,4:30 PM,12,2,7,3,1,25
Fall 2019,10/23/2019,Wednesday,5:30 PM,14,5,11,6,0,36
Fall 2019,10/23/2019,Wednesday,6:30 PM,13,3,18,4,0,38
Fall 2019,10/24/2019,Thursday,7:30 AM,1,0,0,0,0,1
Fall 2019,10/24/2019,Thursday,10:30 AM,36,6,35,4,5,86
Fall 2019,10/24/2019,Thursday,11:30 AM,20,8,35,1,2,66
Fall 2019,10/24/2019,Thursday,12:30 PM,32,11,35,8,5,91
Fall 2019,10/24/2019,Thursday,1:30 PM,23,6,13,7,2,51
Fall 2019,10/24/2019,Thursday,2:30 PM,13,4,11,4,3,35
Fall 2019,10/24/2019,Thursday,3:30 PM,21,4,17,4,2,48
Fall 2019,10/24/2019,Thursday,4:30 PM,17,4,14,2,2,39
Fall 2019,10/24/2019,Thursday,5:30 PM,18,2,8,7,0,35
Fall 2019,10/24/2019,Thursday,6:30 PM,14,1,8,3,1,27
Fall 2019,10/24/2019,Thursday,7:30 PM,7,1,5,3,0,16
Fall 2019,10/24/2019,Thursday,8:30 PM,5,0,2,2,0,9
Fall 2019,10/25/2019,Friday,7:30 AM,1,0,0,0,0,1
Fall 2019,10/25/2019,Friday,8:30 AM,3,0,0,0,0,3
Fall 2019,10/25/2019,Friday,9:30 AM,5,0,0,0,0,5
Fall 2019,10/25/2019,Friday,10:30 AM,9,0,3,0,2,14
Fall 2019,10/25/2019,Friday,11:30 AM,23,4,3,8,3,41
Fall 2019,10/25/2019,Friday,12:30 PM,10,3,5,0,3,21
Fall 2019,10/25/2019,Friday,1:30 PM,9,3,11,1,3,27
Fall 2019,10/25/2019,Friday,5:30 PM,13,3,2,6,1,25
Fall 2019,10/25/2019,Friday,6:30 PM,7,3,1,4,0,15
Fall 2019,10/25/2019,Friday,7:30 PM,6,2,0,3,0,11
Fall 2019,10/26/2019,Saturday,9:30 AM,1,0,0,0,0,1
Fall 2019,10/26/2019,Saturday,10:30 AM,4,1,2,0,0,7
Fall 2019,10/26/2019,Saturday,11:30 AM,4,1,4,0,0,9
Fall 2019,10/26/2019,Saturday,12:30 PM,8,0,6,1,0,15
Fall 2019,10/26/2019,Saturday,1:30 PM,7,2,9,5,0,23
Fall 2019,10/26/2019,Saturday,2:30 PM,7,1,3,5,0,16
Fall 2019,10/28/2019,Monday,7:30 AM,3,0,0,0,0,3
Fall 2019,10/28/2019,Monday,8:30 AM,9,2,7,6,0,24
Fall 2019,10/28/2019,Monday,9:30 AM,21,5,6,5,0,37
Fall 2019,10/28/2019,Monday,10:30 AM,31,9,24,8,0,72
Fall 2019,10/28/2019,Monday,12:30 PM,42,16,46,1,2,107
Fall 2019,10/28/2019,Monday,1:30 PM,22,8,18,17,0,65
Fall 2019,10/28/2019,Monday,2:30 PM,26,10,7,2,0,45
Fall 2019,10/28/2019,Monday,3:30 PM,22,7,19,4,0,52
Fall 2019,10/28/2019,Monday,5:30 PM,22,8,18,3,1,52
Fall 2019,10/28/2019,Monday,6:30 PM,12,3,6,4,0,25
Fall 2019,10/28/2019,Monday,8:30 PM,12,2,6,3,0,23
Fall 2019,10/29/2019,Tuesday,7:30 AM,1,0,0,0,0,1
Fall 2019,10/29/2019,Tuesday,10:30 AM,31,9,19,3,1,63
Fall 2019,10/29/2019,Tuesday,11:30 AM,28,10,18,16,3,75
Fall 2019,10/29/2019,Tuesday,1:30 PM,18,5,15,15,3,56
Fall 2019,10/29/2019,Tuesday,2:30 PM,19,10,15,3,3,50
Fall 2019,10/29/2019,Tuesday,3:30 PM,24,6,22,4,3,59
Fall 2019,10/29/2019,Tuesday,4:30 PM,14,7,18,4,1,44
Fall 2019,10/29/2019,Tuesday,5:30 PM,14,7,17,5,1,44
Fall 2019,10/29/2019,Tuesday,6:30 PM,11,3,7,4,0,25
Fall 2019,10/29/2019,Tuesday,7:30 PM,6,2,7,6,0,21
Fall 2019,10/29/2019,Tuesday,8:30 PM,7,1,7,5,0,20
Fall 2019,10/30/2019,Wednesday,7:30 AM,3,0,2,0,0,5
Fall 2019,10/30/2019,Wednesday,8:30 AM,26,5,6,4,1,42
Fall 2019,10/30/2019,Wednesday,9:30 AM,21,6,11,2,2,42
Fall 2019,10/30/2019,Wednesday,10:30 AM,26,4,27,5,2,64
Fall 2019,10/30/2019,Wednesday,11:30 AM,20,8,18,3,4,53
Fall 2019,10/30/2019,Wednesday,1:30 PM,21,8,18,9,2,58
Fall 2019,10/30/2019,Wednesday,5:30 PM,19,6,15,4,0,44
Fall 2019,10/30/2019,Wednesday,6:30 PM,13,3,9,3,0,28
Fall 2019,10/30/2019,Wednesday,7:30 PM,7,2,8,1,2,20
Fall 2019,10/31/2019,Thursday,7:30 AM,7,0,0,0,0,7
Fall 2019,10/31/2019,Thursday,8:30 AM,11,2,3,0,0,16
Fall 2019,10/31/2019,Thursday,9:30 AM,9,4,7,2,0,22
Fall 2019,10/31/2019,Thursday,10:30 AM,33,8,21,4,0,66
Fall 2019,10/31/2019,Thursday,12:30 PM,30,9,24,9,3,75
Fall 2019,10/31/2019,Thursday,1:30 PM,20,5,15,3,0,43
Fall 2019,10/31/2019,Thursday,2:30 PM,26,5,18,4,2,55
Fall 2019,10/31/2019,Thursday,3:30 PM,29,5,10,4,3,51
Fall 2019,10/31/2019,Thursday,4:30 PM,16,5,8,1,1,31
Fall 2019,10/31/2019,Thursday,5:30 PM,16,4,10,3,2,35
Fall 2019,10/31/2019,Thursday,6:30 PM,7,1,4,3,0,15
Fall 2019,10/31/2019,Thursday,8:30 PM,1,0,1,0,0,2
Fall 2019,11/1/2019,Friday,7:30 AM,2,0,0,0,0,2
Fall 2019,11/1/2019,Friday,8:30 AM,2,0,2,0,0,4
Fall 2019,11/1/2019,Friday,9:30 AM,4,3,2,1,0,10
Fall 2019,11/1/2019,Friday,10:30 AM,10,2,1,0,0,13
Fall 2019,11/1/2019,Friday,11:30 AM,12,2,4,3,4,25
Fall 2019,11/1/2019,Friday,1:30 PM,10,2,3,0,1,16
Fall 2019,11/1/2019,Friday,5:30 PM,7,2,4,2,0,15
Fall 2019,11/1/2019,Friday,6:30 PM,7,3,4,1,1,16
Fall 2019,11/1/2019,Friday,7:30 PM,7,2,4,1,0,14
Fall 2019,11/1/2019,Friday,8:30 PM,5,1,2,0,0,8
Fall 2019,11/2/2019,Saturday,9:30 AM,2,1,0,0,2,5
Fall 2019,11/2/2019,Saturday,10:30 AM,5,3,5,0,0,13
Fall 2019,11/2/2019,Saturday,11:30 AM,5,3,5,0,1,14
Fall 2019,11/2/2019,Saturday,12:30 PM,10,4,3,0,1,18
Fall 2019,11/2/2019,Saturday,3:30 PM,5,0,6,0,0,11
Fall 2019,11/2/2019,Saturday,4:30 PM,6,2,4,0,0,12
Fall 2019,11/4/2019,Monday,7:30 AM,2,0,0,0,0,2
Fall 2019,11/4/2019,Monday,8:30 AM,12,3,5,2,1,23
Fall 2019,11/4/2019,Monday,9:30 AM,24,5,12,6,5,52
Fall 2019,11/4/2019,Monday,10:30 AM,22,8,16,1,1,48
Fall 2019,11/4/2019,Monday,11:30 AM,23,12,25,2,0,62
Fall 2019,11/4/2019,Monday,12:30 PM,33,12,45,10,3,103
Fall 2019,11/4/2019,Monday,1:30 PM,20,6,17,4,2,49
Fall 2019,11/4/2019,Monday,3:30 PM,26,7,12,6,0,51
Fall 2019,11/5/2019,Tuesday,7:30 AM,2,0,0,0,0,2
Fall 2019,11/5/2019,Tuesday,8:30 AM,13,1,5,0,0,19
Fall 2019,11/5/2019,Tuesday,9:30 AM,13,4,13,2,0,32
Fall 2019,11/5/2019,Tuesday,10:30 AM,30,11,28,1,0,70
Fall 2019,11/5/2019,Tuesday,11:30 AM,19,7,16,4,1,47
Fall 2019,11/5/2019,Tuesday,12:30 PM,31,9,37,9,3,89
Fall 2019,11/5/2019,Tuesday,1:30 PM,17,11,18,8,5,59
Fall 2019,11/5/2019,Tuesday,2:30 PM,24,5,19,5,3,56
Fall 2019,11/5/2019,Tuesday,5:30 PM,18,8,16,12,1,55
Fall 2019,11/5/2019,Tuesday,6:30 PM,13,6,7,2,0,28
Fall 2019,11/5/2019,Tuesday,7:30 PM,8,6,12,1,0,27
Fall 2019,11/5/2019,Tuesday,8:30 PM,9,3,6,3,0,21
Fall 2019,11/6/2019,Wednesday,7:30 AM,3,0,0,0,0,3
Fall 2019,11/6/2019,Wednesday,8:30 AM,12,3,3,3,0,21
Fall 2019,11/6/2019,Wednesday,9:30 AM,23,4,10,0,0,37
Fall 2019,11/6/2019,Wednesday,10:30 AM,26,7,22,4,0,59
Fall 2019,11/6/2019,Wednesday,11:30 AM,21,9,30,14,0,74
Fall 2019,11/6/2019,Wednesday,12:30 PM,37,12,51,7,0,107
Fall 2019,11/6/2019,Wednesday,1:30 PM,18,7,17,7,3,52
Fall 2019,11/6/2019,Wednesday,2:30 PM,9,8,10,4,2,33
Fall 2019,11/6/2019,Wednesday,3:30 PM,24,8,6,17,0,55
Fall 2019,11/6/2019,Wednesday,5:30 PM,15,8,7,2,0,32
Fall 2019,11/6/2019,Wednesday,6:30 PM,13,3,5,1,0,22
Fall 2019,11/6/2019,Wednesday,7:30 PM,16,5,9,2,0,32
Fall 2019,11/6/2019,Wednesday,8:30 PM,9,2,0,0,0,11
Fall 2019,11/7/2019,Thursday,7:30 AM,2,0,0,0,0,2
Fall 2019,11/7/2019,Thursday,8:30 AM,5,4,3,0,0,12
Fall 2019,11/7/2019,Thursday,9:30 AM,14,7,5,1,0,27
Fall 2019,11/7/2019,Thursday,10:30 AM,18,9,15,4,2,48
Fall 2019,11/7/2019,Thursday,11:30 AM,21,12,22,17,6,78
Fall 2019,11/7/2019,Thursday,12:30 PM,38,11,35,9,5,98
Fall 2019,11/7/2019,Thursday,1:30 PM,21,8,16,4,2,51
Fall 2019,11/7/2019,Thursday,2:30 PM,24,4,13,5,2,48
Fall 2019,11/7/2019,Thursday,3:30 PM,26,5,16,4,2,53
Fall 2019,11/7/2019,Thursday,5:30 PM,29,5,19,3,1,57
Fall 2019,11/7/2019,Thursday,6:30 PM,15,5,12,4,0,36
Fall 2019,11/7/2019,Thursday,7:30 PM,8,5,6,4,0,23
Fall 2019,11/7/2019,Thursday,8:30 PM,1,2,5,0,0,8
Fall 2019,11/8/2019,Friday,7:30 AM,2,0,0,0,0,2
Fall 2019,11/8/2019,Friday,8:30 AM,6,2,2,1,0,11
Fall 2019,11/8/2019,Friday,9:30 AM,7,2,2,6,0,17
Fall 2019,11/8/2019,Friday,10:30 AM,13,3,1,2,0,19
Fall 2019,11/8/2019,Friday,11:30 AM,7,4,9,1,1,22
Fall 2019,11/8/2019,Friday,12:30 PM,15,3,16,1,3,38
Fall 2019,11/8/2019,Friday,5:30 PM,14,2,4,7,0,27
Fall 2019,11/9/2019,Saturday,9:30 AM,3,0,0,0,0,3
Fall 2019,11/9/2019,Saturday,10:30 AM,4,2,3,1,1,11
Fall 2019,11/9/2019,Saturday,11:30 AM,5,2,7,1,0,15
Fall 2019,11/9/2019,Saturday,12:30 PM,4,4,8,1,0,17
Fall 2019,11/9/2019,Saturday,1:30 PM,7,5,6,6,0,24
Fall 2019,11/9/2019,Saturday,3:30 PM,7,3,6,4,0,20
Fall 2019,11/9/2019,Saturday,4:30 PM,6,1,5,1,0,13
Fall 2019,11/11/2019,Monday,7:30 AM,2,0,0,0,0,2
Fall 2019,11/11/2019,Monday,8:30 AM,12,5,6,2,2,27
Fall 2019,11/11/2019,Monday,9:30 AM,25,8,26,9,3,71
Fall 2019,11/11/2019,Monday,11:30 AM,31,9,30,19,1,90
Fall 2019,11/11/2019,Monday,12:30 PM,43,11,55,4,0,113
Fall 2019,11/11/2019,Monday,1:30 PM,12,8,22,15,0,57
Fall 2019,11/11/2019,Monday,1:30 PM,17,10,20,11,0,58
Fall 2019,11/11/2019,Monday,2:30 PM,15,5,10,4,3,37
Fall 2019,11/11/2019,Monday,3:30 PM,16,5,16,15,3,55
Fall 2019,11/11/2019,Monday,5:30 PM,21,4,18,5,1,49
Fall 2019,11/11/2019,Monday,6:30 PM,8,3,12,1,0,24
Fall 2019,11/11/2019,Monday,7:30 PM,5,2,5,6,0,18
Fall 2019,11/11/2019,Monday,8:30 PM,9,2,6,2,0,19
Fall 2019,11/12/2019,Tuesday,7:30 AM,3,0,1,1,3,8
Fall 2019,11/12/2019,Tuesday,8:30 AM,8,1,5,2,0,16
Fall 2019,11/12/2019,Tuesday,9:30 AM,18,7,10,3,3,41
Fall 2019,11/12/2019,Tuesday,10:30 AM,31,8,35,4,0,78
Fall 2019,11/12/2019,Tuesday,10:30 AM,35,13,30,11,5,94
Fall 2019,11/12/2019,Tuesday,1:30 PM,27,10,13,17,2,69
Fall 2019,11/12/2019,Tuesday,2:30 PM,22,7,11,5,1,46
Fall 2019,11/12/2019,Tuesday,3:30 PM,30,10,19,3,2,64
Fall 2019,11/12/2019,Tuesday,4:30 PM,27,8,19,4,2,60
Fall 2019,11/12/2019,Tuesday,5:30 PM,9,6,18,13,0,46
Fall 2019,11/12/2019,Tuesday,6:30 PM,10,3,9,11,3,36
Fall 2019,11/12/2019,Tuesday,7:30 PM,9,3,5,2,0,19
Fall 2019,11/12/2019,Tuesday,8:30 PM,6,2,8,1,0,17
Fall 2019,11/13/2019,Wednesday,7:30 AM,3,0,1,0,0,4
Fall 2019,11/13/2019,Wednesday,8:30 AM,17,2,3,1,0,23
Fall 2019,11/13/2019,Wednesday,9:30 AM,22,6,7,1,0,36
Fall 2019,11/13/2019,Wednesday,10:30 AM,33,10,13,4,0,60
Fall 2019,11/13/2019,Wednesday,11:30 AM,31,7,17,3,0,58
Fall 2019,11/13/2019,Wednesday,12:30 PM,56,11,42,9,0,118
Fall 2019,11/13/2019,Wednesday,1:30 PM,24,9,7,8,2,50
Fall 2019,11/13/2019,Wednesday,2:30 PM,26,10,15,14,6,71
Fall 2019,11/13/2019,Wednesday,3:30 PM,15,7,13,3,3,41
Fall 2019,11/13/2019,Wednesday,4:30 PM,17,6,11,6,0,40
Fall 2019,11/13/2019,Wednesday,6:30 PM,22,3,4,16,0,45
Fall 2019,11/13/2019,Wednesday,7:30 PM,11,3,5,9,2,30
Fall 2019,11/13/2019,Wednesday,8:30 PM,9,1,8,11,1,30
Fall 2019,11/14/2019,Thursday,7:30 AM,2,1,1,0,0,4
Fall 2019,11/14/2019,Thursday,9:30 AM,16,4,11,1,2,34
Fall 2019,11/14/2019,Thursday,10:30 AM,45,9,25,6,6,91
Fall 2019,11/14/2019,Thursday,11:30 AM,22,7,17,10,1,57
Fall 2019,11/14/2019,Thursday,1:30 PM,29,7,16,5,2,59
Fall 2019,11/14/2019,Thursday,5:30 PM,17,6,12,2,0,37
Fall 2019,11/14/2019,Thursday,6:30 PM,9,3,13,1,0,26
Fall 2019,11/14/2019,Thursday,7:30 PM,13,3,3,2,0,21
Fall 2019,11/14/2019,Thursday,8:30 PM,5,1,2,0,0,8
Fall 2019,11/15/2019,Friday,7:30 AM,2,0,0,0,0,2
Fall 2019,11/15/2019,Friday,8:30 AM,5,1,2,0,1,9
Fall 2019,11/15/2019,Friday,9:30 AM,6,2,1,1,0,10
Fall 2019,11/15/2019,Friday,10:30 AM,11,3,3,0,0,17
Fall 2019,11/15/2019,Friday,12:30 PM,6,2,6,0,4,18
Fall 2019,11/15/2019,Friday,1:30 PM,9,3,7,0,1,20
Fall 2019,11/15/2019,Friday,5:30 PM,8,4,1,0,0,13
Fall 2019,11/15/2019,Friday,6:30 PM,7,3,4,0,0,14
Fall 2019,11/15/2019,Friday,7:30 PM,7,3,4,0,0,14
Fall 2019,11/15/2019,Friday,8:30 PM,6,2,1,1,0,10
Fall 2019,11/16/2019,Saturday,9:30 AM,2,0,0,2,0,4
Fall 2019,11/16/2019,Saturday,10:30 AM,5,0,2,2,1,10
Fall 2019,11/16/2019,Saturday,12:30 PM,11,1,4,1,2,19
Fall 2019,11/16/2019,Saturday,1:30 PM,11,3,7,0,0,21
Fall 2019,11/16/2019,Saturday,2:30 PM,11,4,6,0,0,21
Fall 2019,11/16/2019,Saturday,4:30 PM,9,0,4,0,1,14
Fall 2019,11/18/2019,Monday,7:30 AM,2,0,1,0,0,3
Fall 2019,11/18/2019,Monday,8:30 AM,12,4,10,0,0,26
Fall 2019,11/18/2019,Monday,9:30 AM,15,6,16,2,0,39
Fall 2019,11/18/2019,Monday,11:30 AM,32,8,12,3,0,55
Fall 2019,11/18/2019,Monday,11:30 AM,32,8,12,3,0,55
Fall 2019,11/18/2019,Monday,12:30 PM,52,8,49,2,0,111
Fall 2019,11/18/2019,Monday,1:30 PM,23,6,15,4,2,50
Fall 2019,11/18/2019,Monday,2:30 PM,24,5,8,2,3,42
Fall 2019,11/18/2019,Monday,3:30 PM,21,8,10,0,1,40
Fall 2019,11/19/2019,Tuesday,7:30 AM,3,0,1,0,0,4
Fall 2019,11/19/2019,Tuesday,8:30 AM,13,2,6,0,0,21
Fall 2019,11/19/2019,Tuesday,9:30 AM,18,6,9,4,0,37
Fall 2019,11/19/2019,Tuesday,10:30 AM,33,9,25,5,2,74
Fall 2019,11/19/2019,Tuesday,11:30 AM,25,10,18,6,0,59
Fall 2019,11/19/2019,Tuesday,12:30 PM,37,10,38,12,5,102
Fall 2019,11/19/2019,Tuesday,1:30 PM,21,11,23,4,6,65
Fall 2019,11/19/2019,Tuesday,2:30 PM,23,5,11,1,2,42
Fall 2019,11/19/2019,Tuesday,3:30 PM,26,3,9,4,4,46
Fall 2019,11/20/2019,Wednesday,7:30 AM,3,0,0,0,0,3
Fall 2019,11/20/2019,Wednesday,8:30 AM,14,3,9,1,0,27
Fall 2019,11/20/2019,Wednesday,9:30 AM,25,3,17,0,0,45
Fall 2019,11/20/2019,Wednesday,10:30 AM,28,6,25,2,3,64
Fall 2019,11/20/2019,Wednesday,11:30 AM,27,9,16,6,0,58
Fall 2019,11/20/2019,Wednesday,12:30 PM,45,12,40,5,0,102
Fall 2019,11/20/2019,Wednesday,1:30 PM,24,8,20,5,0,57
Fall 2019,11/20/2019,Wednesday,2:30 PM,18,10,14,9,3,54
Fall 2019,11/20/2019,Wednesday,3:30 PM,27,8,15,7,0,57
Fall 2019,11/20/2019,Wednesday,4:30 PM,19,5,9,8,2,43
Fall 2019,11/20/2019,Wednesday,5:30 PM,18,5,16,2,2,43
Fall 2019,11/20/2019,Wednesday,7:30 PM,10,3,7,2,0,22
Fall 2019,11/21/2019,Thursday,7:30 AM,3,0,0,0,0,3
Fall 2019,11/21/2019,Thursday,8:30 AM,11,3,4,2,0,20
Fall 2019,11/21/2019,Thursday,9:30 AM,16,4,9,3,0,32
Fall 2019,11/21/2019,Thursday,10:30 AM,18,6,13,5,0,42
Fall 2019,11/21/2019,Thursday,1:30 PM,14,5,23,7,0,49
Fall 2019,11/21/2019,Thursday,2:30 PM,19,2,16,4,1,42
Fall 2019,11/21/2019,Thursday,3:30 PM,17,4,18,4,2,45
Fall 2019,11/21/2019,Thursday,5:30 PM,16,3,8,8,0,35
Fall 2019,11/21/2019,Thursday,6:30 PM,7,5,3,7,1,23
Fall 2019,11/21/2019,Thursday,7:30 PM,3,0,4,2,1,10
Fall 2019,11/22/2019,Friday,7:30 AM,1,0,0,0,0,1
Fall 2019,11/22/2019,Friday,9:30 AM,11,4,1,1,2,19
Fall 2019,11/22/2019,Friday,10:30 AM,15,4,2,2,0,23
Fall 2019,11/22/2019,Friday,11:30 AM,13,2,14,2,1,32
Fall 2019,11/22/2019,Friday,5:30 PM,6,3,4,5,2,20
Fall 2019,11/22/2019,Friday,6:30 PM,6,2,3,3,0,14
Fall 2019,11/23/2019,Saturday,9:30 AM,1,0,0,0,0,1
Fall 2019,11/23/2019,Saturday,10:30 AM,6,0,3,0,0,9
Fall 2019,11/23/2019,Saturday,11:30 AM,7,1,6,0,1,15
Fall 2019,11/23/2019,Saturday,12:30 PM,7,2,8,1,0,18
Fall 2019,11/23/2019,Saturday,2:30 PM,6,1,7,0,0,14
Fall 2019,11/23/2019,Saturday,3:30 PM,7,1,4,0,0,12
Fall 2019,11/23/2019,Saturday,4:30 PM,5,0,4,1,1,11
Fall 2019,11/25/2019,Monday,7:30 AM,2,0,0,0,0,2
Fall 2019,11/25/2019,Monday,8:30 AM,8,4,7,0,0,19
Fall 2019,11/25/2019,Monday,9:30 AM,16,6,10,5,0,37
Fall 2019,11/25/2019,Monday,10:30 AM,21,11,21,2,0,55
Fall 2019,11/25/2019,Monday,11:30 AM,27,7,26,2,0,62
Fall 2019,11/25/2019,Monday,12:30 PM,40,14,38,2,0,94
Fall 2019,11/25/2019,Monday,1:30 PM,24,8,11,5,3,51
Fall 2019,11/25/2019,Monday,3:30 PM,15,9,7,1,0,32
Fall 2019,11/25/2019,Monday,5:30 PM,15,6,6,6,2,35
Fall 2019,11/25/2019,Monday,6:30 PM,8,3,4,4,0,19
Fall 2019,11/25/2019,Monday,7:30 PM,5,3,11,2,0,21
Fall 2019,11/25/2019,Monday,8:30 PM,2,1,5,1,0,9
Fall 2019,11/26/2019,Tuesday,7:30 AM,1,1,0,0,0,2
Fall 2019,11/26/2019,Tuesday,8:30 AM,3,2,4,7,0,16
Fall 2019,11/26/2019,Tuesday,9:30 AM,20,7,8,0,1,36
Fall 2019,11/26/2019,Tuesday,10:30 AM,18,5,17,4,0,44
Fall 2019,11/26/2019,Tuesday,11:30 AM,26,8,13,4,3,54
Fall 2019,11/26/2019,Tuesday,12:30 PM,26,8,23,6,2,65
Fall 2019,11/26/2019,Tuesday,1:30 PM,24,5,7,3,3,42
Fall 2019,11/26/2019,Tuesday,6:30 PM,10,4,6,0,0,20
Fall 2019,12/2/2019,Monday,7:30 AM,2,0,0,0,0,2
Fall 2019,12/2/2019,Monday,8:30 AM,13,4,4,0,0,21
Fall 2019,12/2/2019,Monday,10:30 AM,33,6,29,4,0,72
Fall 2019,12/2/2019,Monday,11:30 AM,38,9,21,8,0,76
Fall 2019,12/2/2019,Monday,12:30 PM,53,13,46,7,0,119
Fall 2019,12/2/2019,Monday,1:30 PM,19,10,15,9,1,54
Fall 2019,12/2/2019,Monday,2:30 PM,19,5,16,14,0,54
Fall 2019,12/2/2019,Monday,3:30 PM,27,8,14,6,3,58
Fall 2019,12/2/2019,Monday,5:30 PM,13,5,21,13,3,55
Fall 2019,12/2/2019,Monday,6:30 PM,18,2,14,9,2,45
Fall 2019,12/2/2019,Monday,7:30 PM,6,5,12,6,0,29
Fall 2019,12/3/2019,Tuesday,7:30 AM,1,0,0,0,0,1
Fall 2019,12/3/2019,Tuesday,8:30 AM,14,2,11,1,2,30
Fall 2019,12/3/2019,Tuesday,9:30 AM,27,8,23,3,2,63
Fall 2019,12/3/2019,Tuesday,11:30 AM,23,9,17,1,0,50
Fall 2019,12/3/2019,Tuesday,1:30 PM,26,7,30,9,3,75
Fall 2019,12/3/2019,Tuesday,1:30 PM,17,9,19,2,0,47
Fall 2019,12/3/2019,Tuesday,3:30 PM,22,4,17,1,2,46
Fall 2019,12/3/2019,Tuesday,6:30 PM,14,9,25,3,0,51
Fall 2019,12/3/2019,Tuesday,8:30 PM,11,5,6,0,0,22
Fall 2019,12/4/2019,Wednesday,7:30 AM,3,1,0,0,0,4
Fall 2019,12/4/2019,Wednesday,8:30 AM,14,2,9,1,0,26
Fall 2019,12/4/2019,Wednesday,9:30 AM,27,6,15,6,3,57
Fall 2019,12/4/2019,Wednesday,10:30 AM,37,6,22,6,0,71
Fall 2019,12/4/2019,Wednesday,11:30 AM,34,9,26,7,1,77
Fall 2019,12/4/2019,Wednesday,12:30 PM,40,6,66,18,6,136
Fall 2019,12/4/2019,Wednesday,1:30 PM,21,5,23,6,0,55
Fall 2019,12/4/2019,Wednesday,2:30 PM,22,7,12,3,0,44
Fall 2019,12/4/2019,Wednesday,5:30 PM,20,6,18,4,0,48
Fall 2019,12/4/2019,Wednesday,6:30 PM,17,4,10,2,1,34
Fall 2019,12/4/2019,Wednesday,7:30 PM,11,5,5,2,1,24
Fall 2019,12/5/2019,Thursday,7:30 AM,0,0,0,0,0,0
Fall 2019,12/5/2019,Thursday,9:30 AM,14,4,5,4,0,27
Fall 2019,12/5/2019,Thursday,10:30 AM,23,11,25,7,0,66
Fall 2019,12/5/2019,Thursday,11:30 AM,26,10,28,4,1,69
Fall 2019,12/5/2019,Thursday,12:30 PM,34,12,32,7,0,85
Fall 2019,12/5/2019,Thursday,1:30 PM,18,8,20,4,1,51
Fall 2019,12/5/2019,Thursday,2:30 PM,21,5,15,3,1,45
Fall 2019,12/5/2019,Thursday,3:30 PM,19,6,15,6,1,47
Fall 2019,12/5/2019,Thursday,4:30 PM,20,4,19,2,0,45
Fall 2019,12/5/2019,Thursday,5:30 PM,22,8,13,2,2,47
Fall 2019,12/5/2019,Thursday,6:30 PM,9,5,11,3,0,28
Fall 2019,12/5/2019,Thursday,7:30 PM,11,4,5,3,0,23
Fall 2019,12/5/2019,Thursday,8:30 PM,9,2,7,0,0,18
Fall 2019,12/6/2019,Friday,7:30 AM,0,0,0,0,0,0
Fall 2019,12/6/2019,Friday,8:30 AM,6,2,2,0,0,10
Fall 2019,12/6/2019,Friday,9:30 AM,2,1,4,1,0,8
Fall 2019,12/6/2019,Friday,10:30 AM,10,1,8,1,0,20
Fall 2019,12/6/2019,Friday,11:30 AM,9,2,7,1,1,20
Fall 2019,12/6/2019,Friday,11:30 AM,4,1,3,0,1,9
Fall 2019,12/6/2019,Friday,12:30 PM,9,2,8,2,0,21
Fall 2019,12/6/2019,Friday,6:30 PM,8,2,16,1,1,28
Fall 2019,12/6/2019,Friday,7:30 PM,4,0,6,0,0,10
Fall 2019,12/6/2019,Friday,8:30 PM,5,1,2,1,0,9
Fall 2019,12/7/2019,Saturday,9:30 AM,1,0,0,0,0,1
Fall 2019,12/7/2019,Saturday,10:30 AM,4,0,0,0,0,4
Fall 2019,12/7/2019,Saturday,11:30 AM,3,1,0,0,0,4
Fall 2019,12/7/2019,Saturday,12:30 PM,7,2,4,1,0,14
Fall 2019,12/7/2019,Saturday,1:30 PM,4,2,3,0,0,9
Fall 2019,12/7/2019,Saturday,3:30 PM,5,2,2,5,0,14
Fall 2019,12/7/2019,Saturday,4:30 PM,6,1,0,4,0,11
Fall 2019,12/9/2019,Monday,7:30 AM,3,0,2,0,1,6
Fall 2019,12/9/2019,Monday,8:30 AM,10,1,4,0,0,15
Fall 2019,12/9/2019,Monday,10:30 AM,30,4,18,10,0,62
Fall 2019,12/9/2019,Monday,12:30 PM,26,8,20,6,0,60
Fall 2019,12/9/2019,Monday,1:30 PM,24,10,25,11,5,75
Fall 2019,12/9/2019,Monday,2:30 PM,18,8,13,7,0,46
Fall 2019,12/9/2019,Monday,3:30 PM,15,5,9,4,0,33
Fall 2019,12/9/2019,Monday,4:30 PM,22,5,20,8,1,56
Fall 2019,12/9/2019,Monday,5:30 PM,24,7,25,5,2,63
Fall 2019,12/9/2019,Monday,6:30 PM,11,4,17,6,2,40
Fall 2019,12/9/2019,Monday,7:30 PM,17,3,5,4,2,31
Fall 2019,12/9/2019,Monday,8:30 PM,14,3,5,4,0,26
Fall 2019,12/10/2019,Tuesday,7:30 AM,2,0,1,0,2,5
Fall 2019,12/10/2019,Tuesday,8:30 AM,7,2,6,0,0,15
Fall 2019,12/10/2019,Tuesday,9:30 AM,11,6,9,2,0,28
Fall 2019,12/10/2019,Tuesday,10:30 AM,15,7,22,3,0,47
Fall 2019,12/10/2019,Tuesday,11:30 AM,11,5,18,9,8,51
Fall 2019,12/10/2019,Tuesday,12:30 PM,16,4,20,8,2,50
Fall 2019,12/10/2019,Tuesday,1:30 PM,18,2,22,8,2,52
Fall 2019,12/10/2019,Tuesday,2:30 PM,22,5,18,5,2,52
Fall 2019,12/10/2019,Tuesday,3:30 PM,14,5,18,7,2,46
Fall 2019,12/10/2019,Tuesday,4:30 PM,17,5,18,6,3,49
Fall 2019,12/10/2019,Tuesday,6:30 PM,12,6,10,7,0,35
Fall 2019,12/10/2019,Tuesday,7:30 PM,12,3,9,3,0,27
Fall 2019,12/11/2019,Wednesday,7:30 AM,3,0,1,0,0,4
Fall 2019,12/11/2019,Wednesday,8:30 AM,15,6,7,2,1,31
Fall 2019,12/11/2019,Wednesday,9:30 AM,18,9,8,1,0,36
Fall 2019,12/11/2019,Wednesday,11:30 AM,18,7,28,0,1,54
Fall 2019,12/11/2019,Wednesday,1:30 PM,19,8,11,11,1,50
Fall 2019,12/11/2019,Wednesday,2:30 PM,15,3,11,6,1,36
Fall 2019,12/11/2019,Wednesday,6:30 PM,10,10,6,3,0,29
Fall 2019,12/11/2019,Wednesday,7:30 PM,7,4,5,3,1,20
Fall 2019,12/11/2019,Wednesday,8:30 PM,4,5,1,2,0,12
Fall 2019,12/12/2019,Thursday,7:30 AM,2,0,0,0,0,2
Fall 2019,12/12/2019,Thursday,8:30 AM,15,2,9,2,0,28
Fall 2019,12/12/2019,Thursday,9:30 AM,20,3,7,7,0,37
Fall 2019,12/12/2019,Thursday,10:30 AM,22,6,20,3,0,51
Fall 2019,12/12/2019,Thursday,11:30 AM,24,10,15,6,0,55
Fall 2019,12/12/2019,Thursday,12:30 PM,28,8,17,5,3,61
Fall 2019,12/12/2019,Thursday,1:30 PM,10,3,9,1,0,23
Fall 2019,12/12/2019,Thursday,2:30 PM,6,2,11,2,0,21
Fall 2019,12/12/2019,Thursday,3:30 PM,14,2,12,1,1,30
Fall 2019,12/12/2019,Thursday,5:30 PM,14,1,3,3,1,22
Fall 2019,12/12/2019,Thursday,6:30 PM,10,1,6,1,1,19
Fall 2019,12/12/2019,Thursday,7:30 PM,6,1,3,0,0,10
Fall 2019,12/12/2019,Thursday,8:30 PM,3,0,1,0,0,4
Fall 2019,12/13/2019,Friday,7:30 AM,1,0,0,0,0,1
Fall 2019,12/13/2019,Friday,8:30 AM,2,1,1,0,0,4
Fall 2019,12/13/2019,Friday,9:30 AM,6,1,2,0,1,10
Fall 2019,12/13/2019,Friday,11:30 AM,5,0,9,0,1,15
Fall 2019,12/13/2019,Friday,12:30 PM,4,0,7,0,3,14
Fall 2019,12/13/2019,Friday,12:30 PM,2,0,2,0,1,5
Fall 2019,12/13/2019,Friday,5:30 PM,3,0,1,0,0,4
Fall 2019,12/13/2019,Friday,6:30 PM,4,1,2,0,0,7
Fall 2019,12/13/2019,Friday,7:30 PM,3,1,1,0,0,5
Fall 2019,12/13/2019,Friday,8:30 PM,1,0,0,0,0,1
Fall 2019,12/14/2019,Saturday,10:30 AM,2,0,0,0,0,2
Fall 2019,12/14/2019,Saturday,11:30 AM,3,0,0,0,0,3
Fall 2019,12/14/2019,Saturday,12:30 PM,2,2,0,0,0,4
Fall 2019,12/14/2019,Saturday,1:30 PM,2,2,1,0,0,5
Fall 2019,12/14/2019,Saturday,2:30 PM,3,1,2,0,0,6
Fall 2019,12/14/2019,Saturday,3:30 PM,1,1,1,0,0,3
Fall 2019,12/14/2019,Saturday,4:30 PM,0,1,2,0,0,3
Fall 2019,12/14/2019,Saturday,5:30 PM,0,1,0,0,1,2
Winter Intersession 2019,12/16/2019,Monday,7:30 AM,1,0,0,0,0,1
Winter Intersession 2019,12/16/2019,Monday,8:30 AM,3,0,0,0,0,3
Winter Intersession 2019,12/16/2019,Monday,9:30 AM,10,0,2,0,0,12
Winter Intersession 2019,12/16/2019,Monday,10:30 AM,6,0,0,2,0,8
Winter Intersession 2019,12/16/2019,Monday,11:30 AM,6,0,0,0,0,6
Winter Intersession 2019,12/16/2019,Monday,12:30 PM,7,0,0,0,0,7
Winter Intersession 2019,12/16/2019,Monday,1:30 PM,4,0,1,0,0,5
Winter Intersession 2019,12/16/2019,Monday,4:30 PM,3,0,1,1,0,5
Winter Intersession 2019,12/17/2019,Tuesday,7:30 AM,1,0,0,0,0,1
Winter Intersession 2019,12/17/2019,Tuesday,8:30 AM,4,0,0,0,0,4
Winter Intersession 2019,12/17/2019,Tuesday,9:30 AM,2,0,1,0,0,3
Winter Intersession 2019,12/17/2019,Tuesday,10:30 AM,5,0,0,0,0,5
Winter Intersession 2019,12/17/2019,Tuesday,12:30 PM,6,0,0,0,0,6
Winter Intersession 2019,12/17/2019,Tuesday,1:30 PM,5,2,2,0,0,9
Winter Intersession 2019,12/17/2019,Tuesday,4:30 PM,3,1,1,1,0,6
Winter Intersession 2019,12/18/2019,Wednesday,7:30 AM,1,0,0,0,0,1
Winter Intersession 2019,12/18/2019,Wednesday,10:30 AM,2,0,0,0,0,2
Winter Intersession 2019,12/18/2019,Wednesday,12:30 PM,6,0,0,0,0,6
Winter Intersession 2019,12/18/2019,Wednesday,1:30 PM,4,0,0,2,0,6
Winter Intersession 2019,12/18/2019,Wednesday,3:30 PM,0,2,0,1,0,3
Winter Intersession 2019,12/18/2019,Wednesday,4:30 PM,1,2,1,1,1,6
Winter Intersession 2019,12/19/2019,Thursday,7:30 AM,0,0,0,0,0,0
Winter Intersession 2019,12/19/2019,Thursday,8:30 AM,1,0,0,0,0,1
Winter Intersession 2019,12/19/2019,Thursday,12:30 PM,5,0,0,0,0,5
Winter Intersession 2019,12/19/2019,Thursday,1:30 PM,2,0,2,0,0,4
Winter Intersession 2019,12/20/2019,Friday,8:30 AM,3,0,0,0,0,3
Winter Intersession 2019,12/20/2019,Friday,9:30 AM,3,0,0,0,0,3
Winter Intersession 2019,12/20/2019,Friday,10:30 AM,3,0,0,0,0,3
Winter Intersession 2019,12/20/2019,Friday,11:30 AM,1,0,0,0,0,1
Winter Intersession 2019,12/20/2019,Friday,12:30 PM,3,0,0,0,0,3
Winter Intersession 2019,12/20/2019,Friday,1:30 PM,5,0,0,0,0,5
Winter Intersession 2019,12/20/2019,Friday,2:30 PM,1,0,0,0,0,1
Winter Intersession 2019,12/20/2019,Friday,3:30 PM,0,1,0,0,0,1
Winter Intersession 2019,1/2/2020,Thursday,7:30 AM,0,0,0,0,0,0
Winter Intersession 2019,1/2/2020,Thursday,8:30 AM,1,0,0,0,0,1
Winter Intersession 2019,1/2/2020,Thursday,9:30 AM,3,0,0,0,0,3
Winter Intersession 2019,1/2/2020,Thursday,10:30 AM,2,0,2,0,0,4
Winter Intersession 2019,1/3/2020,Friday,7:30 AM,1,0,0,0,0,1
Winter Intersession 2019,1/3/2020,Friday,8:30 AM,2,0,0,0,0,2
Winter Intersession 2019,1/3/2020,Friday,9:30 AM,4,0,0,0,0,4
Winter Intersession 2019,1/3/2020,Friday,10:30 AM,5,0,1,0,0,6
Winter Intersession 2019,1/3/2020,Friday,11:30 AM,3,0,1,0,0,4
Winter Intersession 2019,1/3/2020,Friday,12:30 PM,4,0,1,0,0,5
Winter Intersession 2019,1/3/2020,Friday,1:30 PM,3,0,1,0,0,4
Winter Intersession 2019,1/6/2020,Monday,7:30 AM,1,0,0,0,0,1
Winter Intersession 2019,1/6/2020,Monday,8:30 AM,2,1,1,0,0,4
Winter Intersession 2019,1/6/2020,Monday,9:30 AM,3,1,3,0,0,7
Winter Intersession 2019,1/6/2020,Monday,10:30 AM,9,2,2,1,0,14
Winter Intersession 2019,1/6/2020,Monday,11:30 AM,7,0,2,0,0,9
Winter Intersession 2019,1/6/2020,Monday,12:30 PM,5,1,3,2,0,11
Winter Intersession 2019,1/6/2020,Monday,2:30 PM,8,0,4,0,0,12
Winter Intersession 2019,1/6/2020,Monday,2:30 PM,5,1,2,1,0,9
Winter Intersession 2019,1/6/2020,Monday,3:30 PM,9,1,1,1,0,12
Winter Intersession 2019,1/7/2020,Tuesday,7:30 AM,0,0,0,0,0,0
Winter Intersession 2019,1/7/2020,Tuesday,9:30 AM,5,1,0,0,0,6
Winter Intersession 2019,1/7/2020,Tuesday,10:30 AM,2,2,0,0,0,4
Winter Intersession 2019,1/7/2020,Tuesday,11:30 AM,3,2,1,0,0,6
Winter Intersession 2019,1/7/2020,Tuesday,12:30 PM,6,2,1,0,0,9
Winter Intersession 2019,1/7/2020,Tuesday,1:30 PM,12,2,2,0,0,16
Winter Intersession 2019,1/7/2020,Tuesday,2:30 PM,2,1,5,0,0,8
Winter Intersession 2019,1/7/2020,Tuesday,3:30 PM,5,1,1,1,0,8
Winter Intersession 2019,1/7/2020,Tuesday,5:30 PM,6,1,0,0,0,7
Winter Intersession 2019,1/8/2020,Wednesday,7:30 AM,2,0,0,0,0,2
Winter Intersession 2019,1/8/2020,Wednesday,8:30 AM,1,1,2,0,0,4
Winter Intersession 2019,1/8/2020,Wednesday,9:30 AM,3,1,0,0,0,4
Winter Intersession 2019,1/8/2020,Wednesday,10:30 AM,9,1,1,0,0,11
Winter Intersession 2019,1/8/2020,Wednesday,11:30 AM,8,3,0,0,1,12
Winter Intersession 2019,1/8/2020,Wednesday,12:30 PM,12,1,1,0,0,14
Winter Intersession 2019,1/8/2020,Wednesday,2:30 PM,11,2,4,2,0,19
Winter Intersession 2019,1/8/2020,Wednesday,3:30 PM,6,2,2,4,0,14
Winter Intersession 2019,1/8/2020,Wednesday,4:30 PM,8,1,1,3,0,13
Winter Intersession 2019,1/8/2020,Wednesday,5:30 PM,3,1,1,0,0,5
Winter Intersession 2019,1/9/2020,Thursday,7:30 AM,0,0,0,0,0,0
Winter Intersession 2019,1/9/2020,Thursday,8:30 AM,2,0,1,0,2,5
Winter Intersession 2019,1/9/2020,Thursday,9:30 AM,4,1,2,0,0,7
Winter Intersession 2019,1/9/2020,Thursday,10:30 AM,6,2,2,0,1,11
Winter Intersession 2019,1/9/2020,Thursday,12:30 PM,3,0,2,0,0,5
Winter Intersession 2019,1/9/2020,Thursday,1:30 PM,2,1,2,0,0,5
Winter Intersession 2019,1/9/2020,Thursday,2:30 PM,6,0,3,0,0,9
Winter Intersession 2019,1/9/2020,Thursday,3:30 PM,10,0,1,0,0,11
Winter Intersession 2019,1/9/2020,Thursday,4:30 PM,4,1,1,1,0,7
Winter Intersession 2019,1/9/2020,Thursday,5:30 PM,5,0,0,0,0,5
Winter Intersession 2019,1/10/2020,Friday,7:30 AM,1,0,0,0,0,1
Winter Intersession 2019,1/10/2020,Friday,8:30 AM,7,0,0,0,0,7
Winter Intersession 2019,1/10/2020,Friday,9:30 AM,5,0,0,0,2,7
Winter Intersession 2019,1/10/2020,Friday,10:30 AM,8,1,2,0,0,11
Winter Intersession 2019,1/10/2020,Friday,11:30 AM,5,0,1,2,1,9
Winter Intersession 2019,1/10/2020,Friday,12:30 PM,13,0,1,0,0,14
Winter Intersession 2019,1/10/2020,Friday,1:30 PM,11,0,3,0,0,14
Winter Intersession 2019,1/10/2020,Friday,1:30 PM,11,0,3,0,0,14
Winter Intersession 2019,1/10/2020,Friday,2:30 PM,7,0,2,2,1,12
Winter Intersession 2019,1/10/2020,Friday,3:30 PM,2,0,1,2,0,5
Winter Intersession 2019,1/10/2020,Friday,4:30 PM,4,1,0,0,0,5
Spring 2020,1/13/2020,Monday,8:30 AM,9,1,2,2,3,17
Spring 2020,1/13/2020,Monday,9:30 AM,12,5,8,1,3,29
Spring 2020,1/13/2020,Monday,10:30 AM,15,8,14,0,5,42
Spring 2020,1/13/2020,Monday,11:30 AM,17,2,17,0,0,36
Spring 2020,1/13/2020,Monday,1:30 PM,22,3,22,3,0,50
Spring 2020,1/13/2020,Monday,1:30 PM,23,3,18,4,2,50
Spring 2020,1/13/2020,Monday,2:30 PM,16,4,15,2,4,41
Spring 2020,1/13/2020,Monday,3:30 PM,12,3,8,3,5,31
Spring 2020,1/13/2020,Monday,4:30 PM,15,5,9,4,3,36
Spring 2020,1/13/2020,Monday,5:30 PM,6,4,11,1,0,22
Spring 2020,1/13/2020,Monday,5:30 PM,9,0,0,0,0,9
Spring 2020,1/13/2020,Monday,6:30 PM,7,1,3,1,0,12
Spring 2020,1/13/2020,Monday,7:30 PM,7,0,0,1,0,8
Spring 2020,1/14/2020,Tuesday,7:30 AM,0,0,0,0,3,3
Spring 2020,1/14/2020,Tuesday,8:30 AM,6,3,3,1,1,14
Spring 2020,1/14/2020,Tuesday,9:30 AM,10,3,9,4,0,26
Spring 2020,1/14/2020,Tuesday,10:30 AM,19,2,10,7,3,41
Spring 2020,1/14/2020,Tuesday,11:30 AM,19,4,15,3,4,45
Spring 2020,1/14/2020,Tuesday,12:30 PM,42,4,36,6,0,88
Spring 2020,1/14/2020,Tuesday,1:30 PM,28,4,15,2,0,49
Spring 2020,1/14/2020,Tuesday,5:30 PM,11,2,10,1,0,24
Spring 2020,1/14/2020,Tuesday,6:30 PM,11,2,1,1,0,15
Spring 2020,1/14/2020,Tuesday,7:30 PM,7,3,3,0,0,13
Spring 2020,1/14/2020,Tuesday,8:30 PM,7,2,1,0,0,10
Spring 2020,1/15/2020,Wednesday,7:30 AM,1,1,0,0,0,2
Spring 2020,1/15/2020,Wednesday,8:30 AM,11,1,2,0,0,14
Spring 2020,1/15/2020,Wednesday,10:30 AM,21,5,19,1,0,46
Spring 2020,1/15/2020,Wednesday,12:30 PM,12,38,42,5,4,101
Spring 2020,1/15/2020,Wednesday,1:30 PM,12,3,16,4,1,36
Spring 2020,1/15/2020,Wednesday,6:30 PM,8,3,5,0,0,16
Spring 2020,1/16/2020,Thursday,7:30 AM,0,0,0,0,0,0
Spring 2020,1/16/2020,Thursday,8:30 AM,7,0,4,0,1,12
Spring 2020,1/16/2020,Thursday,9:30 AM,7,2,11,1,0,21
Spring 2020,1/16/2020,Thursday,10:30 AM,14,1,11,0,0,26
Spring 2020,1/16/2020,Thursday,11:30 AM,17,5,27,1,0,50
Spring 2020,1/16/2020,Thursday,12:30 PM,28,11,47,4,1,91
Spring 2020,1/16/2020,Thursday,1:30 PM,17,7,24,0,0,48
Spring 2020,1/16/2020,Thursday,2:30 PM,20,9,15,2,0,46
Spring 2020,1/16/2020,Thursday,3:30 PM,15,7,9,3,0,34
Spring 2020,1/16/2020,Thursday,4:30 PM,23,3,16,1,3,46
Spring 2020,1/16/2020,Thursday,5:30 PM,12,3,13,2,3,33
Spring 2020,1/16/2020,Thursday,7:30 PM,14,1,5,2,0,22
Spring 2020,1/16/2020,Thursday,8:30 PM,10,1,1,1,0,13
Spring 2020,1/17/2020,Friday,7:30 AM,1,0,0,0,1,2
Spring 2020,1/17/2020,Friday,8:30 AM,4,1,3,0,1,9
Spring 2020,1/17/2020,Friday,10:30 AM,7,2,12,1,0,22
Spring 2020,1/17/2020,Friday,1:30 PM,11,4,6,2,3,26
Spring 2020,1/17/2020,Friday,2:30 PM,11,1,9,0,0,21
Spring 2020,1/17/2020,Friday,3:30 PM,5,3,9,1,0,18
Spring 2020,1/17/2020,Friday,4:30 PM,8,1,7,2,0,18
Spring 2020,1/17/2020,Friday,7:30 PM,2,3,3,2,0,10
Spring 2020,1/17/2020,Friday,8:30 PM,0,1,1,1,0,3
Spring 2020,1/18/2020,Saturday,2:30 PM,9,2,5,0,0,16
Spring 2020,1/18/2020,Saturday,3:30 PM,10,4,6,0,0,20
Spring 2020,1/18/2020,Saturday,4:30 PM,13,4,5,0,0,22
Spring 2020,1/21/2020,Tuesday,7:30 AM,2,0,2,0,0,4
Spring 2020,1/21/2020,Tuesday,8:30 AM,7,0,3,0,0,10
Spring 2020,1/21/2020,Tuesday,9:30 AM,13,4,14,3,5,39
Spring 2020,1/21/2020,Tuesday,10:30 AM,23,6,15,6,0,50
Spring 2020,1/21/2020,Tuesday,1:30 PM,27,13,26,5,0,71
Spring 2020,1/21/2020,Tuesday,5:30 PM,24,4,11,5,3,47
Spring 2020,1/21/2020,Tuesday,6:30 PM,11,2,8,3,0,24
Spring 2020,1/21/2020,Tuesday,7:30 PM,10,3,11,0,0,24
Spring 2020,1/21/2020,Tuesday,8:30 PM,11,0,7,2,0,20
Spring 2020,1/22/2020,Wednesday,7:30 AM,1,0,1,0,0,2
Spring 2020,1/22/2020,Wednesday,8:30 AM,8,2,4,0,2,16
Spring 2020,1/22/2020,Wednesday,9:30 AM,16,4,13,5,2,40
Spring 2020,1/22/2020,Wednesday,10:30 AM,19,8,20,5,0,52
Spring 2020,1/22/2020,Wednesday,11:30 AM,19,4,29,0,0,52
Spring 2020,1/22/2020,Wednesday,12:30 PM,50,13,48,7,0,118
Spring 2020,1/22/2020,Wednesday,1:30 PM,16,5,19,6,3,49
Spring 2020,1/22/2020,Wednesday,2:30 PM,20,7,15,9,3,54
Spring 2020,1/22/2020,Wednesday,3:30 PM,15,4,16,7,2,44
Spring 2020,1/22/2020,Wednesday,5:30 PM,18,2,14,2,0,36
Spring 2020,1/22/2020,Wednesday,6:30 PM,7,4,9,0,0,20
Spring 2020,1/22/2020,Wednesday,7:30 PM,7,4,7,2,0,20
Spring 2020,1/22/2020,Wednesday,8:30 PM,2,4,1,2,0,9
Spring 2020,1/23/2020,Thursday,7:30 AM,4,0,0,0,0,4
Spring 2020,1/23/2020,Thursday,8:30 AM,5,3,1,5,0,14
Spring 2020,1/23/2020,Thursday,9:30 AM,10,3,13,7,2,35
Spring 2020,1/23/2020,Thursday,11:30 AM,26,5,18,4,0,53
Spring 2020,1/23/2020,Thursday,12:30 PM,43,6,27,5,0,81
Spring 2020,1/23/2020,Thursday,1:30 PM,17,7,8,3,0,35
Spring 2020,1/23/2020,Thursday,3:30 PM,10,7,19,10,0,46
Spring 2020,1/23/2020,Thursday,4:30 PM,10,3,18,7,0,38
Spring 2020,1/23/2020,Thursday,6:30 PM,10,3,16,4,1,34
Spring 2020,1/23/2020,Thursday,7:30 PM,15,2,5,1,0,23
Spring 2020,1/23/2020,Thursday,8:30 PM,14,3,3,2,0,22
Spring 2020,1/24/2020,Friday,7:30 AM,1,0,0,0,0,1
Spring 2020,1/24/2020,Friday,8:30 AM,3,0,2,0,0,5
Spring 2020,1/24/2020,Friday,9:30 AM,5,0,7,0,0,12
Spring 2020,1/24/2020,Friday,10:30 AM,7,2,6,1,0,16
Spring 2020,1/24/2020,Friday,11:30 AM,12,1,6,3,6,28
Spring 2020,1/24/2020,Friday,12:30 PM,11,4,4,4,1,24
Spring 2020,1/24/2020,Friday,5:30 PM,14,1,5,5,0,25
Spring 2020,1/24/2020,Friday,6:30 PM,11,1,8,5,0,25
Spring 2020,1/24/2020,Friday,7:30 PM,7,1,8,2,0,18
Spring 2020,1/25/2020,Saturday,9:30 AM,0,0,0,2,0,2
Spring 2020,1/25/2020,Saturday,10:30 AM,0,2,2,0,0,4
Spring 2020,1/25/2020,Saturday,11:30 AM,7,3,2,0,1,13
Spring 2020,1/25/2020,Saturday,12:30 PM,7,4,4,0,3,18
Spring 2020,1/25/2020,Saturday,2:30 PM,7,7,9,2,1,26
Spring 2020,1/27/2020,Monday,10:30 AM,18,7,22,4,2,53
Spring 2020,1/27/2020,Monday,11:30 AM,20,8,17,1,0,46
Spring 2020,1/27/2020,Monday,12:30 PM,42,13,36,5,0,96
Spring 2020,1/27/2020,Monday,1:30 PM,23,9,20,9,0,61
Spring 2020,1/27/2020,Monday,2:30 PM,18,5,11,5,3,42
Spring 2020,1/27/2020,Monday,4:30 PM,13,7,15,2,0,37
Spring 2020,1/27/2020,Monday,5:30 PM,13,5,13,7,0,38
Spring 2020,1/27/2020,Monday,6:30 PM,10,4,7,2,0,23
Spring 2020,1/27/2020,Monday,7:30 PM,10,4,4,1,0,19
Spring 2020,1/27/2020,Monday,8:30 PM,5,3,5,0,0,13
Spring 2020,1/28/2020,Tuesday,7:30 AM,2,0,0,0,0,2
Spring 2020,1/28/2020,Tuesday,8:30 AM,8,1,2,1,0,12
Spring 2020,1/28/2020,Tuesday,9:30 AM,12,5,15,2,0,34
Spring 2020,1/28/2020,Tuesday,10:30 AM,19,9,15,4,0,47
Spring 2020,1/28/2020,Tuesday,11:30 AM,21,10,16,4,0,51
Spring 2020,1/28/2020,Tuesday,12:30 PM,37,14,39,5,0,95
Spring 2020,1/28/2020,Tuesday,1:30 PM,21,6,18,6,0,51
Spring 2020,1/29/2020,Wednesday,7:30 AM,2,0,2,0,0,4
Spring 2020,1/29/2020,Wednesday,8:30 AM,8,1,5,2,0,16
Spring 2020,1/29/2020,Wednesday,10:30 AM,28,5,15,4,0,52
Spring 2020,1/29/2020,Wednesday,11:30 AM,20,7,22,1,0,50
Spring 2020,1/29/2020,Wednesday,1:30 PM,18,10,27,2,0,57
Spring 2020,1/29/2020,Wednesday,2:30 PM,0,0,0,0,0,0
Spring 2020,1/29/2020,Wednesday,2:30 PM,23,10,20,5,0,58
Spring 2020,1/29/2020,Wednesday,3:30 PM,17,6,18,4,0,45
Spring 2020,1/29/2020,Wednesday,4:30 PM,10,5,15,6,3,39
Spring 2020,1/29/2020,Wednesday,5:30 PM,8,5,15,3,0,31
Spring 2020,1/29/2020,Wednesday,6:30 PM,4,4,12,3,0,23
Spring 2020,1/29/2020,Wednesday,7:30 PM,7,2,12,2,0,23
Spring 2020,1/29/2020,Wednesday,8:30 PM,9,1,7,0,0,17
Spring 2020,1/30/2020,Thursday,7:30 AM,5,0,1,0,0,6
Spring 2020,1/30/2020,Thursday,8:30 AM,4,3,5,2,0,14
Spring 2020,1/30/2020,Thursday,9:30 AM,14,3,17,2,1,37
Spring 2020,1/30/2020,Thursday,10:30 AM,24,6,33,1,9,73
Spring 2020,1/30/2020,Thursday,11:30 AM,23,4,13,4,1,45
Spring 2020,1/30/2020,Thursday,12:30 PM,34,11,32,9,5,91
Spring 2020,1/30/2020,Thursday,1:30 PM,21,6,20,3,1,51
Spring 2020,1/31/2020,Friday,11:30 AM,10,4,8,1,2,25
Spring 2020,1/31/2020,Friday,6:30 PM,5,2,7,4,1,19
Spring 2020,1/31/2020,Friday,7:30 PM,2,4,7,5,0,18
Spring 2020,2/1/2020,Saturday,9:30 AM,3,2,0,0,1,6
Spring 2020,2/1/2020,Saturday,10:30 AM,3,1,1,0,5,10
Spring 2020,2/1/2020,Saturday,11:30 AM,4,2,6,0,0,12
Spring 2020,2/1/2020,Saturday,12:30 PM,7,2,7,0,2,18
Spring 2020,2/1/2020,Saturday,2:30 PM,6,4,9,2,0,21
Spring 2020,2/1/2020,Saturday,3:30 PM,8,4,13,2,0,27
Spring 2020,2/1/2020,Saturday,4:30 PM,8,2,8,4,0,22
Spring 2020,2/1/2020,Saturday,5:30 PM,0,0,0,0,0,0
Spring 2020,2/3/2020,Monday,10:30 AM,33,5,19,5,2,64
Spring 2020,2/3/2020,Monday,11:30 AM,25,6,19,4,0,54
Spring 2020,2/3/2020,Monday,12:30 PM,50,13,46,5,4,118
Spring 2020,2/3/2020,Monday,1:30 PM,23,6,14,11,3,57
Spring 2020,2/3/2020,Monday,2:30 PM,27,5,11,11,2,56
Spring 2020,2/3/2020,Monday,5:30 PM,22,8,14,7,1,52
Spring 2020,2/3/2020,Monday,6:30 PM,12,7,7,7,0,33
Spring 2020,2/3/2020,Monday,7:30 PM,13,5,18,4,0,40
Spring 2020,2/4/2020,Tuesday,7:30 AM,2,0,0,0,0,2
Spring 2020,2/4/2020,Tuesday,8:30 AM,17,3,7,4,0,31
Spring 2020,2/4/2020,Tuesday,9:30 AM,16,4,11,8,4,43
Spring 2020,2/4/2020,Tuesday,10:30 AM,17,5,15,3,2,42
Spring 2020,2/4/2020,Tuesday,11:30 AM,28,9,15,7,3,62
Spring 2020,2/4/2020,Tuesday,12:30 PM,43,11,32,5,8,99
Spring 2020,2/4/2020,Tuesday,1:30 PM,22,8,22,8,0,60
Spring 2020,2/4/2020,Tuesday,3:30 PM,18,8,21,10,0,57
Spring 2020,2/4/2020,Tuesday,4:30 PM,14,5,16,4,0,39
Spring 2020,2/6/2020,Thursday,7:30 AM,0,0,0,0,0,0
Spring 2020,2/6/2020,Thursday,8:30 AM,10,4,3,2,0,19
Spring 2020,2/6/2020,Thursday,9:30 AM,11,3,14,1,0,29
Spring 2020,2/6/2020,Thursday,10:30 AM,22,8,17,8,0,55
Spring 2020,2/6/2020,Thursday,1:30 PM,16,6,16,4,0,42
Spring 2020,2/7/2020,Friday,7:30 AM,0,0,0,0,0,0
Spring 2020,2/7/2020,Friday,8:30 AM,3,1,2,0,0,6
Spring 2020,2/7/2020,Friday,9:30 AM,4,2,6,2,0,14
Spring 2020,2/7/2020,Friday,10:30 AM,7,6,7,4,2,26
Spring 2020,2/7/2020,Friday,12:30 PM,10,3,8,6,3,30
Spring 2020,2/7/2020,Friday,1:30 PM,11,3,13,4,1,32
Spring 2020,2/7/2020,Friday,2:30 PM,7,4,11,0,2,24
Spring 2020,2/7/2020,Friday,3:30 PM,11,3,8,0,1,23
Spring 2020,2/7/2020,Friday,4:30 PM,11,5,6,2,1,25
Spring 2020,2/7/2020,Friday,5:30 PM,14,3,2,4,0,23
Spring 2020,2/7/2020,Friday,6:30 PM,15,2,2,5,0,24
Spring 2020,2/7/2020,Friday,7:30 PM,12,2,3,5,0,22
Spring 2020,2/7/2020,Friday,8:30 PM,8,3,2,3,0,16
Spring 2020,2/8/2020,Saturday,9:30 AM,0,0,0,0,1,1
Spring 2020,2/8/2020,Saturday,10:30 AM,1,1,3,1,0,6
Spring 2020,2/8/2020,Saturday,11:30 AM,5,1,4,1,0,11
Spring 2020,2/8/2020,Saturday,12:30 PM,5,2,6,2,0,15
Spring 2020,2/10/2020,Monday,10:30 AM,29,6,25,2,0,62
Spring 2020,2/10/2020,Monday,12:30 PM,34,12,37,10,4,97
Spring 2020,2/10/2020,Monday,1:30 PM,19,6,15,13,0,53
Spring 2020,2/10/2020,Monday,2:30 PM,25,9,20,9,5,68
Spring 2020,2/10/2020,Monday,3:30 PM,17,7,29,9,1,63
Spring 2020,2/10/2020,Monday,4:30 PM,19,9,17,9,0,54
Spring 2020,2/10/2020,Monday,7:30 PM,10,2,4,4,0,20
Spring 2020,2/10/2020,Monday,8:30 PM,3,2,5,4,0,14
Spring 2020,2/11/2020,Tuesday,7:30 AM,2,1,2,0,1,6
Spring 2020,2/11/2020,Tuesday,8:30 AM,8,2,2,2,0,14
Spring 2020,2/11/2020,Tuesday,9:30 AM,13,6,14,5,0,38
Spring 2020,2/11/2020,Tuesday,10:30 AM,15,7,22,5,0,49
Spring 2020,2/11/2020,Tuesday,12:30 PM,30,14,41,4,2,91
Spring 2020,2/11/2020,Tuesday,1:30 PM,20,8,14,4,0,46
Spring 2020,2/11/2020,Tuesday,3:30 PM,18,13,14,7,0,52
Spring 2020,2/11/2020,Tuesday,4:30 PM,17,7,14,3,0,41
Spring 2020,2/12/2020,Wednesday,7:30 AM,4,0,1,0,0,5
Spring 2020,2/12/2020,Wednesday,8:30 AM,8,2,8,2,1,21
Spring 2020,2/12/2020,Wednesday,9:30 AM,11,2,9,3,0,25
Spring 2020,2/12/2020,Wednesday,10:30 AM,25,10,17,1,0,53
Spring 2020,2/12/2020,Wednesday,11:30 AM,20,6,24,1,0,51
Spring 2020,2/12/2020,Wednesday,12:30 PM,42,11,32,5,0,90
Spring 2020,2/12/2020,Wednesday,1:30 PM,19,10,22,4,0,55
Spring 2020,2/12/2020,Wednesday,2:30 PM,22,7,14,16,2,61
Spring 2020,2/12/2020,Wednesday,3:30 PM,20,6,18,5,0,49
Spring 2020,2/12/2020,Wednesday,7:30 PM,7,4,5,5,0,21
Spring 2020,2/12/2020,Wednesday,8:30 PM,5,2,5,0,0,12
Spring 2020,2/12/2020,Wednesday,11:30 AM,1,1,0,0,0,2
Spring 2020,2/12/2020,Wednesday,12:30 PM,6,3,6,1,0,16
Spring 2020,2/12/2020,Wednesday,1:30 PM,24,5,14,1,3,47
Spring 2020,2/13/2020,Thursday,10:30 AM,42,8,32,1,0,83
Spring 2020,2/13/2020,Thursday,12:30 PM,35,13,33,2,1,84
Spring 2020,2/13/2020,Thursday,1:30 PM,18,7,21,4,1,51
Spring 2020,2/13/2020,Thursday,3:30 PM,11,7,12,3,0,33
Spring 2020,2/14/2020,Friday,1:30 PM,5,2,6,2,1,16
Spring 2020,2/14/2020,Friday,5:30 PM,4,0,0,0,0,4
Spring 2020,2/15/2020,Saturday,9:30 AM,1,1,0,0,0,2
Spring 2020,2/15/2020,Saturday,10:30 AM,4,1,0,1,1,7
Spring 2020,2/15/2020,Saturday,11:30 AM,9,2,6,0,1,18
Spring 2020,2/15/2020,Saturday,12:30 PM,5,2,6,0,2,15
Spring 2020,2/15/2020,Saturday,1:30 PM,8,2,4,1,4,19
Spring 2020,2/17/2020,Monday,10:30 AM,25,9,20,9,3,66
Spring 2020,2/17/2020,Monday,11:30 AM,25,13,19,4,0,61
Spring 2020,2/17/2020,Monday,12:30 PM,27,11,55,5,2,100
Spring 2020,2/17/2020,Monday,1:30 PM,17,8,18,6,2,51
Spring 2020,2/17/2020,Monday,2:30 PM,20,2,11,17,8,58
Spring 2020,2/17/2020,Monday,3:30 PM,22,6,18,9,3,58
Spring 2020,2/17/2020,Monday,4:30 PM,18,6,17,3,2,46
Spring 2020,2/17/2020,Monday,5:30 PM,14,8,14,6,0,42
Spring 2020,2/17/2020,Monday,6:30 PM,9,6,11,7,0,33
Spring 2020,2/17/2020,Monday,7:30 PM,7,3,11,2,0,23
Spring 2020,2/17/2020,Monday,8:30 PM,5,3,3,0,0,11
Spring 2020,2/18/2020,Tuesday,7:30 AM,0,1,0,0,3,4
Spring 2020,2/18/2020,Tuesday,8:30 AM,5,3,3,5,1,17
Spring 2020,2/18/2020,Tuesday,9:30 AM,10,8,13,1,0,32
Spring 2020,2/18/2020,Tuesday,10:30 AM,16,12,15,6,2,51
Spring 2020,2/18/2020,Tuesday,12:30 PM,36,11,47,5,0,99
Spring 2020,2/18/2020,Tuesday,1:30 PM,18,12,21,4,0,55
Spring 2020,2/18/2020,Tuesday,2:30 PM,15,8,15,5,0,43
Spring 2020,2/18/2020,Tuesday,3:30 PM,19,9,20,6,0,54
Spring 2020,2/18/2020,Tuesday,4:30 PM,15,7,14,6,1,43
Spring 2020,2/19/2020,Wednesday,10:30 AM,26,10,24,7,0,67
Spring 2020,2/19/2020,Wednesday,12:30 PM,38,12,43,3,3,99
Spring 2020,2/19/2020,Wednesday,1:30 PM,27,6,16,4,0,53
Spring 2020,2/19/2020,Wednesday,3:30 PM,18,7,24,8,0,57
Spring 2020,2/19/2020,Wednesday,4:30 PM,14,5,16,8,0,43
Spring 2020,2/19/2020,Wednesday,5:30 PM,13,5,9,5,0,32
Spring 2020,2/19/2020,Wednesday,6:30 PM,10,4,7,2,0,23
Spring 2020,2/19/2020,Wednesday,7:30 PM,5,1,5,0,0,11
Spring 2020,2/19/2020,Wednesday,8:30 PM,5,0,3,0,0,8
Spring 2020,2/20/2020,Thursday,7:30 AM,15,3,1,5,1,25
Spring 2020,2/20/2020,Thursday,9:30 AM,12,9,11,2,0,34
Spring 2020,2/20/2020,Thursday,10:30 AM,23,7,23,3,0,56
Spring 2020,2/20/2020,Thursday,11:30 AM,23,6,12,3,2,46
Spring 2020,2/20/2020,Thursday,12:30 PM,38,8,34,6,4,90
Spring 2020,2/20/2020,Thursday,1:30 PM,18,5,2,22,6,53
Spring 2020,2/20/2020,Thursday,2:30 PM,14,7,15,5,0,41
Spring 2020,2/20/2020,Thursday,3:30 PM,11,7,12,9,0,39
Spring 2020,2/21/2020,Friday,7:30 AM,2,0,0,0,0,2
Spring 2020,2/21/2020,Friday,8:30 AM,6,3,2,0,0,11
Spring 2020,2/21/2020,Friday,9:30 AM,9,2,3,0,1,15
Spring 2020,2/21/2020,Friday,10:30 AM,8,4,5,3,2,22
Spring 2020,2/21/2020,Friday,12:30 PM,12,3,9,7,3,34
Spring 2020,2/21/2020,Friday,5:30 PM,9,1,2,2,2,16
Spring 2020,2/21/2020,Friday,6:30 PM,9,1,5,3,2,20
Spring 2020,2/21/2020,Friday,7:30 PM,11,1,5,5,0,22
Spring 2020,2/22/2020,Saturday,10:30 AM,6,2,3,0,0,11
Spring 2020,2/22/2020,Saturday,11:30 AM,7,4,2,0,0,13
Spring 2020,2/22/2020,Saturday,12:30 PM,10,5,4,1,0,20
Spring 2020,2/22/2020,Saturday,1:30 PM,9,4,4,0,0,17
Spring 2020,2/24/2020,Monday,11:30 AM,29,11,21,2,0,63
Spring 2020,2/24/2020,Monday,12:30 PM,39,12,43,5,0,99
Spring 2020,2/24/2020,Monday,1:30 PM,16,8,20,2,0,46
Spring 2020,2/24/2020,Monday,3:30 PM,19,6,17,8,2,52
Spring 2020,2/24/2020,Monday,4:30 PM,27,5,14,10,0,56
Spring 2020,2/24/2020,Monday,5:30 PM,22,6,15,9,1,53
Spring 2020,2/24/2020,Monday,6:30 PM,15,4,8,3,1,31
Spring 2020,2/24/2020,Monday,7:30 PM,13,2,5,6,0,26
Spring 2020,2/24/2020,Monday,8:30 PM,11,3,1,4,1,20
Spring 2020,2/25/2020,Tuesday,7:30 AM,0,1,0,0,3,4
Spring 2020,2/25/2020,Tuesday,8:30 AM,6,3,0,2,0,11
Spring 2020,2/25/2020,Tuesday,9:30 AM,12,7,12,11,0,42
Spring 2020,2/25/2020,Tuesday,10:30 AM,24,7,22,11,0,64
Spring 2020,2/25/2020,Tuesday,11:30 AM,18,9,18,11,0,56
Spring 2020,2/25/2020,Tuesday,12:30 PM,40,12,40,12,0,104
Spring 2020,2/25/2020,Tuesday,1:30 PM,20,7,21,11,0,59
Spring 2020,2/25/2020,Tuesday,2:30 PM,20,8,30,13,2,73
Spring 2020,2/25/2020,Tuesday,3:30 PM,27,10,18,4,0,59
Spring 2020,2/25/2020,Tuesday,4:30 PM,16,7,12,9,0,44
Spring 2020,2/26/2020,Wednesday,12:30 PM,27,5,32,7,4,75
Spring 2020,2/26/2020,Wednesday,2:30 PM,28,6,23,1,4,62
Spring 2020,2/26/2020,Wednesday,8:30 PM,10,2,1,0,0,13
Spring 2020,2/27/2020,Thursday,7:30 AM,3,0,0,0,1,4
Spring 2020,2/27/2020,Thursday,9:30 AM,10,7,12,7,2,38
Spring 2020,2/27/2020,Thursday,11:30 AM,15,7,13,6,3,44
Spring 2020,2/27/2020,Thursday,12:30 PM,30,14,32,8,4,88
Spring 2020,2/27/2020,Thursday,3:30 PM,24,5,5,6,0,40
Spring 2020,2/27/2020,Thursday,4:30 PM,17,4,10,10,0,41
Spring 2020,2/28/2020,Friday,11:30 AM,13,6,6,1,1,27
Spring 2020,2/28/2020,Friday,12:30 PM,8,5,5,2,4,24
Spring 2020,2/28/2020,Friday,3:30 PM,8,6,6,0,0,20
Spring 2020,2/28/2020,Friday,4:30 PM,6,4,5,0,0,15
Spring 2020,2/28/2020,Friday,5:30 PM,5,5,1,4,0,15
Spring 2020,2/28/2020,Friday,6:30 PM,11,3,0,5,0,19
Spring 2020,2/28/2020,Friday,8:30 PM,6,2,0,1,0,9
Spring 2020,2/29/2020,Saturday,11:30 AM,6,2,9,2,0,19
Spring 2020,3/2/2020,Monday,10:30 AM,24,7,17,4,0,52
Spring 2020,3/2/2020,Monday,11:30 AM,20,7,13,4,0,44
Spring 2020,3/2/2020,Monday,12:30 PM,41,14,47,12,0,114
Spring 2020,3/2/2020,Monday,1:30 PM,26,7,29,7,0,69
Spring 2020,3/2/2020,Monday,2:30 PM,18,8,16,10,2,54
Spring 2020,3/2/2020,Monday,3:30 PM,13,7,14,11,4,49
Spring 2020,3/2/2020,Monday,4:30 PM,18,4,13,12,2,49
Spring 2020,3/2/2020,Monday,5:30 PM,23,6,17,5,1,52
Spring 2020,3/2/2020,Monday,6:30 PM,15,4,10,3,0,32
Spring 2020,3/2/2020,Monday,7:30 PM,11,2,9,3,0,25
Spring 2020,3/2/2020,Monday,8:30 PM,8,1,6,0,0,15
Spring 2020,3/3/2020,Tuesday,7:30 AM,1,1,0,0,0,2
Spring 2020,3/3/2020,Tuesday,8:30 AM,7,3,2,2,1,15
Spring 2020,3/3/2020,Tuesday,10:30 AM,20,6,28,8,0,62
Spring 2020,3/3/2020,Tuesday,11:30 AM,20,8,28,5,0,61
Spring 2020,3/3/2020,Tuesday,12:30 PM,38,11,32,10,0,91
Spring 2020,3/3/2020,Tuesday,1:30 PM,13,9,24,7,0,53
Spring 2020,3/3/2020,Tuesday,3:30 PM,17,6,14,9,0,46
Spring 2020,3/3/2020,Tuesday,4:30 PM,15,7,14,7,2,45
Spring 2020,3/4/2020,Wednesday,10:30 AM,32,5,24,1,1,63
Spring 2020,3/4/2020,Wednesday,11:30 AM,21,8,29,9,1,68
Spring 2020,3/4/2020,Wednesday,12:30 PM,39,9,38,14,0,100
Spring 2020,3/4/2020,Wednesday,1:30 PM,25,4,15,10,3,57
Spring 2020,3/4/2020,Wednesday,1:30 PM,22,5,21,4,0,52
Spring 2020,3/4/2020,Wednesday,2:30 PM,25,11,17,9,3,65
Spring 2020,3/4/2020,Wednesday,3:30 PM,17,3,15,7,2,44
Spring 2020,3/4/2020,Wednesday,5:30 PM,15,6,14,3,1,39
Spring 2020,3/4/2020,Wednesday,7:30 PM,8,3,6,5,0,22
Spring 2020,3/4/2020,Wednesday,8:30 PM,7,1,5,0,0,13
Spring 2020,3/5/2020,Thursday,7:30 AM,0,0,0,0,0,0
Spring 2020,3/5/2020,Thursday,8:30 AM,13,5,4,3,2,27
Spring 2020,3/5/2020,Thursday,10:30 AM,24,5,21,10,1,61
Spring 2020,3/5/2020,Thursday,11:30 AM,18,7,14,9,1,49
Spring 2020,3/5/2020,Thursday,12:30 PM,26,11,49,16,0,102
Spring 2020,3/5/2020,Thursday,1:30 PM,22,8,32,8,0,70
Spring 2020,3/5/2020,Thursday,2:30 PM,8,5,18,6,0,37
Spring 2020,3/5/2020,Thursday,3:30 PM,12,3,19,2,0,36
Spring 2020,3/5/2020,Thursday,4:30 PM,12,3,14,0,0,29
Spring 2020,3/6/2020,Friday,7:30 AM,2,0,0,0,0,2
Spring 2020,3/6/2020,Friday,8:30 AM,2,2,2,0,0,6
Spring 2020,3/6/2020,Friday,9:30 AM,5,5,3,0,0,13
Spring 2020,3/6/2020,Friday,10:30 AM,8,5,7,0,0,20
Spring 2020,3/6/2020,Friday,11:30 AM,12,5,9,3,4,33
Spring 2020,3/6/2020,Friday,12:30 PM,14,6,10,4,3,37
Spring 2020,3/6/2020,Friday,1:30 PM,11,6,4,2,1,24
Spring 2020,3/6/2020,Friday,5:30 PM,7,2,0,1,1,11
Spring 2020,3/6/2020,Friday,6:30 PM,9,3,1,1,0,14
Spring 2020,3/6/2020,Friday,7:30 PM,10,3,5,3,0,21
Spring 2020,3/6/2020,Friday,8:30 PM,5,0,4,1,0,10
Spring 2020,3/9/2020,Monday,12:30 PM,46,12,47,7,0,112
Spring 2020,3/9/2020,Monday,1:30 PM,29,5,25,17,0,76
Spring 2020,3/9/2020,Monday,3:30 PM,20,7,13,8,6,54
Spring 2020,3/9/2020,Monday,5:30 PM,22,8,21,6,3,60
Spring 2020,3/9/2020,Monday,6:30 PM,12,6,15,5,1,39
Spring 2020,3/9/2020,Monday,8:30 PM,11,3,1,0,0,15
Spring 2020,3/10/2020,Tuesday,9:30 AM,17,6,11,1,0,35
Spring 2020,3/10/2020,Tuesday,10:30 AM,24,7,11,10,0,52
Spring 2020,3/10/2020,Tuesday,11:30 AM,18,8,17,3,0,46
Spring 2020,3/10/2020,Tuesday,12:30 PM,38,10,34,6,0,88
Spring 2020,3/10/2020,Tuesday,1:30 PM,21,11,21,5,0,58
Spring 2020,3/11/2020,Wednesday,7:30 AM,1,0,1,0,0,2
Spring 2020,3/11/2020,Wednesday,8:30 AM,17,1,16,1,2,37
Spring 2020,3/11/2020,Wednesday,9:30 AM,23,2,14,15,6,60
Spring 2020,3/11/2020,Wednesday,10:30 AM,25,5,17,5,2,54
Spring 2020,3/11/2020,Wednesday,11:30 AM,24,10,22,6,0,62
Spring 2020,3/11/2020,Wednesday,12:30 PM,36,14,41,10,0,101
Spring 2020,3/11/2020,Wednesday,1:30 PM,22,4,23,14,0,63
Spring 2020,3/11/2020,Wednesday,2:30 PM,32,8,12,12,0,64
Spring 2020,3/11/2020,Wednesday,3:30 PM,18,5,17,10,1,51
Spring 2020,3/11/2020,Wednesday,5:30 PM,16,4,9,1,0,30
Spring 2020,3/11/2020,Wednesday,6:30 PM,11,4,6,0,0,21
Spring 2020,3/11/2020,Wednesday,8:30 PM,7,0,2,0,10,19
Spring 2020,3/12/2020,Thursday,8:30 AM,15,2,3,3,2,25
Spring 2020,3/12/2020,Thursday,9:30 AM,11,4,11,4,3,33
Spring 2020,3/12/2020,Thursday,10:30 AM,21,5,20,7,15,68
Spring 2020,3/12/2020,Thursday,11:30 AM,17,10,8,9,0,44
Spring 2020,3/12/2020,Thursday,12:30 PM,24,8,20,11,0,63
Spring 2020,3/12/2020,Thursday,1:30 PM,9,2,14,8,0,33
Spring 2020,3/12/2020,Thursday,2:30 PM,19,4,13,7,0,43
Spring 2020,3/12/2020,Thursday,3:30 PM,12,6,10,4,0,32
Spring 2020,3/12/2020,Thursday,4:30 PM,13,5,14,1,0,33
Spring 2020,3/13/2020,Friday,11:30 AM,14,1,2,0,0,17
Spring 2020,3/13/2020,Friday,12:30 PM,12,1,1,0,0,14
Spring 2020,3/13/2020,Friday,1:30 PM,9,1,1,0,0,11
Spring 2020,3/13/2020,Friday,5:30 PM,4,1,1,0,0,6
Spring 2020,3/13/2020,Friday,6:30 PM,5,0,0,0,0,5
Spring 2020,3/13/2020,Friday,7:30 PM,5,0,0,0,0,5
Spring 2020,3/13/2020,Friday,8:30 PM,2,0,0,0,0,2
Spring 2020,3/14/2020,Saturday,9:30 AM,0,1,0,0,0,1
Spring 2020,3/14/2020,Saturday,10:30 AM,3,1,1,0,0,5
Spring 2020,3/14/2020,Saturday,11:30 AM,4,1,1,0,0,6
Spring 2020,3/14/2020,Saturday,1:30 PM,4,0,0,0,0,4
Spring 2020,3/14/2020,Saturday,3:30 PM,2,2,0,0,0,4
Spring 2020,3/14/2020,Saturday,4:30 PM,1,0,1,0,0,2
Spring 2020,3/14/2020,Saturday,5:30 PM,0,0,1,0,0,1
Fall 2020,8/31/2020,Monday,8:30 AM,1,0,0,0,0,1
Fall 2020,8/31/2020,Monday,9:30 AM,5,0,0,0,1,6
Fall 2020,8/31/2020,Monday,10:30 AM,1,0,0,0,0,1
Fall 2020,8/31/2020,Monday,4:30 PM,3,0,1,0,0,4
Fall 2020,8/31/2020,Monday,5:30 PM,3,0,0,1,1,5
Fall 2020,8/31/2020,Monday,6:30 PM,4,0,1,3,1,9
Fall 2020,8/31/2020,Monday,7:30 PM,2,0,0,0,0,2
Fall 2020,9/1/2020,Tuesday,8:30 AM,1,0,0,0,0,1
Fall 2020,9/1/2020,Tuesday,11:30 AM,3,0,0,0,0,3
Fall 2020,9/1/2020,Tuesday,12:30 PM,7,0,4,0,0,11
Fall 2020,9/1/2020,Tuesday,1:30 PM,2,0,3,0,0,5
Fall 2020,9/1/2020,Tuesday,2:30 PM,4,0,3,1,0,8
Fall 2020,9/1/2020,Tuesday,4:30 PM,9,0,2,2,1,14
Fall 2020,9/1/2020,Tuesday,5:30 PM,4,0,0,0,2,6
Fall 2020,9/1/2020,Tuesday,6:30 PM,5,0,0,1,0,6
Fall 2020,9/1/2020,Tuesday,7:30 PM,4,0,1,1,0,6
Fall 2020,9/2/2020,Wednesday,8:30 AM,0,0,0,0,0,0
Fall 2020,9/2/2020,Wednesday,9:30 AM,5,0,0,0,0,5
Fall 2020,9/2/2020,Wednesday,10:30 AM,7,0,0,0,0,7
Fall 2020,9/2/2020,Wednesday,4:30 PM,0,0,1,1,0,2
Fall 2020,9/2/2020,Wednesday,5:30 PM,5,0,0,1,0,6
Fall 2020,9/2/2020,Wednesday,6:30 PM,1,0,0,1,1,3
Fall 2020,9/2/2020,Wednesday,7:30 PM,1,0,0,1,0,2
Fall 2020,9/3/2020,Thursday,11:30 AM,3,0,4,0,0,7
Fall 2020,9/3/2020,Thursday,12:30 PM,5,0,3,0,0,8
Fall 2020,9/3/2020,Thursday,1:30 PM,4,0,1,0,0,5
Fall 2020,9/3/2020,Thursday,2:30 PM,5,0,0,0,1,6
Fall 2020,9/3/2020,Thursday,4:30 PM,2,0,0,0,0,2
Fall 2020,9/3/2020,Thursday,5:30 PM,1,0,0,1,0,2
Fall 2020,9/3/2020,Thursday,6:30 PM,1,0,0,2,0,3
Fall 2020,9/3/2020,Thursday,7:30 PM,2,0,0,2,0,4
Fall 2020,9/4/2020,Friday,8:30 AM,3,0,0,0,0,3
Fall 2020,9/4/2020,Friday,9:30 AM,1,0,1,0,0,2
Fall 2020,9/4/2020,Friday,10:30 AM,5,0,1,0,0,6
Fall 2020,9/4/2020,Friday,4:30 PM,5,0,0,1,0,6
Fall 2020,9/4/2020,Friday,5:30 PM,7,0,0,0,0,7
Fall 2020,9/4/2020,Friday,6:30 PM,1,0,1,0,0,2
Fall 2020,9/4/2020,Friday,7:30 PM,1,0,1,0,0,2
Fall 2020,9/8/2020,Tuesday,11:30 AM,8,0,1,0,0,9
Fall 2020,9/8/2020,Tuesday,12:30 PM,8,0,2,0,1,11
Fall 2020,9/8/2020,Tuesday,1:30 PM,4,0,4,0,4,12
Fall 2020,9/8/2020,Tuesday,2:30 PM,5,0,4,0,0,9
Fall 2020,9/8/2020,Tuesday,4:30 PM,3,0,3,0,0,6
Fall 2020,9/8/2020,Tuesday,5:30 PM,3,0,0,0,0,3
Fall 2020,9/8/2020,Tuesday,6:30 PM,0,0,0,1,0,1
Fall 2020,9/8/2020,Tuesday,7:30 PM,1,0,0,0,0,1
Fall 2020,9/9/2020,Wednesday,7:30 AM,0,0,0,0,0,0
Fall 2020,9/9/2020,Wednesday,8:30 AM,3,0,1,0,0,4
Fall 2020,9/9/2020,Wednesday,9:30 AM,5,0,0,0,0,5
Fall 2020,9/9/2020,Wednesday,10:30 AM,8,0,1,1,0,10
Fall 2020,9/9/2020,Wednesday,4:30 PM,2,0,0,0,0,2
Fall 2020,9/9/2020,Wednesday,5:30 PM,4,0,0,1,0,5
Fall 2020,9/9/2020,Wednesday,6:30 PM,1,0,0,1,0,2
Fall 2020,9/9/2020,Wednesday,7:30 PM,3,0,0,1,1,5
Fall 2020,9/10/2020,Thursday,7:30 AM,0,0,0,0,0,0
Fall 2020,9/10/2020,Thursday,11:30 AM,11,0,3,3,1,18
Fall 2020,9/10/2020,Thursday,12:30 PM,6,0,3,0,1,10
Fall 2020,9/10/2020,Thursday,1:30 PM,4,0,1,0,0,5
Fall 2020,9/10/2020,Thursday,2:30 PM,5,0,1,1,0,7
Fall 2020,9/10/2020,Thursday,4:30 PM,8,0,2,1,0,11
Fall 2020,9/10/2020,Thursday,5:30 PM,3,0,0,1,0,4
Fall 2020,9/10/2020,Thursday,6:30 PM,5,0,2,1,0,8
Fall 2020,9/10/2020,Thursday,7:30 PM,2,0,2,1,0,5
Fall 2020,9/11/2020,Friday,7:30 AM,0,0,0,0,0,0
Fall 2020,9/11/2020,Friday,8:30 AM,3,0,0,0,0,3
Fall 2020,9/11/2020,Friday,9:30 AM,3,0,0,0,0,3
Fall 2020,9/11/2020,Friday,10:30 AM,4,0,1,0,0,5
Fall 2020,9/11/2020,Friday,4:30 PM,4,0,4,0,4,12
Fall 2020,9/11/2020,Friday,5:30 PM,3,0,1,1,0,5
Fall 2020,9/11/2020,Friday,6:30 PM,1,0,0,1,0,2
Fall 2020,9/11/2020,Friday,7:30 PM,1,0,0,1,0,2
Fall 2020,9/14/2020,Monday,7:30 AM,0,0,0,0,0,0
Fall 2020,9/14/2020,Monday,8:30 AM,2,0,0,0,0,2
Fall 2020,9/14/2020,Monday,9:30 AM,1,0,0,0,0,1
Fall 2020,9/14/2020,Monday,10:30 AM,0,0,0,1,0,1
Fall 2020,9/14/2020,Monday,4:30 PM,6,0,0,2,4,12
Fall 2020,9/14/2020,Monday,5:30 PM,3,0,0,0,0,3
Fall 2020,9/14/2020,Monday,6:30 PM,4,0,0,0,0,4
Fall 2020,9/14/2020,Monday,7:30 PM,1,0,0,2,0,3
Fall 2020,9/15/2020,Tuesday,11:30 AM,7,0,2,1,0,10
Fall 2020,9/15/2020,Tuesday,12:30 PM,5,0,1,1,0,7
Fall 2020,9/15/2020,Tuesday,1:30 PM,2,0,1,1,2,6
Fall 2020,9/15/2020,Tuesday,2:30 PM,3,0,1,1,2,7
Fall 2020,9/15/2020,Tuesday,4:30 PM,4,0,1,0,0,5
Fall 2020,9/15/2020,Tuesday,5:30 PM,6,0,0,0,0,6
Fall 2020,9/15/2020,Tuesday,6:30 PM,2,0,0,1,0,3
Fall 2020,9/15/2020,Tuesday,7:30 PM,1,0,0,1,0,2
Fall 2020,9/16/2020,Wednesday,7:30 AM,2,0,0,0,0,2
Fall 2020,9/16/2020,Wednesday,8:30 AM,1,0,0,0,0,1
Fall 2020,9/16/2020,Wednesday,9:30 AM,2,0,0,0,0,2
Fall 2020,9/16/2020,Wednesday,10:30 AM,2,0,1,0,0,3
Fall 2020,9/16/2020,Wednesday,4:30 PM,4,0,0,1,1,6
Fall 2020,9/16/2020,Wednesday,5:30 PM,4,0,0,1,2,7
Fall 2020,9/16/2020,Wednesday,6:30 PM,2,0,0,3,1,6
Fall 2020,9/16/2020,Wednesday,7:30 PM,1,0,0,1,0,2
Fall 2020,9/17/2020,Thursday,11:30 AM,2,0,0,0,4,6
Fall 2020,9/17/2020,Thursday,12:30 PM,7,0,2,0,1,10
Fall 2020,9/17/2020,Thursday,1:30 PM,4,0,1,0,1,6
Fall 2020,9/17/2020,Thursday,2:30 PM,4,0,2,0,1,7
Fall 2020,9/17/2020,Thursday,4:30 PM,2,0,0,0,0,2
Fall 2020,9/17/2020,Thursday,5:30 PM,6,0,0,2,0,8
Fall 2020,9/17/2020,Thursday,6:30 PM,3,0,0,0,0,3
Fall 2020,9/17/2020,Thursday,7:30 PM,5,0,0,0,0,5
Fall 2020,9/18/2020,Friday,7:30 AM,0,0,0,0,0,0
Fall 2020,9/18/2020,Friday,8:30 AM,2,0,0,0,0,2
Fall 2020,9/18/2020,Friday,9:30 AM,1,0,1,0,0,2
Fall 2020,9/18/2020,Friday,10:30 AM,2,0,1,0,0,3
Fall 2020,9/18/2020,Friday,4:30 PM,5,0,0,0,0,5
Fall 2020,9/18/2020,Friday,5:30 PM,0,0,0,0,0,0
Fall 2020,9/18/2020,Friday,6:30 PM,0,0,0,0,0,0
Fall 2020,9/18/2020,Friday,7:30 PM,0,0,0,0,0,0
Fall 2020,9/21/2020,Monday,7:30 AM,0,0,0,0,0,0
Fall 2020,9/21/2020,Monday,8:30 AM,1,0,0,0,0,1
Fall 2020,9/21/2020,Monday,9:30 AM,5,0,0,0,0,5
Fall 2020,9/21/2020,Monday,10:30 AM,4,0,0,1,0,5
Fall 2020,9/21/2020,Monday,4:30 PM,7,1,0,0,0,8
Fall 2020,9/21/2020,Monday,5:30 PM,2,1,2,0,0,5
Fall 2020,9/21/2020,Monday,6:30 PM,0,0,2,0,0,2
Fall 2020,9/21/2020,Monday,7:30 PM,0,0,2,0,0,2
Fall 2020,9/22/2020,Tuesday,7:30 AM,0,0,0,0,0,0
Fall 2020,9/22/2020,Tuesday,8:30 AM,2,0,0,0,0,2
Fall 2020,9/22/2020,Tuesday,9:30 AM,5,0,0,0,1,6
Fall 2020,9/22/2020,Tuesday,10:30 AM,0,0,0,0,1,1
Fall 2020,9/22/2020,Tuesday,11:30 AM,6,0,1,0,0,7
Fall 2020,9/22/2020,Tuesday,12:30 PM,8,0,2,0,3,13
Fall 2020,9/22/2020,Tuesday,1:30 PM,7,0,2,0,4,13
Fall 2020,9/22/2020,Tuesday,2:30 PM,6,0,0,0,0,6
Fall 2020,9/22/2020,Tuesday,3:30 PM,4,0,0,0,0,4
Fall 2020,9/22/2020,Tuesday,4:30 PM,4,0,0,0,0,4
Fall 2020,9/22/2020,Tuesday,5:30 PM,7,0,1,0,0,8
Fall 2020,9/22/2020,Tuesday,6:30 PM,4,0,1,0,0,5
Fall 2020,9/22/2020,Tuesday,7:30 PM,3,0,0,1,0,4
Fall 2020,9/23/2020,Wednesday,7:30 AM,0,0,0,0,0,0
Fall 2020,9/23/2020,Wednesday,8:30 AM,0,0,0,0,0,0
Fall 2020,9/23/2020,Wednesday,9:30 AM,2,0,0,1,0,3
Fall 2020,9/23/2020,Wednesday,10:30 AM,3,0,0,1,0,4
Fall 2020,9/23/2020,Wednesday,11:30 AM,5,0,0,0,2,7
Fall 2020,9/23/2020,Wednesday,12:30 PM,6,0,0,0,1,7
Fall 2020,9/23/2020,Wednesday,1:30 PM,9,0,0,0,0,9
Fall 2020,9/23/2020,Wednesday,2:30 PM,5,0,0,0,1,6
Fall 2020,9/23/2020,Wednesday,3:30 PM,4,0,1,1,2,8
Fall 2020,9/23/2020,Wednesday,4:30 PM,4,0,1,1,0,6
Fall 2020,9/23/2020,Wednesday,5:30 PM,4,0,2,1,0,7
Fall 2020,9/23/2020,Wednesday,6:30 PM,2,0,0,1,2,5
Fall 2020,9/23/2020,Wednesday,7:30 PM,1,0,0,0,2,3
Fall 2020,9/24/2020,Thursday,7:30 AM,0,0,0,0,0,0
Fall 2020,9/24/2020,Thursday,8:30 AM,3,0,0,0,2,5
Fall 2020,9/24/2020,Thursday,9:30 AM,4,0,0,0,1,5
Fall 2020,9/24/2020,Thursday,10:30 AM,3,0,0,0,3,6
Fall 2020,9/24/2020,Thursday,11:30 AM,5,0,2,0,0,7
Fall 2020,9/24/2020,Thursday,12:30 PM,7,0,1,2,0,10
Fall 2020,9/24/2020,Thursday,1:30 PM,7,0,0,1,2,10
Fall 2020,9/24/2020,Thursday,2:30 PM,5,0,0,1,0,6
Fall 2020,9/24/2020,Thursday,3:30 PM,6,0,2,1,1,10
Fall 2020,9/24/2020,Thursday,4:30 PM,0,0,0,1,0,1
Fall 2020,9/24/2020,Thursday,5:30 PM,3,0,0,0,0,3
Fall 2020,9/24/2020,Thursday,6:30 PM,2,0,0,0,0,2
Fall 2020,9/24/2020,Thursday,7:30 PM,4,0,0,0,1,5
Fall 2020,9/25/2020,Friday,7:30 AM,0,0,0,0,0,0
Fall 2020,9/25/2020,Friday,8:30 AM,2,0,0,1,0,3
Fall 2020,9/25/2020,Friday,9:30 AM,3,0,0,0,0,3
Fall 2020,9/25/2020,Friday,10:30 AM,3,0,0,0,0,3
Fall 2020,9/25/2020,Friday,11:30 AM,6,0,0,0,0,6
Fall 2020,9/25/2020,Friday,12:30 PM,4,0,0,0,3,7
Fall 2020,9/25/2020,Friday,1:30 PM,4,0,0,0,3,7
Fall 2020,9/25/2020,Friday,2:30 PM,4,0,0,0,2,6
Fall 2020,9/25/2020,Friday,3:30 PM,0,0,0,0,0,0
Fall 2020,9/25/2020,Friday,4:30 PM,0,0,0,0,0,0
Fall 2020,9/25/2020,Friday,5:30 PM,0,0,1,1,2,4
Fall 2020,9/25/2020,Friday,6:30 PM,0,0,1,0,2,3
Fall 2020,9/25/2020,Friday,7:30 PM,0,0,1,0,1,2
Fall 2020,9/26/2020,Saturday,9:30 AM,0,0,0,0,0,0
Fall 2020,9/26/2020,Saturday,10:30 AM,0,0,0,0,0,0
Fall 2020,9/26/2020,Saturday,11:30 AM,1,0,0,0,0,1
Fall 2020,9/26/2020,Saturday,12:30 PM,2,0,0,0,0,2
Fall 2020,9/26/2020,Saturday,1:30 PM,3,0,1,0,0,4
Fall 2020,9/26/2020,Saturday,2:30 PM,4,0,1,0,0,5
Fall 2020,9/28/2020,Monday,7:30 AM,2,0,0,0,0,2
Fall 2020,9/28/2020,Monday,8:30 AM,5,0,0,1,0,6
Fall 2020,9/28/2020,Monday,9:30 AM,1,0,0,1,0,2
Fall 2020,9/28/2020,Monday,10:30 AM,5,0,1,1,0,7
Fall 2020,9/28/2020,Monday,11:30 AM,6,0,0,0,2,8
Fall 2020,9/28/2020,Monday,12:30 PM,2,0,0,0,1,3
Fall 2020,9/28/2020,Monday,1:30 PM,5,0,0,1,0,6
Fall 2020,9/28/2020,Monday,2:30 PM,4,0,0,0,5,9
Fall 2020,9/28/2020,Monday,3:30 PM,3,0,1,0,0,4
Fall 2020,9/28/2020,Monday,4:30 PM,2,0,1,0,2,5
Fall 2020,9/28/2020,Monday,5:30 PM,3,0,1,0,1,5
Fall 2020,9/28/2020,Monday,6:30 PM,3,0,0,0,1,4
Fall 2020,9/28/2020,Monday,7:30 PM,6,0,0,0,0,6
Fall 2020,9/29/2020,Tuesday,7:30 AM,1,0,0,0,0,1
Fall 2020,9/29/2020,Tuesday,8:30 AM,5,0,0,0,0,5
Fall 2020,9/29/2020,Tuesday,9:30 AM,9,0,0,0,0,9
Fall 2020,9/29/2020,Tuesday,10:30 AM,10,0,0,0,1,11
Fall 2020,9/29/2020,Tuesday,11:30 AM,13,0,1,0,0,14
Fall 2020,9/29/2020,Tuesday,12:30 PM,9,0,3,0,3,15
Fall 2020,9/29/2020,Tuesday,1:30 PM,8,0,3,0,3,14
Fall 2020,9/29/2020,Tuesday,2:30 PM,9,0,2,0,0,11
Fall 2020,9/29/2020,Tuesday,3:30 PM,7,0,2,0,1,10
Fall 2020,9/29/2020,Tuesday,4:30 PM,4,0,0,0,0,4
Fall 2020,9/29/2020,Tuesday,5:30 PM,2,0,1,0,0,3
Fall 2020,9/29/2020,Tuesday,6:30 PM,3,0,1,0,0,4
Fall 2020,9/29/2020,Tuesday,7:30 PM,0,0,2,0,0,2
Fall 2020,9/30/2020,Wednesday,7:30 AM,0,0,0,0,0,0
Fall 2020,9/30/2020,Wednesday,8:30 AM,0,0,0,0,0,0
Fall 2020,9/30/2020,Wednesday,9:30 AM,3,0,0,0,0,3
Fall 2020,9/30/2020,Wednesday,10:30 AM,4,0,0,0,0,4
Fall 2020,9/30/2020,Wednesday,11:30 AM,4,0,0,0,0,4
Fall 2020,9/30/2020,Wednesday,12:30 PM,4,0,0,0,1,5
Fall 2020,9/30/2020,Wednesday,1:30 PM,2,0,0,0,1,3
Fall 2020,9/30/2020,Wednesday,1:30 PM,1,0,0,0,1,2
Fall 2020,9/30/2020,Wednesday,2:30 PM,5,0,0,0,1,6
Fall 2020,9/30/2020,Wednesday,2:30 PM,4,0,0,0,1,5
Fall 2020,9/30/2020,Wednesday,4:30 PM,2,0,3,0,2,7
Fall 2020,9/30/2020,Wednesday,5:30 PM,2,0,3,0,2,7
Fall 2020,9/30/2020,Wednesday,6:30 PM,3,0,1,0,1,5
Fall 2020,9/30/2020,Wednesday,7:30 PM,0,0,0,0,1,1
Fall 2020,10/1/2020,Thursday,7:30 AM,0,0,0,0,0,0
Fall 2020,10/1/2020,Thursday,8:30 AM,6,0,0,0,0,6
Fall 2020,10/1/2020,Thursday,9:30 AM,7,0,0,0,0,7
Fall 2020,10/1/2020,Thursday,10:30 AM,11,0,0,0,0,11
Fall 2020,10/1/2020,Thursday,11:30 AM,6,0,1,0,0,7
Fall 2020,10/1/2020,Thursday,12:30 PM,5,0,1,0,0,6
Fall 2020,10/1/2020,Thursday,1:30 PM,4,0,2,0,1,7
Fall 2020,10/1/2020,Thursday,2:30 PM,6,0,1,0,1,8
Fall 2020,10/1/2020,Thursday,3:30 PM,2,0,2,0,4,8
Fall 2020,10/1/2020,Thursday,4:30 PM,4,0,1,0,0,5
Fall 2020,10/1/2020,Thursday,5:30 PM,6,0,1,0,0,7
Fall 2020,10/1/2020,Thursday,6:30 PM,5,0,1,0,0,6
Fall 2020,10/1/2020,Thursday,7:30 PM,4,0,0,0,0,4
Fall 2020,10/2/2020,Friday,7:30 AM,0,0,0,0,0,0
Fall 2020,10/2/2020,Friday,7:30 AM,1,0,0,0,0,1
Fall 2020,10/2/2020,Friday,8:30 AM,2,0,0,0,0,2
Fall 2020,10/2/2020,Friday,9:30 AM,1,0,0,0,2,3
Fall 2020,10/2/2020,Friday,10:30 AM,2,0,0,0,2,4
Fall 2020,10/2/2020,Friday,11:30 AM,2,0,0,0,0,2
Fall 2020,10/2/2020,Friday,11:30 AM,2,0,0,0,0,2
Fall 2020,10/2/2020,Friday,12:30 PM,7,0,0,0,0,7
Fall 2020,10/2/2020,Friday,1:30 PM,6,0,0,0,1,7
Fall 2020,10/2/2020,Friday,2:30 PM,7,0,0,0,1,8
Fall 2020,10/2/2020,Friday,4:30 PM,4,0,0,0,0,4
Fall 2020,10/2/2020,Friday,5:30 PM,0,0,0,0,0,0
Fall 2020,10/2/2020,Friday,6:30 PM,1,0,0,0,0,1
Fall 2020,10/2/2020,Friday,7:30 PM,1,0,0,0,0,1
Fall 2020,10/3/2020,Saturday,10:30 AM,1,0,0,0,0,1
Fall 2020,10/3/2020,Saturday,11:30 AM,1,0,0,0,0,1
Fall 2020,10/3/2020,Saturday,12:30 PM,4,0,0,0,0,4
Fall 2020,10/3/2020,Saturday,1:30 PM,3,0,0,0,0,3
Fall 2020,10/5/2020,Monday,7:30 AM,0,0,0,0,0,0
Fall 2020,10/5/2020,Monday,8:30 AM,0,0,2,0,0,2
Fall 2020,10/5/2020,Monday,9:30 AM,3,0,1,0,0,4
Fall 2020,10/5/2020,Monday,10:30 AM,2,0,0,0,0,2
Fall 2020,10/5/2020,Monday,11:30 AM,5,0,1,0,0,6
Fall 2020,10/5/2020,Monday,1:30 PM,4,0,1,0,0,5
Fall 2020,10/5/2020,Monday,2:30 PM,3,0,0,0,0,3
Fall 2020,10/5/2020,Monday,3:30 PM,4,0,0,0,0,4
Fall 2020,10/5/2020,Monday,3:30 PM,4,0,0,0,0,4
Fall 2020,10/5/2020,Monday,4:30 PM,4,0,0,0,0,4
Fall 2020,10/5/2020,Monday,5:30 PM,5,0,1,0,1,7
Fall 2020,10/5/2020,Monday,6:30 PM,2,0,3,0,0,5
Fall 2020,10/5/2020,Monday,7:30 PM,4,0,3,0,0,7
Fall 2020,10/6/2020,Tuesday,7:30 AM,0,0,0,0,0,0
Fall 2020,10/6/2020,Tuesday,8:30 AM,2,0,0,0,0,2
Fall 2020,10/6/2020,Tuesday,9:30 AM,4,0,0,0,0,4
Fall 2020,10/6/2020,Tuesday,10:30 AM,6,0,0,0,1,7
Fall 2020,10/6/2020,Tuesday,11:30 AM,6,0,0,0,0,6
Fall 2020,10/6/2020,Tuesday,12:30 PM,4,0,2,0,3,9
Fall 2020,10/6/2020,Tuesday,1:30 PM,5,0,0,3,0,8
Fall 2020,10/6/2020,Tuesday,2:30 PM,8,0,2,0,0,10
Fall 2020,10/6/2020,Tuesday,4:30 PM,7,0,1,0,0,8
Fall 2020,10/6/2020,Tuesday,5:30 PM,5,0,0,0,0,5
Fall 2020,10/6/2020,Tuesday,6:30 PM,4,0,0,0,0,4
Fall 2020,10/6/2020,Tuesday,7:30 PM,2,0,0,2,0,4
Fall 2020,10/7/2020,Wednesday,7:30 AM,0,0,0,0,0,0
Fall 2020,10/7/2020,Wednesday,8:30 AM,0,0,0,0,0,0
Fall 2020,10/7/2020,Wednesday,9:30 AM,5,0,0,0,0,5
Fall 2020,10/7/2020,Wednesday,10:30 AM,3,0,0,0,0,3
Fall 2020,10/7/2020,Wednesday,11:30 AM,9,0,1,0,3,13
Fall 2020,10/7/2020,Wednesday,12:30 PM,3,0,1,0,1,5
Fall 2020,10/7/2020,Wednesday,1:30 PM,2,0,1,0,1,4
Fall 2020,10/7/2020,Wednesday,2:30 PM,9,0,2,0,1,12
Fall 2020,10/7/2020,Wednesday,4:30 PM,5,0,0,0,0,5
Fall 2020,10/7/2020,Wednesday,5:30 PM,5,0,0,0,0,5
Fall 2020,10/7/2020,Wednesday,6:30 PM,4,0,0,0,0,4
Fall 2020,10/7/2020,Wednesday,7:30 PM,3,0,0,0,0,3
Fall 2020,10/8/2020,Thursday,7:30 AM,0,0,0,0,0,0
Fall 2020,10/8/2020,Thursday,8:30 AM,2,0,0,0,0,2
Fall 2020,10/8/2020,Thursday,9:30 AM,5,0,0,0,0,5
Fall 2020,10/8/2020,Thursday,10:30 AM,2,0,0,0,1,3
Fall 2020,10/8/2020,Thursday,11:30 AM,4,0,3,0,1,8
Fall 2020,10/8/2020,Thursday,12:30 PM,14,0,1,0,0,15
Fall 2020,10/8/2020,Thursday,1:30 PM,8,0,3,0,1,12
Fall 2020,10/8/2020,Thursday,2:30 PM,9,0,2,0,0,11
Fall 2020,10/8/2020,Thursday,3:30 PM,8,0,0,0,0,8
Fall 2020,10/8/2020,Thursday,4:30 PM,12,0,1,0,0,13
Fall 2020,10/8/2020,Thursday,5:30 PM,6,0,2,0,0,8
Fall 2020,10/8/2020,Thursday,6:30 PM,3,0,0,0,0,3
Fall 2020,10/8/2020,Thursday,7:30 PM,1,0,0,0,0,1
Fall 2020,10/9/2020,Friday,7:30 AM,1,0,0,0,0,1
Fall 2020,10/9/2020,Friday,8:30 AM,2,0,0,0,0,2
Fall 2020,10/9/2020,Friday,9:30 AM,3,0,0,0,0,3
Fall 2020,10/9/2020,Friday,10:30 AM,4,0,0,0,0,4
Fall 2020,10/9/2020,Friday,11:30 AM,4,0,0,0,0,4
Fall 2020,10/9/2020,Friday,12:30 PM,8,0,0,0,1,9
Fall 2020,10/9/2020,Friday,1:30 PM,2,0,0,0,1,3
Fall 2020,10/9/2020,Friday,2:30 PM,3,0,0,0,0,3
Fall 2020,10/9/2020,Friday,4:30 PM,1,0,0,0,1,2
Fall 2020,10/9/2020,Friday,5:30 PM,3,0,0,0,3,6
Fall 2020,10/9/2020,Friday,6:30 PM,2,0,0,0,2,4
Fall 2020,10/9/2020,Friday,7:30 PM,0,0,0,0,1,1
Fall 2020,10/12/2020,Monday,7:30 AM,1,0,0,0,0,1
Fall 2020,10/12/2020,Monday,8:30 AM,1,0,0,0,0,1
Fall 2020,10/12/2020,Monday,9:30 AM,4,0,1,0,0,5
Fall 2020,10/12/2020,Monday,10:30 AM,4,0,1,0,0,5
Fall 2020,10/12/2020,Monday,11:30 AM,8,0,0,0,0,8
Fall 2020,10/12/2020,Monday,12:30 PM,10,0,1,0,1,12
Fall 2020,10/12/2020,Monday,1:30 PM,5,0,3,0,2,10
Fall 2020,10/12/2020,Monday,2:30 PM,4,0,0,0,2,6
Fall 2020,10/12/2020,Monday,3:30 PM,4,0,0,0,0,4
Fall 2020,10/12/2020,Monday,4:30 PM,6,0,0,0,0,6
Fall 2020,10/12/2020,Monday,5:30 PM,1,0,1,0,0,2
Fall 2020,10/12/2020,Monday,6:30 PM,4,0,1,0,0,5
Fall 2020,10/12/2020,Monday,7:30 PM,1,0,1,0,0,2
Fall 2020,10/13/2020,Tuesday,7:30 AM,0,0,0,0,0,0
Fall 2020,10/13/2020,Tuesday,8:30 AM,2,0,0,0,3,5
Fall 2020,10/13/2020,Tuesday,9:30 AM,1,0,0,0,1,2
Fall 2020,10/13/2020,Tuesday,10:30 AM,4,0,0,0,1,5
Fall 2020,10/13/2020,Tuesday,11:30 AM,8,0,1,0,0,9
Fall 2020,10/13/2020,Tuesday,12:30 PM,13,0,2,0,2,17
Fall 2020,10/13/2020,Tuesday,1:30 PM,7,0,0,0,2,9
Fall 2020,10/13/2020,Tuesday,2:30 PM,3,0,0,0,0,3
Fall 2020,10/13/2020,Tuesday,4:30 PM,9,0,0,0,0,9
Fall 2020,10/13/2020,Tuesday,5:30 PM,3,0,1,0,0,4
Fall 2020,10/13/2020,Tuesday,6:30 PM,3,0,1,0,0,4
Fall 2020,10/13/2020,Tuesday,7:30 PM,0,0,1,0,0,1
Fall 2020,10/14/2020,Wednesday,7:30 AM,2,0,0,0,0,2
Fall 2020,10/14/2020,Wednesday,8:30 AM,4,0,0,0,0,4
Fall 2020,10/14/2020,Wednesday,9:30 AM,3,0,0,0,0,3
Fall 2020,10/14/2020,Wednesday,10:30 AM,3,0,1,0,0,4
Fall 2020,10/14/2020,Wednesday,11:30 AM,6,0,1,0,0,7
Fall 2020,10/14/2020,Wednesday,12:30 PM,9,0,1,0,2,12
Fall 2020,10/14/2020,Wednesday,1:30 PM,4,0,1,0,5,10
Fall 2020,10/14/2020,Wednesday,2:30 PM,2,0,1,0,0,3
Fall 2020,10/14/2020,Wednesday,4:30 PM,4,0,3,0,2,9
Fall 2020,10/14/2020,Wednesday,4:30 PM,3,0,2,0,1,6
Fall 2020,10/14/2020,Wednesday,5:30 PM,6,0,3,0,4,13
Fall 2020,10/14/2020,Wednesday,6:30 PM,5,0,2,0,2,9
Fall 2020,10/14/2020,Wednesday,7:30 PM,4,0,1,0,1,6
Fall 2020,10/15/2020,Thursday,7:30 AM,0,0,0,0,0,0
Fall 2020,10/15/2020,Thursday,8:30 AM,1,0,0,0,0,1
Fall 2020,10/15/2020,Thursday,9:30 AM,1,0,0,0,0,1
Fall 2020,10/15/2020,Thursday,10:30 AM,2,0,0,0,0,2
Fall 2020,10/15/2020,Thursday,11:30 AM,3,0,1,0,0,4
Fall 2020,10/15/2020,Thursday,1:30 PM,6,0,2,0,0,8
Fall 2020,10/15/2020,Thursday,3:30 PM,3,0,2,0,0,5
Fall 2020,10/15/2020,Thursday,4:30 PM,6,2,0,0,0,8
Fall 2020,10/15/2020,Thursday,5:30 PM,4,0,0,0,0,4
Fall 2020,10/15/2020,Thursday,6:30 PM,2,0,0,0,0,2
Fall 2020,10/15/2020,Thursday,7:30 PM,1,0,0,0,0,1
Fall 2020,10/16/2020,Friday,7:30 AM,0,0,0,0,0,0
Fall 2020,10/16/2020,Friday,8:30 AM,1,0,0,0,0,1
Fall 2020,10/16/2020,Friday,9:30 AM,1,0,0,0,0,1
Fall 2020,10/16/2020,Friday,10:30 AM,2,0,0,0,0,2
Fall 2020,10/16/2020,Friday,11:30 AM,2,0,0,0,1,3
Fall 2020,10/16/2020,Friday,12:30 PM,5,0,0,0,1,6
Fall 2020,10/16/2020,Friday,1:30 PM,5,0,0,0,0,5
Fall 2020,10/16/2020,Friday,2:30 PM,3,0,0,0,2,5
Fall 2020,10/16/2020,Friday,3:30 PM,5,0,0,0,0,5
Fall 2020,10/16/2020,Friday,4:30 PM,7,0,3,0,4,14
Fall 2020,10/16/2020,Friday,5:30 PM,8,0,3,0,4,15
Fall 2020,10/16/2020,Friday,6:30 PM,5,0,2,0,1,8
Fall 2020,10/16/2020,Friday,7:30 PM,3,0,0,0,1,4
Fall 2020,10/17/2020,Saturday,10:30 AM,2,0,0,0,0,2
Fall 2020,10/17/2020,Saturday,11:30 AM,3,1,2,0,0,6
Fall 2020,10/17/2020,Saturday,12:30 PM,2,0,0,0,0,2
Fall 2020,10/17/2020,Saturday,12:30 PM,2,0,0,0,0,2
Fall 2020,10/17/2020,Saturday,1:30 PM,2,0,0,0,0,2
Fall 2020,10/17/2020,Saturday,2:30 PM,1,0,0,0,0,1
Fall 2020,10/19/2020,Monday,7:30 AM,0,0,0,0,0,0
Fall 2020,10/19/2020,Monday,8:30 AM,3,0,0,0,0,3
Fall 2020,10/19/2020,Monday,9:30 AM,2,0,0,0,0,2
Fall 2020,10/19/2020,Monday,10:30 AM,2,0,0,0,0,2
Fall 2020,10/19/2020,Monday,11:30 AM,6,0,1,0,2,9
Fall 2020,10/19/2020,Monday,12:30 PM,7,0,0,0,2,9
Fall 2020,10/19/2020,Monday,1:30 PM,3,0,1,0,0,4
Fall 2020,10/19/2020,Monday,2:30 PM,4,0,1,0,0,5
Fall 2020,10/19/2020,Monday,3:30 PM,6,0,1,0,1,8
Fall 2020,10/19/2020,Monday,4:30 PM,9,0,2,0,3,14
Fall 2020,10/19/2020,Monday,5:30 PM,2,0,1,0,1,4
Fall 2020,10/19/2020,Monday,6:30 PM,4,0,2,0,2,8
Fall 2020,10/19/2020,Monday,7:30 PM,3,0,1,0,1,5
Fall 2020,10/20/2020,Tuesday,7:30 AM,0,0,0,0,0,0
Fall 2020,10/20/2020,Tuesday,8:30 AM,1,0,0,0,0,1
Fall 2020,10/20/2020,Tuesday,9:30 AM,1,0,0,0,0,1
Fall 2020,10/20/2020,Tuesday,10:30 AM,2,0,0,0,0,2
Fall 2020,10/20/2020,Tuesday,11:30 AM,5,0,1,0,0,6
Fall 2020,10/20/2020,Tuesday,12:30 PM,9,0,0,0,0,9
Fall 2020,10/20/2020,Tuesday,1:30 PM,7,0,2,0,1,10
Fall 2020,10/20/2020,Tuesday,3:30 PM,5,0,3,0,0,8
Fall 2020,10/20/2020,Tuesday,4:30 PM,4,0,2,0,0,6
Fall 2020,10/20/2020,Tuesday,5:30 PM,5,0,0,0,1,6
Fall 2020,10/20/2020,Tuesday,6:30 PM,1,0,0,0,0,1
Fall 2020,10/20/2020,Tuesday,7:30 PM,0,0,0,0,0,0
Fall 2020,10/21/2020,Wednesday,7:30 AM,0,0,0,0,0,0
Fall 2020,10/21/2020,Wednesday,8:30 AM,2,0,1,0,0,3
Fall 2020,10/21/2020,Wednesday,9:30 AM,11,0,0,0,0,11
Fall 2020,10/21/2020,Wednesday,10:30 AM,5,0,0,0,0,5
Fall 2020,10/21/2020,Wednesday,11:30 AM,5,0,0,0,4,9
Fall 2020,10/21/2020,Wednesday,12:30 PM,15,0,0,0,2,17
Fall 2020,10/21/2020,Wednesday,1:30 PM,5,0,1,0,0,6
Fall 2020,10/21/2020,Wednesday,2:30 PM,4,0,1,0,0,5
Fall 2020,10/21/2020,Wednesday,3:30 PM,8,0,0,0,0,8
Fall 2020,10/21/2020,Wednesday,4:30 PM,5,0,2,0,1,8
Fall 2020,10/21/2020,Wednesday,5:30 PM,5,0,2,0,1,8
Fall 2020,10/21/2020,Wednesday,6:30 PM,3,0,2,0,0,5
Fall 2020,10/21/2020,Wednesday,7:30 PM,4,0,0,1,0,5
Fall 2020,10/22/2020,Thursday,7:30 AM,0,0,0,0,0,0
Fall 2020,10/22/2020,Thursday,9:30 AM,4,0,0,0,2,6
Fall 2020,10/22/2020,Thursday,10:30 AM,3,0,0,0,0,3
Fall 2020,10/22/2020,Thursday,11:30 AM,7,0,0,0,0,7
Fall 2020,10/22/2020,Thursday,12:30 PM,6,0,0,0,0,6
Fall 2020,10/22/2020,Thursday,3:30 PM,1,0,0,0,0,1
Fall 2020,10/22/2020,Thursday,4:30 PM,3,0,0,0,0,3
Fall 2020,10/22/2020,Thursday,5:30 PM,4,0,0,0,0,4
Fall 2020,10/22/2020,Thursday,6:30 PM,0,0,0,0,0,0
Fall 2020,10/22/2020,Thursday,7:30 PM,1,0,0,0,0,1
Fall 2020,10/23/2020,Friday,7:30 AM,0,0,0,0,0,0
Fall 2020,10/23/2020,Friday,8:30 AM,2,0,0,0,0,2
Fall 2020,10/23/2020,Friday,9:30 AM,1,0,0,0,1,2
Fall 2020,10/23/2020,Friday,10:30 AM,3,0,1,0,0,4
Fall 2020,10/23/2020,Friday,11:30 AM,6,0,0,0,0,6
Fall 2020,10/23/2020,Friday,12:30 PM,4,0,0,0,1,5
Fall 2020,10/23/2020,Friday,1:30 PM,5,0,0,0,2,7
Fall 2020,10/23/2020,Friday,2:30 PM,8,0,0,0,2,10
Fall 2020,10/23/2020,Friday,3:30 PM,4,0,0,0,0,4
Fall 2020,10/23/2020,Friday,4:30 PM,5,0,0,0,0,5
Fall 2020,10/23/2020,Friday,6:30 PM,2,0,0,0,0,2
Fall 2020,10/23/2020,Friday,7:30 PM,0,0,0,0,0,0
Fall 2020,10/24/2020,Saturday,11:30 AM,1,0,1,0,0,2
Fall 2020,10/24/2020,Saturday,12:30 PM,1,0,1,0,0,2
Fall 2020,10/24/2020,Saturday,1:30 PM,0,0,4,0,0,4
Fall 2020,10/24/2020,Saturday,2:30 PM,2,0,4,0,0,6
Fall 2020,10/26/2020,Monday,7:30 AM,1,0,0,0,0,1
Fall 2020,10/26/2020,Monday,8:30 AM,0,0,0,0,0,0
Fall 2020,10/26/2020,Monday,9:30 AM,3,0,0,0,0,3
Fall 2020,10/26/2020,Monday,10:30 AM,3,0,0,0,0,3
Fall 2020,10/26/2020,Monday,11:30 AM,2,0,0,0,2,4
Fall 2020,10/26/2020,Monday,12:30 PM,2,0,0,0,2,4
Fall 2020,10/26/2020,Monday,12:30 PM,2,0,0,0,0,2
Fall 2020,10/26/2020,Monday,1:30 PM,5,0,0,0,1,6
Fall 2020,10/26/2020,Monday,2:30 PM,3,0,0,0,1,4
Fall 2020,10/26/2020,Monday,3:30 PM,4,0,0,0,1,5
Fall 2020,10/26/2020,Monday,4:30 PM,4,0,2,0,0,6
Fall 2020,10/26/2020,Monday,5:30 PM,2,0,1,0,0,3
Fall 2020,10/26/2020,Monday,6:30 PM,5,0,2,0,0,7
Fall 2020,10/26/2020,Monday,7:30 PM,8,0,4,0,0,12
Fall 2020,10/27/2020,Tuesday,7:30 AM,0,0,0,0,0,0
Fall 2020,10/27/2020,Tuesday,8:30 AM,3,0,0,0,0,3
Fall 2020,10/27/2020,Tuesday,9:30 AM,4,0,0,0,1,5
Fall 2020,10/27/2020,Tuesday,10:30 AM,4,0,0,0,0,4
Fall 2020,10/27/2020,Tuesday,10:30 AM,4,0,0,0,0,4
Fall 2020,10/27/2020,Tuesday,11:30 AM,5,0,0,0,0,5
Fall 2020,10/27/2020,Tuesday,12:30 PM,5,0,0,0,0,5
Fall 2020,10/27/2020,Tuesday,1:30 PM,6,0,3,0,1,10
Fall 2020,10/27/2020,Tuesday,3:30 PM,4,0,2,0,0,6
Fall 2020,10/27/2020,Tuesday,4:30 PM,4,0,1,0,0,5
Fall 2020,10/27/2020,Tuesday,5:30 PM,2,0,0,0,0,2
Fall 2020,10/27/2020,Tuesday,6:30 PM,3,0,1,0,0,4
Fall 2020,10/27/2020,Tuesday,7:30 PM,1,0,0,0,0,1
Fall 2020,10/28/2020,Wednesday,7:30 AM,0,0,0,0,0,0
Fall 2020,10/28/2020,Wednesday,8:30 AM,1,0,0,0,0,1
Fall 2020,10/28/2020,Wednesday,9:30 AM,2,0,0,0,0,2
Fall 2020,10/28/2020,Wednesday,10:30 AM,2,0,0,0,0,2
Fall 2020,10/28/2020,Wednesday,11:30 AM,10,0,0,0,1,11
Fall 2020,10/28/2020,Wednesday,12:30 PM,10,0,0,0,0,10
Fall 2020,10/28/2020,Wednesday,1:30 PM,3,0,0,0,0,3
Fall 2020,10/28/2020,Wednesday,2:30 PM,3,0,0,0,0,3
Fall 2020,10/28/2020,Wednesday,3:30 PM,3,0,0,0,0,3
Fall 2020,10/28/2020,Wednesday,4:30 PM,8,0,3,0,1,12
Fall 2020,10/28/2020,Wednesday,5:30 PM,6,0,3,0,0,9
Fall 2020,10/28/2020,Wednesday,6:30 PM,7,0,0,0,2,9
Fall 2020,10/28/2020,Wednesday,7:30 PM,3,0,1,0,1,5
Fall 2020,10/29/2020,Thursday,7:30 AM,0,0,0,0,0,0
Fall 2020,10/29/2020,Thursday,8:30 AM,3,0,0,0,0,3
Fall 2020,10/29/2020,Thursday,9:30 AM,6,0,0,0,0,6
Fall 2020,10/29/2020,Thursday,10:30 AM,4,0,0,0,0,4
Fall 2020,10/29/2020,Thursday,11:30 AM,4,0,0,0,0,4
Fall 2020,10/29/2020,Thursday,12:30 PM,7,0,0,0,0,7
Fall 2020,10/29/2020,Thursday,1:30 PM,4,0,0,0,0,4
Fall 2020,10/29/2020,Thursday,2:30 PM,3,0,3,0,0,6
Fall 2020,10/29/2020,Thursday,3:30 PM,3,0,1,0,0,4
Fall 2020,10/29/2020,Thursday,3:30 PM,4,0,1,0,2,7
Fall 2020,10/29/2020,Thursday,4:30 PM,4,0,1,0,2,7
Fall 2020,10/29/2020,Thursday,5:30 PM,6,0,2,0,0,8
Fall 2020,10/29/2020,Thursday,6:30 PM,6,0,1,0,0,7
Fall 2020,10/29/2020,Thursday,7:30 PM,2,0,1,0,0,3
Fall 2020,10/30/2020,Friday,7:30 AM,1,0,0,0,0,1
Fall 2020,10/30/2020,Friday,8:30 AM,1,0,0,0,0,1
Fall 2020,10/30/2020,Friday,9:30 AM,2,0,1,0,0,3
Fall 2020,10/30/2020,Friday,10:30 AM,2,0,1,0,0,3
Fall 2020,10/30/2020,Friday,11:30 AM,2,0,0,0,5,7
Fall 2020,10/30/2020,Friday,12:30 PM,3,0,1,0,6,10
Fall 2020,10/30/2020,Friday,1:30 PM,3,0,1,0,1,5
Fall 2020,10/30/2020,Friday,2:30 PM,4,0,2,0,0,6
Fall 2020,10/30/2020,Friday,3:30 PM,2,0,3,0,0,5
Fall 2020,10/30/2020,Friday,4:30 PM,5,0,4,0,2,11
Fall 2020,10/30/2020,Friday,5:30 PM,6,0,2,0,0,8
Fall 2020,10/30/2020,Friday,6:30 PM,5,0,4,0,0,9
Fall 2020,10/30/2020,Friday,6:30 PM,0,0,2,0,0,2
Fall 2020,10/31/2020,Saturday,9:30 AM,0,0,0,0,0,0
Fall 2020,10/31/2020,Saturday,10:30 AM,1,0,0,0,0,1
Fall 2020,10/31/2020,Saturday,11:30 AM,2,0,0,0,0,2
Fall 2020,10/31/2020,Saturday,12:30 PM,2,0,1,0,1,4
Fall 2020,10/31/2020,Saturday,1:30 PM,2,0,1,0,0,3
Fall 2020,10/31/2020,Saturday,2:30 PM,3,0,1,0,0,4
Fall 2020,11/2/2020,Monday,7:30 AM,0,0,0,0,0,0
Fall 2020,11/2/2020,Monday,8:30 AM,1,0,0,0,0,1
Fall 2020,11/2/2020,Monday,9:30 AM,3,0,0,0,0,3
Fall 2020,11/2/2020,Monday,10:30 AM,3,0,0,0,0,3
Fall 2020,11/2/2020,Monday,11:30 AM,4,0,0,0,0,4
Fall 2020,11/2/2020,Monday,11:30 AM,4,0,0,0,0,4
Fall 2020,11/2/2020,Monday,12:30 PM,5,1,2,0,0,8
Fall 2020,11/2/2020,Monday,1:30 PM,2,0,2,0,2,6
Fall 2020,11/2/2020,Monday,2:30 PM,3,0,3,0,1,7
Fall 2020,11/2/2020,Monday,4:30 PM,5,0,4,0,0,9
Fall 2020,11/2/2020,Monday,5:30 PM,1,0,2,0,0,3
Fall 2020,11/2/2020,Monday,6:30 PM,3,0,1,0,0,4
Fall 2020,11/2/2020,Monday,7:30 PM,7,0,0,0,0,7
Fall 2020,11/2/2020,Monday,7:30 PM,2,0,0,0,0,2
Fall 2020,11/4/2020,Wednesday,7:30 AM,1,0,0,0,0,1
Fall 2020,11/4/2020,Wednesday,8:30 AM,1,0,0,0,0,1
Fall 2020,11/4/2020,Wednesday,9:30 AM,1,0,1,0,1,3
Fall 2020,11/4/2020,Wednesday,10:30 AM,4,0,0,0,0,4
Fall 2020,11/4/2020,Wednesday,11:30 AM,7,0,0,0,1,8
Fall 2020,11/4/2020,Wednesday,12:30 PM,13,0,0,0,0,13
Fall 2020,11/4/2020,Wednesday,1:30 PM,6,0,1,0,0,7
Fall 2020,11/4/2020,Wednesday,2:30 PM,4,0,0,0,1,5
Fall 2020,11/4/2020,Wednesday,3:30 PM,3,0,3,0,0,6
Fall 2020,11/4/2020,Wednesday,4:30 PM,8,0,0,0,0,8
Fall 2020,11/4/2020,Wednesday,5:30 PM,6,0,1,0,1,8
Fall 2020,11/4/2020,Wednesday,6:30 PM,9,0,2,0,1,12
Fall 2020,11/4/2020,Wednesday,7:30 PM,6,0,1,0,0,7
Fall 2020,11/5/2020,Thursday,7:30 AM,0,0,0,0,0,0
Fall 2020,11/5/2020,Thursday,7:30 AM,2,0,0,0,0,2
Fall 2020,11/5/2020,Thursday,8:30 AM,2,0,0,0,0,2
Fall 2020,11/5/2020,Thursday,9:30 AM,7,0,0,0,0,7
Fall 2020,11/5/2020,Thursday,10:30 AM,6,0,0,0,0,6
Fall 2020,11/5/2020,Thursday,11:30 AM,7,0,1,0,0,8
Fall 2020,11/5/2020,Thursday,12:30 PM,3,0,0,0,2,5
Fall 2020,11/5/2020,Thursday,1:30 PM,2,0,0,0,3,5
Fall 2020,11/5/2020,Thursday,2:30 PM,4,0,0,0,0,4
Fall 2020,11/5/2020,Thursday,3:30 PM,1,0,2,0,1,4
Fall 2020,11/5/2020,Thursday,4:30 PM,2,0,1,0,0,3
Fall 2020,11/5/2020,Thursday,5:30 PM,3,0,2,0,0,5
Fall 2020,11/5/2020,Thursday,6:30 PM,4,0,2,0,0,6
Fall 2020,11/5/2020,Thursday,7:30 PM,1,0,2,0,0,3
Fall 2020,11/6/2020,Friday,7:30 AM,0,0,0,0,0,0
Fall 2020,11/6/2020,Friday,8:30 AM,3,0,0,0,0,3
Fall 2020,11/6/2020,Friday,9:30 AM,6,0,0,0,0,6
Fall 2020,11/6/2020,Friday,10:30 AM,3,0,0,0,0,3
Fall 2020,11/6/2020,Friday,11:30 AM,5,0,0,0,0,5
Fall 2020,11/6/2020,Friday,12:30 PM,5,0,0,0,1,6
Fall 2020,11/6/2020,Friday,1:30 PM,3,0,0,0,0,3
Fall 2020,11/6/2020,Friday,3:30 PM,3,0,0,0,0,3
Fall 2020,11/6/2020,Friday,4:30 PM,2,0,0,0,1,3
Fall 2020,11/6/2020,Friday,5:30 PM,1,0,1,0,0,2
Fall 2020,11/6/2020,Friday,6:30 PM,0,0,0,0,0,0
Fall 2020,11/6/2020,Friday,7:30 PM,0,0,0,0,0,0
Fall 2020,11/7/2020,Saturday,8:30 AM,1,0,0,0,0,1
Fall 2020,11/7/2020,Saturday,9:30 AM,1,0,0,0,0,1
Fall 2020,11/7/2020,Saturday,10:30 AM,1,0,1,0,0,2
Fall 2020,11/7/2020,Saturday,12:30 PM,3,2,0,0,0,5
Fall 2020,11/7/2020,Saturday,1:30 PM,0,0,1,0,0,1
Fall 2020,11/7/2020,Saturday,2:30 PM,0,0,2,0,0,2
Fall 2020,11/9/2020,Monday,7:30 AM,2,0,0,0,0,2
Fall 2020,11/9/2020,Monday,8:30 AM,2,0,0,0,0,2
Fall 2020,11/9/2020,Monday,9:30 AM,1,0,0,0,0,1
Fall 2020,11/9/2020,Monday,10:30 AM,3,0,0,0,1,4
Fall 2020,11/9/2020,Monday,11:30 AM,2,0,2,0,0,4
Fall 2020,11/9/2020,Monday,12:30 PM,9,0,0,0,0,9
Fall 2020,11/9/2020,Monday,1:30 PM,7,0,0,0,2,9
Fall 2020,11/9/2020,Monday,2:30 PM,4,0,2,0,1,7
Fall 2020,11/9/2020,Monday,4:30 PM,2,0,0,0,2,4
Fall 2020,11/9/2020,Monday,5:30 PM,2,0,0,0,0,2
Fall 2020,11/9/2020,Monday,6:30 PM,3,0,0,0,0,3
Fall 2020,11/9/2020,Monday,7:30 PM,2,0,0,0,0,2
Fall 2020,11/10/2020,Tuesday,7:30 AM,1,0,0,0,0,1
Fall 2020,11/10/2020,Tuesday,10:30 AM,1,0,0,0,0,1
Fall 2020,11/10/2020,Tuesday,11:30 AM,4,0,0,0,1,5
Fall 2020,11/10/2020,Tuesday,12:30 PM,6,0,0,0,2,8
Fall 2020,11/10/2020,Tuesday,12:30 PM,6,0,0,0,2,8
Fall 2020,11/10/2020,Tuesday,1:30 PM,5,0,0,0,1,6
Fall 2020,11/10/2020,Tuesday,2:30 PM,5,0,0,0,1,6
Fall 2020,11/10/2020,Tuesday,2:30 PM,7,0,1,0,0,8
Fall 2020,11/10/2020,Tuesday,4:30 PM,5,0,0,0,0,5
Fall 2020,11/10/2020,Tuesday,5:30 PM,2,0,0,0,0,2
Fall 2020,11/10/2020,Tuesday,6:30 PM,3,0,2,0,0,5
Fall 2020,11/10/2020,Tuesday,7:30 PM,1,0,2,0,0,3
Fall 2020,11/11/2020,Wednesday,7:30 AM,1,0,0,0,0,1
Fall 2020,11/11/2020,Wednesday,8:30 AM,1,0,0,0,0,1
Fall 2020,11/11/2020,Wednesday,9:30 AM,0,0,0,0,0,0
Fall 2020,11/11/2020,Wednesday,10:30 AM,4,0,1,0,1,6
Fall 2020,11/11/2020,Wednesday,11:30 AM,6,0,2,0,0,8
Fall 2020,11/11/2020,Wednesday,12:30 PM,6,0,1,0,1,8
Fall 2020,11/11/2020,Wednesday,1:30 PM,2,0,0,0,2,4
Fall 2020,11/11/2020,Wednesday,3:30 PM,7,0,2,0,2,11
Fall 2020,11/11/2020,Wednesday,4:30 PM,3,0,1,0,1,5
Fall 2020,11/11/2020,Wednesday,5:30 PM,5,0,1,0,0,6
Fall 2020,11/11/2020,Wednesday,6:30 PM,2,0,1,0,0,3
Fall 2020,11/11/2020,Wednesday,7:30 PM,1,0,1,0,0,2
Fall 2020,11/12/2020,Thursday,7:30 AM,0,0,0,0,0,0
Fall 2020,11/12/2020,Thursday,8:30 AM,1,0,0,0,0,1
Fall 2020,11/12/2020,Thursday,11:30 AM,9,0,1,0,0,10
Fall 2020,11/12/2020,Thursday,12:30 PM,5,0,2,0,0,7
Fall 2020,11/12/2020,Thursday,1:30 PM,8,0,3,0,2,13
Fall 2020,11/12/2020,Thursday,2:30 PM,1,0,3,0,2,6
Fall 2020,11/12/2020,Thursday,3:30 PM,5,0,4,0,0,9
Fall 2020,11/12/2020,Thursday,4:30 PM,2,0,3,0,0,5
Fall 2020,11/12/2020,Thursday,5:30 PM,4,0,2,0,0,6
Fall 2020,11/12/2020,Thursday,6:30 PM,3,0,1,0,0,4
Fall 2020,11/12/2020,Thursday,7:30 PM,3,0,1,0,0,4
Fall 2020,11/13/2020,Friday,7:30 AM,0,0,0,0,0,0
Fall 2020,11/13/2020,Friday,8:30 AM,2,0,0,0,0,2
Fall 2020,11/13/2020,Friday,9:30 AM,2,0,0,0,0,2
Fall 2020,11/13/2020,Friday,10:30 AM,4,0,0,0,0,4
Fall 2020,11/13/2020,Friday,11:30 AM,6,0,1,0,0,7
Fall 2020,11/13/2020,Friday,1:30 PM,5,0,1,0,0,6
Fall 2020,11/13/2020,Friday,4:30 PM,0,0,1,0,0,1
Fall 2020,11/13/2020,Friday,5:30 PM,1,0,0,0,1,2
Fall 2020,11/13/2020,Friday,6:30 PM,1,0,0,0,1,2
Fall 2020,11/13/2020,Friday,7:30 PM,1,0,0,0,0,1
Fall 2020,11/14/2020,Saturday,9:30 AM,0,0,0,0,0,0
Fall 2020,11/14/2020,Saturday,10:30 AM,0,0,0,0,0,0
Fall 2020,11/14/2020,Saturday,11:30 AM,2,0,0,0,0,2
Fall 2020,11/14/2020,Saturday,12:30 PM,3,0,1,0,0,4
Fall 2020,11/14/2020,Saturday,1:30 PM,6,0,1,0,0,7
Fall 2020,11/16/2020,Monday,7:30 AM,0,0,0,0,0,0
Fall 2020,11/16/2020,Monday,8:30 AM,0,0,0,0,1,1
Fall 2020,11/16/2020,Monday,9:30 AM,1,0,0,0,0,1
Fall 2020,11/16/2020,Monday,10:30 AM,4,0,1,0,0,5
Fall 2020,11/16/2020,Monday,11:30 AM,7,0,1,0,0,8
Fall 2020,11/16/2020,Monday,3:30 PM,1,1,0,0,0,2
Fall 2020,11/16/2020,Monday,4:30 PM,1,0,0,0,0,1
Fall 2020,11/16/2020,Monday,4:30 PM,1,0,1,0,1,3
Fall 2020,11/16/2020,Monday,5:30 PM,1,0,0,0,0,1
Fall 2020,11/16/2020,Monday,5:30 PM,1,0,1,0,0,2
Fall 2020,11/16/2020,Monday,6:30 PM,0,0,0,0,0,0
Fall 2020,11/16/2020,Monday,7:30 PM,0,0,0,0,0,0
Fall 2020,11/17/2020,Tuesday,7:30 AM,0,0,0,0,0,0
Fall 2020,11/17/2020,Tuesday,9:30 AM,4,0,0,0,0,4
Fall 2020,11/17/2020,Tuesday,11:30 AM,6,0,1,0,3,10
Fall 2020,11/17/2020,Tuesday,12:30 PM,8,0,0,0,2,10
Fall 2020,11/17/2020,Tuesday,1:30 PM,3,0,0,0,1,4
Fall 2020,11/17/2020,Tuesday,2:30 PM,2,0,1,0,0,3
Fall 2020,11/17/2020,Tuesday,3:30 PM,1,0,1,0,0,2
Fall 2020,11/17/2020,Tuesday,4:30 PM,4,0,2,0,0,6
Fall 2020,11/17/2020,Tuesday,5:30 PM,0,0,1,0,0,1
Fall 2020,11/17/2020,Tuesday,6:30 PM,2,0,1,0,0,3
Fall 2020,11/17/2020,Tuesday,7:30 PM,2,0,0,0,0,2
Fall 2020,11/18/2020,Wednesday,7:30 AM,0,0,0,0,0,0
Fall 2020,11/18/2020,Wednesday,8:30 AM,2,0,0,0,0,2
Fall 2020,11/18/2020,Wednesday,9:30 AM,2,0,0,0,0,2
Fall 2020,11/18/2020,Wednesday,10:30 AM,3,0,0,0,0,3
Fall 2020,11/18/2020,Wednesday,11:30 AM,3,0,0,0,0,3
Fall 2020,11/18/2020,Wednesday,12:30 PM,4,0,0,0,0,4
Fall 2020,11/18/2020,Wednesday,1:30 PM,3,0,0,0,0,3
Fall 2020,11/18/2020,Wednesday,4:30 PM,3,0,0,0,0,3
Fall 2020,11/18/2020,Wednesday,5:30 PM,3,0,0,0,0,3
Fall 2020,11/18/2020,Wednesday,6:30 PM,3,0,0,0,0,3
Fall 2020,11/18/2020,Wednesday,7:30 PM,0,0,0,0,0,0
Fall 2020,11/19/2020,Thursday,7:30 AM,0,0,0,0,0,0
Fall 2020,11/19/2020,Thursday,8:30 AM,2,0,0,0,0,2
Fall 2020,11/19/2020,Thursday,9:30 AM,0,0,0,0,0,0
Fall 2020,11/19/2020,Thursday,10:30 AM,4,0,0,0,1,5
Fall 2020,11/19/2020,Thursday,11:30 AM,4,0,0,0,1,5
Fall 2020,11/19/2020,Thursday,12:30 PM,4,0,0,0,1,5
Fall 2020,11/19/2020,Thursday,1:30 PM,3,0,0,0,1,4
Fall 2020,11/19/2020,Thursday,2:30 PM,2,0,0,0,1,3
Fall 2020,11/19/2020,Thursday,1:30 PM,2,0,0,0,2,4
Fall 2020,11/19/2020,Thursday,3:30 PM,1,0,0,0,1,2
Fall 2020,11/19/2020,Thursday,4:30 PM,3,0,0,0,0,3
Fall 2020,11/19/2020,Thursday,5:30 PM,2,0,1,0,0,3
Fall 2020,11/19/2020,Thursday,6:30 PM,1,0,1,0,0,2
Fall 2020,11/19/2020,Thursday,7:30 PM,0,0,2,0,0,2
Fall 2020,11/20/2020,Friday,7:30 AM,1,0,0,0,0,1
Fall 2020,11/20/2020,Friday,8:30 AM,3,0,0,0,0,3
Fall 2020,11/20/2020,Friday,9:30 AM,3,0,0,0,0,3
Fall 2020,11/20/2020,Friday,10:30 AM,3,0,0,0,0,3
Fall 2020,11/20/2020,Friday,11:30 AM,6,0,0,0,1,7
Fall 2020,11/20/2020,Friday,12:30 PM,6,1,0,0,1,8
Fall 2020,11/20/2020,Friday,1:30 PM,2,1,0,0,1,4
Fall 2020,11/20/2020,Friday,2:30 PM,2,0,0,0,0,2
Fall 2020,11/20/2020,Friday,4:30 PM,4,0,0,0,0,4
Fall 2020,11/20/2020,Friday,6:30 PM,0,0,0,0,0,0
Fall 2020,11/20/2020,Friday,7:30 PM,1,0,0,0,0,1
Fall 2020,11/21/2020,Saturday,9:30 AM,0,0,0,0,0,0
Fall 2020,11/21/2020,Saturday,10:30 AM,0,0,0,0,0,0
Fall 2020,11/21/2020,Saturday,11:30 AM,1,0,0,0,0,1
Fall 2020,11/21/2020,Saturday,12:30 PM,1,0,0,0,0,1
Fall 2020,11/21/2020,Saturday,1:30 PM,2,0,2,0,0,4
Fall 2020,11/21/2020,Saturday,2:30 PM,0,0,1,0,0,1
Fall 2020,11/23/2020,Monday,7:30 AM,0,0,0,0,0,0
Fall 2020,11/23/2020,Monday,8:30 AM,0,0,0,0,0,0
Fall 2020,11/23/2020,Monday,9:30 AM,4,0,0,0,0,4
Fall 2020,11/23/2020,Monday,10:30 AM,1,0,0,0,0,1
Fall 2020,11/23/2020,Monday,11:30 AM,2,0,0,0,0,2
Fall 2020,11/23/2020,Monday,12:30 PM,2,0,0,0,0,0
Fall 2020,11/23/2020,Monday,1:30 PM,0,1,0,0,0,1
Fall 2020,11/23/2020,Monday,2:30 PM,0,0,0,0,0,0
Fall 2020,11/23/2020,Monday,3:30 PM,2,0,0,0,0,2
Fall 2020,11/23/2020,Monday,4:30 PM,6,0,0,0,1,7
Fall 2020,11/23/2020,Monday,5:30 PM,3,0,0,0,2,5
Fall 2020,11/23/2020,Monday,6:30 PM,4,0,0,0,2,6
Fall 2020,11/23/2020,Monday,7:30 PM,3,0,1,0,0,4
Fall 2020,11/24/2020,Tuesday,7:30 AM,0,0,0,0,0,0
Fall 2020,11/24/2020,Tuesday,8:30 AM,1,0,0,0,0,1
Fall 2020,11/24/2020,Tuesday,9:30 AM,1,0,0,0,0,1
Fall 2020,11/24/2020,Tuesday,10:30 AM,0,0,0,0,0,0
Fall 2020,11/24/2020,Tuesday,11:30 AM,2,0,1,0,0,3
Fall 2020,11/24/2020,Tuesday,12:30 PM,1,0,0,0,3,4
Fall 2020,11/24/2020,Tuesday,1:30 PM,3,0,0,0,1,4
Fall 2020,11/24/2020,Tuesday,2:30 PM,5,0,0,0,0,5
Fall 2020,11/24/2020,Tuesday,3:30 PM,1,0,0,1,0,2
Fall 2020,11/24/2020,Tuesday,4:30 PM,3,0,0,0,2,5
Fall 2020,11/24/2020,Tuesday,5:30 PM,0,0,0,0,0,0
Fall 2020,11/24/2020,Tuesday,6:30 PM,2,0,1,0,0,3
Fall 2020,11/24/2020,Tuesday,7:30 PM,0,0,1,0,0,1
Fall 2020,11/30/2020,Monday,7:30 AM,0,0,0,0,0,0
Fall 2020,11/30/2020,Monday,8:30 AM,1,0,0,0,0,1
Fall 2020,11/30/2020,Monday,9:30 AM,3,0,0,0,0,3
Fall 2020,11/30/2020,Monday,10:30 AM,2,0,0,0,0,2
Fall 2020,11/30/2020,Monday,11:30 AM,4,0,0,0,0,4
Fall 2020,11/30/2020,Monday,12:30 PM,2,0,0,0,0,2
Fall 2020,11/30/2020,Monday,1:30 PM,3,1,1,0,3,8
Fall 2020,11/30/2020,Monday,2:30 PM,5,0,0,0,2,7
Fall 2020,11/30/2020,Monday,3:30 PM,5,1,1,1,0,8
Fall 2020,11/30/2020,Monday,4:30 PM,3,0,0,0,1,4
Fall 2020,11/30/2020,Monday,5:30 PM,1,0,0,0,1,2
Fall 2020,11/30/2020,Monday,6:30 PM,1,0,0,0,1,2
Fall 2020,11/30/2020,Monday,7:30 PM,1,0,1,0,1,3
Fall 2020,12/1/2020,Tuesday,7:30 AM,0,0,0,0,0,0
Fall 2020,12/1/2020,Tuesday,8:30 AM,2,0,0,0,0,2
Fall 2020,12/1/2020,Tuesday,9:30 AM,2,0,0,0,0,2
Fall 2020,12/1/2020,Tuesday,10:30 AM,4,0,0,0,0,4
Fall 2020,12/1/2020,Tuesday,11:30 AM,3,0,0,0,1,4
Fall 2020,12/1/2020,Tuesday,12:30 PM,1,0,0,1,1,3
Fall 2020,12/1/2020,Tuesday,1:30 PM,3,0,2,0,0,5
Fall 2020,12/1/2020,Tuesday,2:30 PM,2,0,1,0,1,4
Fall 2020,12/1/2020,Tuesday,1:30 PM,2,1,0,0,0,3
Fall 2020,12/1/2020,Tuesday,2:30 PM,1,0,1,0,2,4
Fall 2020,12/1/2020,Tuesday,3:30 PM,4,0,0,1,1,6
Fall 2020,12/1/2020,Tuesday,4:30 PM,3,0,1,0,0,4
Fall 2020,12/1/2020,Tuesday,5:30 PM,2,0,1,0,0,3
Fall 2020,12/1/2020,Tuesday,6:30 PM,2,0,0,0,0,2
Fall 2020,12/1/2020,Tuesday,7:30 PM,1,0,0,0,0,1
Fall 2020,12/2/2020,Wednesday,9:30 AM,1,0,0,0,0,1
Fall 2020,12/2/2020,Wednesday,10:30 AM,1,0,0,0,0,1
Fall 2020,12/2/2020,Wednesday,11:30 AM,3,0,0,0,1,4
Fall 2020,12/2/2020,Wednesday,12:30 PM,1,0,0,0,1,2
Fall 2020,12/2/2020,Wednesday,1:30 PM,3,0,0,0,1,4
Fall 2020,12/2/2020,Wednesday,2:30 PM,2,0,0,0,2,4
Fall 2020,12/2/2020,Wednesday,3:30 PM,3,0,0,0,0,3
Fall 2020,12/2/2020,Wednesday,4:30 PM,0,0,0,0,0,0
Fall 2020,12/2/2020,Wednesday,5:30 PM,2,0,0,0,3,5
Fall 2020,12/2/2020,Wednesday,6:30 PM,0,0,0,0,0,0
Fall 2020,12/2/2020,Wednesday,7:30 PM,0,0,0,0,0,0
Fall 2020,12/3/2020,Thursday,7:30 AM,0,0,0,0,0,0
Fall 2020,12/3/2020,Thursday,8:30 AM,1,0,0,0,0,1
Fall 2020,12/3/2020,Thursday,9:30 AM,1,0,0,0,0,1
Fall 2020,12/3/2020,Thursday,11:30 AM,1,0,0,0,0,1
Fall 2020,12/3/2020,Thursday,12:30 PM,3,0,0,0,1,4
Fall 2020,12/3/2020,Thursday,1:30 PM,5,0,0,0,1,6
Fall 2020,12/3/2020,Thursday,2:30 PM,1,0,0,1,1,3
Fall 2020,12/3/2020,Thursday,3:30 PM,2,0,0,0,0,2
Fall 2020,12/3/2020,Thursday,4:30 PM,1,0,0,0,0,1
Fall 2020,12/3/2020,Thursday,5:30 PM,1,0,0,0,0,1
Fall 2020,12/3/2020,Thursday,6:30 PM,0,0,0,0,0,0
Fall 2020,12/3/2020,Thursday,7:30 PM,0,0,0,0,0,0
Fall 2020,12/4/2020,Friday,7:30 AM,1,0,0,0,0,1
Fall 2020,12/4/2020,Friday,8:30 AM,1,0,0,0,0,1
Fall 2020,12/4/2020,Friday,9:30 AM,2,0,0,0,0,2
Fall 2020,12/4/2020,Friday,10:30 AM,2,0,0,0,0,2
Fall 2020,12/4/2020,Friday,11:30 AM,2,0,0,0,0,2
Fall 2020,12/4/2020,Friday,12:30 PM,4,0,0,0,1,5
Fall 2020,12/4/2020,Friday,1:30 PM,1,0,0,0,0,1
Fall 2020,12/4/2020,Friday,2:30 PM,1,0,1,0,1,3
Fall 2020,12/4/2020,Friday,3:30 PM,4,0,1,0,1,6
Fall 2020,12/4/2020,Friday,6:30 PM,0,0,0,0,0,0
Fall 2020,12/4/2020,Friday,7:30 PM,0,0,0,0,0,0
Fall 2020,12/5/2020,Saturday,10:30 AM,1,0,0,0,0,1
Fall 2020,12/5/2020,Saturday,11:30 AM,0,0,2,0,0,2
Fall 2020,12/7/2020,Monday,7:30 AM,0,0,0,0,0,0
Fall 2020,12/7/2020,Monday,8:30 AM,1,0,0,0,0,1
Fall 2020,12/7/2020,Monday,9:30 AM,1,0,0,0,0,1
Fall 2020,12/7/2020,Monday,10:30 AM,4,0,0,0,0,4
Fall 2020,12/7/2020,Monday,11:30 AM,1,0,0,0,0,1
Fall 2020,12/7/2020,Monday,12:30 PM,0,0,0,0,1,1
Fall 2020,12/7/2020,Monday,1:30 PM,1,0,0,0,1,2
Fall 2020,12/7/2020,Monday,2:30 PM,2,0,0,0,1,3
Fall 2020,12/7/2020,Monday,3:30 PM,4,0,1,0,0,5
Fall 2020,12/7/2020,Monday,4:30 PM,3,0,0,0,3,6
Fall 2020,12/7/2020,Monday,5:30 PM,2,0,0,0,3,5
Fall 2020,12/7/2020,Monday,6:30 PM,3,0,0,0,3,6
Fall 2020,12/7/2020,Monday,7:30 PM,0,0,0,0,1,1
Fall 2020,12/8/2020,Tuesday,7:30 AM,0,0,0,0,0,0
Fall 2020,12/8/2020,Tuesday,8:30 AM,1,0,0,0,0,1
Fall 2020,12/8/2020,Tuesday,9:30 AM,3,0,0,0,2,5
Fall 2020,12/8/2020,Tuesday,10:30 AM,1,0,0,0,2,3
Fall 2020,12/8/2020,Tuesday,11:30 AM,3,0,0,0,0,3
Fall 2020,12/8/2020,Tuesday,12:30 PM,3,0,0,0,2,5
Fall 2020,12/8/2020,Tuesday,1:30 PM,4,0,1,0,1,6
Fall 2020,12/8/2020,Tuesday,2:30 PM,4,0,1,0,0,5
Fall 2020,12/8/2020,Tuesday,3:30 PM,3,0,1,0,0,4
Fall 2020,12/8/2020,Tuesday,4:30 PM,5,0,1,0,1,7
Fall 2020,12/8/2020,Tuesday,5:30 PM,6,0,0,0,0,6
Fall 2020,12/8/2020,Tuesday,6:30 PM,2,0,0,0,0,2
Fall 2020,12/8/2020,Tuesday,7:30 PM,2,0,0,0,0,2
Fall 2020,12/9/2020,Wednesday,7:30 AM,0,0,0,0,0,0
Fall 2020,12/9/2020,Wednesday,8:30 AM,2,0,0,0,0,2
Fall 2020,12/9/2020,Wednesday,9:30 AM,2,0,0,0,0,2
Fall 2020,12/9/2020,Wednesday,10:30 AM,4,0,0,0,0,4
Fall 2020,12/9/2020,Wednesday,11:30 AM,3,1,0,0,1,5
Fall 2020,12/9/2020,Wednesday,12:30 PM,2,0,0,0,0,2
Fall 2020,12/9/2020,Wednesday,1:30 PM,2,0,0,0,0,2
Fall 2020,12/9/2020,Wednesday,2:30 PM,2,0,0,0,0,2
Fall 2020,12/9/2020,Wednesday,4:30 PM,3,0,0,0,1,4
Fall 2020,12/9/2020,Wednesday,5:30 PM,1,0,0,0,1,2
Fall 2020,12/9/2020,Wednesday,6:30 PM,0,0,0,0,1,1
Fall 2020,12/9/2020,Wednesday,7:30 PM,2,0,0,0,0,2
Fall 2020,12/10/2020,Thursday,7:30 AM,0,0,0,0,0,0
Fall 2020,12/10/2020,Thursday,8:30 AM,0,0,0,0,2,2
Fall 2020,12/10/2020,Thursday,9:30 AM,1,0,0,0,2,3
Fall 2020,12/10/2020,Thursday,10:30 AM,3,0,0,0,2,5
Fall 2020,12/10/2020,Thursday,11:30 AM,3,0,0,0,0,3
Fall 2020,12/10/2020,Thursday,12:30 PM,4,0,0,0,0,4
Fall 2020,12/10/2020,Thursday,1:30 PM,2,0,0,0,0,2
Fall 2020,12/10/2020,Thursday,2:30 PM,1,0,0,0,0,1
Fall 2020,12/10/2020,Thursday,2:30 PM,1,0,0,2,0,3
Fall 2020,12/10/2020,Thursday,3:30 PM,1,0,0,2,0,3
Fall 2020,12/10/2020,Thursday,4:30 PM,2,0,0,0,0,2
Fall 2020,12/10/2020,Thursday,5:30 PM,5,0,0,0,0,5
Fall 2020,12/10/2020,Thursday,6:30 PM,5,0,0,0,0,5
Fall 2020,12/10/2020,Thursday,7:30 PM,4,0,2,0,0,6
Fall 2020,12/11/2020,Friday,7:30 AM,1,0,0,0,0,1
Fall 2020,12/11/2020,Friday,8:30 AM,1,0,0,0,0,1
Fall 2020,12/11/2020,Friday,9:30 AM,2,0,0,0,0,2
Fall 2020,12/11/2020,Friday,10:30 AM,1,0,1,0,0,2
Fall 2020,12/11/2020,Friday,11:30 AM,2,0,0,0,0,2
Fall 2020,12/11/2020,Friday,12:30 PM,3,0,0,0,0,3
Fall 2020,12/11/2020,Friday,1:30 PM,4,0,0,0,0,4
Fall 2020,12/11/2020,Friday,2:30 PM,3,0,0,0,0,3
Fall 2020,12/11/2020,Friday,3:30 PM,2,0,1,0,0,3
Fall 2020,12/11/2020,Friday,4:30 PM,2,0,0,0,0,2
Fall 2020,12/11/2020,Friday,5:30 PM,3,0,0,0,1,4
Fall 2020,12/11/2020,Friday,6:30 PM,2,0,0,0,1,3
Winter Intersession 2020,12/15/2020,Tuesday,9:30 AM,2,0,0,0,0,2
Winter Intersession 2020,12/15/2020,Tuesday,10:30 AM,4,0,0,0,0,4
Winter Intersession 2020,12/15/2020,Tuesday,11:30 AM,2,0,0,0,0,2
Winter Intersession 2020,12/15/2020,Tuesday,1:30 PM,1,0,0,0,0,1
Winter Intersession 2020,12/15/2020,Tuesday,12:30 PM,1,0,0,0,0,1
Winter Intersession 2020,12/15/2020,Tuesday,1:30 PM,1,0,0,0,0,1
Winter Intersession 2020,12/15/2020,Tuesday,2:30 PM,2,0,0,0,0,2
Winter Intersession 2020,12/15/2020,Tuesday,2:30 PM,1,0,0,0,0,1
Winter Intersession 2020,12/15/2020,Tuesday,3:30 PM,3,0,0,0,0,3
Winter Intersession 2020,12/15/2020,Tuesday,4:30 PM,4,0,0,0,1,5
Winter Intersession 2020,12/15/2020,Tuesday,5:30 PM,0,0,0,0,0,0
Winter Intersession 2020,12/16/2020,Wednesday,9:30 AM,0,0,0,0,0,0
Winter Intersession 2020,12/16/2020,Wednesday,10:30 AM,2,0,0,0,0,2
Winter Intersession 2020,12/16/2020,Wednesday,11:30 AM,0,0,0,0,0,0
Winter Intersession 2020,12/16/2020,Wednesday,12:30 PM,0,0,0,0,0,0
Winter Intersession 2020,12/16/2020,Wednesday,1:30 PM,0,0,0,0,0,0
Winter Intersession 2020,12/16/2020,Wednesday,2:30 PM,0,0,0,0,0,0
Winter Intersession 2020,12/16/2020,Wednesday,3:30 PM,1,0,0,0,0,1
Winter Intersession 2020,12/16/2020,Wednesday,4:30 PM,1,0,0,0,0,1
Winter Intersession 2020,12/16/2020,Wednesday,5:30 PM,2,0,0,0,0,2
Winter Intersession 2020,12/17/2020,Thursday,9:30 AM,1,0,0,0,0,1
Winter Intersession 2020,12/17/2020,Thursday,10:30 AM,2,0,0,0,0,2
Winter Intersession 2020,12/17/2020,Thursday,11:30 AM,1,0,0,0,0,1
Winter Intersession 2020,12/17/2020,Thursday,1:30 PM,1,0,0,0,0,1
Winter Intersession 2020,12/17/2020,Thursday,2:30 PM,0,0,0,0,0,0
Winter Intersession 2020,12/17/2020,Thursday,3:30 PM,1,0,0,0,0,1
Winter Intersession 2020,12/17/2020,Thursday,4:30 PM,1,0,0,0,0,1
Winter Intersession 2020,12/17/2020,Thursday,5:30 PM,1,0,0,0,0,1
Winter Intersession 2020,12/18/2020,Friday,9:30 AM,1,0,0,0,0,1
Winter Intersession 2020,12/18/2020,Friday,10:30 AM,4,0,0,1,0,5
Winter Intersession 2020,12/18/2020,Friday,12:30 PM,0,0,0,0,0,0
Winter Intersession 2020,12/18/2020,Friday,1:30 PM,0,0,0,0,0,0
Winter Intersession 2020,12/18/2020,Friday,2:30 PM,0,0,0,0,0,0
Winter Intersession 2020,12/18/2020,Friday,3:30 PM,0,0,0,0,0,0
Winter Intersession 2020,12/18/2020,Friday,4:30 PM,0,0,0,0,0,0
Winter Intersession 2020,12/21/2020,Monday,9:30 AM,0,0,0,0,0,0
Winter Intersession 2020,12/21/2020,Monday,10:30 AM,0,0,0,0,0,0
Winter Intersession 2020,12/21/2020,Monday,11:30 AM,1,0,0,0,0,1
Winter Intersession 2020,12/21/2020,Monday,12:30 PM,1,0,0,0,0,1
Winter Intersession 2020,12/21/2020,Monday,12:30 PM,1,0,0,0,0,1
Winter Intersession 2020,12/21/2020,Monday,2:30 PM,1,0,0,0,0,1
Winter Intersession 2020,12/21/2020,Monday,1:30 PM,1,0,0,0,0,1
Winter Intersession 2020,12/21/2020,Monday,2:30 PM,1,0,0,0,0,1
Winter Intersession 2020,12/21/2020,Monday,3:30 PM,2,0,0,0,0,2
Winter Intersession 2020,12/21/2020,Monday,4:30 PM,0,0,0,0,0,0
Winter Intersession 2020,12/21/2020,Monday,5:30 PM,0,0,0,0,0,0
Winter Intersession 2020,12/22/2020,Tuesday,9:30 AM,0,0,0,2,0,2
Winter Intersession 2020,12/22/2020,Tuesday,10:30 AM,0,0,0,0,0,0
Winter Intersession 2020,12/22/2020,Tuesday,11:30 AM,0,0,0,0,0,0
Winter Intersession 2020,12/22/2020,Tuesday,12:30 PM,1,0,0,0,0,1
Winter Intersession 2020,12/22/2020,Tuesday,1:30 PM,1,0,0,0,0,1
Winter Intersession 2020,12/22/2020,Tuesday,2:30 PM,0,0,0,0,3,3
Winter Intersession 2020,12/22/2020,Tuesday,2:30 PM,0,0,1,0,3,4
Winter Intersession 2020,12/22/2020,Tuesday,3:30 PM,0,0,1,0,0,1
Winter Intersession 2020,12/22/2020,Tuesday,4:30 PM,0,0,0,0,0,0
Winter Intersession 2020,12/22/2020,Tuesday,5:30 PM,0,0,0,0,0,0
Winter Intersession 2020,12/23/2020,Wednesday,9:30 AM,0,0,0,0,0,0
Winter Intersession 2020,12/23/2020,Wednesday,10:30 AM,0,0,0,0,0,0
Winter Intersession 2020,12/23/2020,Wednesday,11:30 AM,2,0,0,0,0,2
Winter Intersession 2020,12/23/2020,Wednesday,12:30 PM,3,0,0,0,0,3
Winter Intersession 2020,12/23/2020,Wednesday,1:30 PM,1,0,0,0,0,1
Winter Intersession 2020,12/23/2020,Wednesday,2:30 PM,0,0,0,0,0,0
Winter Intersession 2020,12/23/2020,Wednesday,3:30 PM,0,0,0,0,0,0
Winter Intersession 2020,12/23/2020,Wednesday,4:30 PM,0,0,0,0,0,0
Winter Intersession 2020,12/23/2020,Wednesday,5:30 PM,0,0,0,0,0,0
Winter Intersession 2020,1/4/2021,Monday,9:30 AM,1,0,0,0,0,1
Winter Intersession 2020,1/4/2021,Monday,10:30 AM,2,0,0,0,0,2
Winter Intersession 2020,1/4/2021,Monday,11:30 AM,2,0,0,0,0,2
Winter Intersession 2020,1/4/2021,Monday,12:30 PM,1,0,0,0,0,1
Winter Intersession 2020,1/4/2021,Monday,2:30 PM,0,0,0,0,0,0
Winter Intersession 2020,1/4/2021,Monday,3:30 PM,2,0,0,0,0,2
Winter Intersession 2020,1/4/2021,Monday,4:30 PM,2,0,0,0,0,2
Winter Intersession 2020,1/4/2021,Monday,5:30 PM,0,0,0,0,0,0
Winter Intersession 2020,1/5/2021,Tuesday,9:30 AM,2,0,0,0,0,2
Winter Intersession 2020,1/5/2021,Tuesday,10:30 AM,0,0,0,0,0,0
Winter Intersession 2020,1/5/2021,Tuesday,11:30 AM,0,0,0,0,0,0
Winter Intersession 2020,1/5/2021,Tuesday,12:30 PM,0,0,0,0,0,0
Winter Intersession 2020,1/5/2021,Tuesday,2:30 PM,2,0,0,0,0,2
Winter Intersession 2020,1/5/2021,Tuesday,3:30 PM,0,0,0,0,0,0
Winter Intersession 2020,1/5/2021,Tuesday,4:30 PM,0,0,0,0,0,0
Winter Intersession 2020,1/5/2021,Tuesday,5:30 PM,0,0,0,0,0,0
Winter Intersession 2020,1/6/2021,Wednesday,9:30 AM,0,0,0,0,0,0
Winter Intersession 2020,1/6/2021,Wednesday,10:30 AM,0,0,0,0,0,0
Winter Intersession 2020,1/6/2021,Wednesday,11:30 AM,1,0,0,0,0,1
Winter Intersession 2020,1/6/2021,Wednesday,12:30 PM,0,0,0,0,0,0
Winter Intersession 2020,1/6/2021,Wednesday,2:30 PM,0,0,0,0,0,0
Winter Intersession 2020,1/6/2021,Wednesday,3:30 PM,0,0,0,0,0,0
Winter Intersession 2020,1/6/2021,Wednesday,4:30 PM,0,0,0,0,0,0
Winter Intersession 2020,1/6/2021,Wednesday,5:30 PM,0,0,0,0,0,0
Winter Intersession 2020,1/7/2021,Thursday,8:30 AM,1,0,0,0,0,1
Winter Intersession 2020,1/7/2021,Thursday,10:30 AM,0,0,0,0,0,0
Winter Intersession 2020,1/7/2021,Thursday,11:30 AM,1,0,0,0,5,6
Winter Intersession 2020,1/7/2021,Thursday,12:30 PM,1,0,0,0,0,1
Winter Intersession 2020,1/7/2021,Thursday,2:30 PM,2,0,0,0,0,2
Winter Intersession 2020,1/7/2021,Thursday,3:30 PM,4,0,1,0,0,5
Winter Intersession 2020,1/7/2021,Thursday,4:30 PM,0,0,0,0,0,0
Winter Intersession 2020,1/7/2021,Thursday,5:30 PM,0,0,0,0,0,0
Winter Intersession 2020,1/8/2021,Friday,9:30 AM,1,0,0,0,0,1
Winter Intersession 2020,1/8/2021,Friday,10:30 AM,1,0,0,0,0,1
Winter Intersession 2020,1/8/2021,Friday,11:30 AM,2,0,0,0,0,2
Winter Intersession 2020,1/8/2021,Friday,12:30 PM,1,0,0,2,0,3
Winter Intersession 2020,1/8/2021,Friday,1:30 PM,3,0,0,0,0,3
Winter Intersession 2020,1/8/2021,Friday,2:30 PM,3,0,0,0,0,3
Winter Intersession 2020,1/8/2021,Friday,3:30 PM,3,0,0,0,0,3
Winter Intersession 2020,1/8/2021,Friday,4:30 PM,1,0,0,0,0,1
Winter Intersession 2020,1/11/2021,Monday,9:30 AM,2,0,0,0,0,2
Winter Intersession 2020,1/11/2021,Monday,2:30 PM,2,0,0,0,0,2
Winter Intersession 2020,1/11/2021,Monday,3:30 PM,2,0,0,0,2,4
Winter Intersession 2020,1/11/2021,Monday,4:30 PM,0,0,0,0,0,0
Winter Intersession 2020,1/11/2021,Monday,5:30 PM,4,0,0,0,0,4
Winter Intersession 2020,1/12/2021,Tuesday,9:30 AM,2,0,0,0,0,2
Winter Intersession 2020,1/12/2021,Tuesday,10:30 AM,0,0,0,0,0,0
Winter Intersession 2020,1/12/2021,Tuesday,11:30 AM,0,0,0,0,0,0
Winter Intersession 2020,1/12/2021,Tuesday,12:30 PM,0,0,0,0,0,0
Winter Intersession 2020,1/12/2021,Tuesday,1:30 PM,1,0,0,0,0,1
Winter Intersession 2020,1/12/2021,Tuesday,2:30 PM,0,0,0,0,0,0
Winter Intersession 2020,1/12/2021,Tuesday,3:30 PM,4,0,0,0,1,5
Winter Intersession 2020,1/12/2021,Tuesday,4:30 PM,1,0,0,0,0,1
Winter Intersession 2020,1/12/2021,Tuesday,5:30 PM,0,0,0,0,0,0
Winter Intersession 2020,1/13/2021,Wednesday,9:30 AM,2,0,0,0,0,2
Winter Intersession 2020,1/13/2021,Wednesday,10:30 AM,1,0,0,0,0,1
Winter Intersession 2020,1/13/2021,Wednesday,11:30 AM,1,0,0,0,0,1
Winter Intersession 2020,1/13/2021,Wednesday,12:30 PM,2,0,0,0,0,2
Winter Intersession 2020,1/13/2021,Wednesday,1:30 PM,2,0,0,0,0,2
Winter Intersession 2020,1/13/2021,Wednesday,2:30 PM,0,0,0,0,0,0
Winter Intersession 2020,1/13/2021,Wednesday,3:30 PM,3,0,0,0,1,4
Winter Intersession 2020,1/13/2021,Wednesday,4:30 PM,2,0,0,0,2,4
Winter Intersession 2020,1/13/2021,Wednesday,5:30 PM,1,0,0,0,0,1
Winter Intersession 2020,1/14/2021,Thursday,9:30 AM,0,0,0,0,0,0
Winter Intersession 2020,1/14/2021,Thursday,10:30 AM,1,0,0,0,0,1
Winter Intersession 2020,1/14/2021,Thursday,11:30 AM,1,0,0,0,0,1
Winter Intersession 2020,1/14/2021,Thursday,1:30 PM,1,0,0,0,0,1
Winter Intersession 2020,1/14/2021,Thursday,2:30 PM,2,0,0,0,0,2
Winter Intersession 2020,1/14/2021,Thursday,3:30 PM,0,0,0,0,1,1
Winter Intersession 2020,1/14/2021,Thursday,4:30 PM,2,0,0,0,1,3
Winter Intersession 2020,1/14/2021,Thursday,5:30 PM,0,0,0,0,0,0
Winter Intersession 2020,1/15/2021,Friday,9:30 AM,1,0,0,0,0,1
Winter Intersession 2020,1/15/2021,Friday,10:30 AM,2,0,0,0,0,2
Winter Intersession 2020,1/15/2021,Friday,11:30 AM,3,0,0,1,0,4
Winter Intersession 2020,1/15/2021,Friday,12:30 PM,2,0,0,0,0,2
Winter Intersession 2020,1/15/2021,Friday,12:30 PM,1,0,1,0,0,2
Winter Intersession 2020,1/15/2021,Friday,1:30 PM,5,0,1,0,0,6
Winter Intersession 2020,1/15/2021,Friday,2:30 PM,2,0,1,0,0,3
Winter Intersession 2020,1/15/2021,Friday,3:30 PM,2,0,2,0,0,4
Winter Intersession 2020,1/15/2021,Friday,4:30 PM,0,0,0,0,0,0
Spring 2021,1/19/2021,Tuesday,7:30 AM,0,0,0,0,0,0
Spring 2021,1/19/2021,Tuesday,8:30 AM,1,0,0,0,1,2
Spring 2021,1/19/2021,Tuesday,9:30 AM,2,0,0,0,1,3
Spring 2021,1/19/2021,Tuesday,9:30 AM,4,0,0,0,1,5
Spring 2021,1/19/2021,Tuesday,10:30 AM,5,0,0,0,0,5
Spring 2021,1/19/2021,Tuesday,11:30 AM,6,0,0,0,0,6
Spring 2021,1/19/2021,Tuesday,12:30 PM,13,0,0,0,0,13
Spring 2021,1/19/2021,Tuesday,1:30 PM,7,0,3,0,0,10
Spring 2021,1/19/2021,Tuesday,2:30 PM,8,0,1,0,0,9
Spring 2021,1/19/2021,Tuesday,3:30 PM,7,0,0,3,0,10
Spring 2021,1/19/2021,Tuesday,4:30 PM,8,0,0,1,0,9
Spring 2021,1/19/2021,Tuesday,5:30 PM,2,0,0,1,1,4
Spring 2021,1/19/2021,Tuesday,6:30 PM,4,0,0,0,1,5
Spring 2021,1/19/2021,Tuesday,7:30 PM,1,0,0,0,0,1
Spring 2021,1/20/2021,Wednesday,7:30 AM,1,0,0,0,0,1
Spring 2021,1/20/2021,Wednesday,8:30 AM,0,0,0,0,0,0
Spring 2021,1/20/2021,Wednesday,9:30 AM,5,0,0,0,0,5
Spring 2021,1/20/2021,Wednesday,10:30 AM,3,0,0,0,1,4
Spring 2021,1/20/2021,Wednesday,11:30 AM,3,0,0,0,3,6
Spring 2021,1/20/2021,Wednesday,12:30 PM,10,0,0,0,1,11
Spring 2021,1/20/2021,Wednesday,1:30 PM,8,0,0,0,0,8
Spring 2021,1/20/2021,Wednesday,2:30 PM,7,0,0,0,1,8
Spring 2021,1/20/2021,Wednesday,4:30 PM,4,0,1,0,0,5
Spring 2021,1/20/2021,Wednesday,5:30 PM,4,0,0,0,0,4
Spring 2021,1/20/2021,Wednesday,6:30 PM,1,0,1,0,0,2
Spring 2021,1/20/2021,Wednesday,7:30 PM,2,1,1,0,0,4
Spring 2021,1/21/2021,Thursday,7:30 AM,0,0,0,0,0,0
Spring 2021,1/21/2021,Thursday,8:30 AM,0,0,0,0,0,0
Spring 2021,1/21/2021,Thursday,9:30 AM,7,0,1,0,0,8
Spring 2021,1/21/2021,Thursday,10:30 AM,5,0,0,0,0,5
Spring 2021,1/21/2021,Thursday,11:30 AM,6,0,0,0,0,6
Spring 2021,1/21/2021,Thursday,12:30 PM,12,0,0,0,0,12
Spring 2021,1/21/2021,Thursday,12:30 PM,13,0,1,0,0,14
Spring 2021,1/21/2021,Thursday,1:30 PM,5,0,2,0,0,7
Spring 2021,1/21/2021,Thursday,2:30 PM,11,0,2,0,0,13
Spring 2021,1/21/2021,Thursday,3:30 PM,6,1,1,0,1,9
Spring 2021,1/21/2021,Thursday,4:30 PM,4,0,2,1,1,8
Spring 2021,1/21/2021,Thursday,5:30 PM,4,0,0,0,2,6
Spring 2021,1/21/2021,Thursday,6:30 PM,2,0,0,0,1,3
Spring 2021,1/21/2021,Thursday,7:30 PM,0,0,2,0,0,2
Spring 2021,1/22/2021,Friday,7:30 AM,1,0,0,0,0,1
Spring 2021,1/22/2021,Friday,8:30 AM,3,0,0,0,0,3
Spring 2021,1/22/2021,Friday,9:30 AM,5,0,1,0,0,6
Spring 2021,1/22/2021,Friday,10:30 AM,3,0,1,0,0,4
Spring 2021,1/22/2021,Friday,11:30 AM,4,0,0,0,0,4
Spring 2021,1/22/2021,Friday,12:30 PM,4,0,0,0,0,4
Spring 2021,1/22/2021,Friday,1:30 PM,6,0,0,0,0,6
Spring 2021,1/22/2021,Friday,2:30 PM,6,0,0,0,0,6
Spring 2021,1/22/2021,Friday,4:30 PM,5,0,0,0,0,5
Spring 2021,1/22/2021,Friday,5:30 PM,2,0,1,0,0,3
Spring 2021,1/22/2021,Friday,6:30 PM,1,0,1,0,0,2
Spring 2021,1/22/2021,Friday,7:30 PM,2,1,1,0,0,4
Spring 2021,1/23/2021,Saturday,9:30 AM,2,0,0,0,0,2
Spring 2021,1/23/2021,Saturday,10:30 AM,1,0,0,1,0,2
Spring 2021,1/23/2021,Saturday,11:30 AM,4,0,1,0,3,8
Spring 2021,1/23/2021,Saturday,1:30 PM,5,0,1,0,3,9
Spring 2021,1/23/2021,Saturday,12:30 PM,5,0,1,0,3,9
Spring 2021,1/23/2021,Saturday,1:30 PM,6,0,1,0,3,10
Spring 2021,1/23/2021,Saturday,2:30 PM,5,0,0,0,2,7
Spring 2021,1/25/2021,Monday,7:30 AM,1,0,0,0,1,2
Spring 2021,1/25/2021,Monday,8:30 AM,3,0,0,0,0,3
Spring 2021,1/25/2021,Monday,9:30 AM,6,0,1,0,0,7
Spring 2021,1/25/2021,Monday,10:30 AM,7,0,2,0,1,10
Spring 2021,1/25/2021,Monday,11:30 AM,12,0,2,0,4,18
Spring 2021,1/25/2021,Monday,12:30 PM,11,0,0,0,3,14
Spring 2021,1/25/2021,Monday,1:30 PM,5,0,0,0,3,8
Spring 2021,1/25/2021,Monday,2:30 PM,8,0,0,0,1,9
Spring 2021,1/25/2021,Monday,3:30 PM,3,0,1,0,3,7
Spring 2021,1/25/2021,Monday,4:30 PM,5,0,0,1,0,6
Spring 2021,1/25/2021,Monday,5:30 PM,5,0,1,0,2,8
Spring 2021,1/25/2021,Monday,6:30 PM,3,0,0,0,0,3
Spring 2021,1/25/2021,Monday,5:30 PM,2,0,2,1,0,5
Spring 2021,1/25/2021,Monday,6:30 PM,2,2,0,1,0,5
Spring 2021,1/25/2021,Monday,7:30 PM,2,0,0,0,0,2
Spring 2021,1/26/2021,Tuesday,7:30 AM,0,0,0,0,0,0
Spring 2021,1/26/2021,Tuesday,8:30 AM,1,0,1,0,0,2
Spring 2021,1/26/2021,Tuesday,9:30 AM,6,0,0,0,0,6
Spring 2021,1/26/2021,Tuesday,10:30 AM,7,0,0,0,1,8
Spring 2021,1/26/2021,Tuesday,11:30 AM,6,0,1,0,2,9
Spring 2021,1/26/2021,Tuesday,12:30 PM,5,0,2,0,1,8
Spring 2021,1/26/2021,Tuesday,1:30 PM,8,0,1,0,0,9
Spring 2021,1/26/2021,Tuesday,2:30 PM,9,0,1,0,1,11
Spring 2021,1/26/2021,Tuesday,3:30 PM,4,0,0,1,0,5
Spring 2021,1/26/2021,Tuesday,4:30 PM,6,0,0,2,0,8
Spring 2021,1/26/2021,Tuesday,5:30 PM,9,0,1,0,1,11
Spring 2021,1/26/2021,Tuesday,6:30 PM,3,0,1,0,0,4
Spring 2021,1/26/2021,Tuesday,7:30 PM,4,0,0,0,0,4
Spring 2021,1/27/2021,Wednesday,7:30 AM,2,0,0,0,0,2
Spring 2021,1/27/2021,Wednesday,8:30 AM,2,0,0,0,0,2
Spring 2021,1/27/2021,Wednesday,9:30 AM,3,0,0,0,0,3
Spring 2021,1/27/2021,Wednesday,10:30 AM,6,0,0,0,1,7
Spring 2021,1/27/2021,Wednesday,11:30 AM,4,1,1,0,1,7
Spring 2021,1/27/2021,Wednesday,12:30 PM,10,1,0,0,3,14
Spring 2021,1/27/2021,Wednesday,1:30 PM,12,0,0,0,3,15
Spring 2021,1/27/2021,Wednesday,2:30 PM,5,0,0,0,3,8
Spring 2021,1/27/2021,Wednesday,3:30 PM,4,0,0,0,1,5
Spring 2021,1/27/2021,Wednesday,4:30 PM,4,0,1,0,1,6
Spring 2021,1/27/2021,Wednesday,4:30 PM,5,0,1,0,0,6
Spring 2021,1/27/2021,Wednesday,5:30 PM,3,0,0,0,0,3
Spring 2021,1/27/2021,Wednesday,6:30 PM,3,0,0,0,0,3
Spring 2021,1/27/2021,Wednesday,7:30 PM,2,0,0,0,0,2
Spring 2021,1/28/2021,Thursday,7:30 AM,0,0,0,0,0,0
Spring 2021,1/28/2021,Thursday,8:30 AM,2,0,0,0,0,2
Spring 2021,1/28/2021,Thursday,9:30 AM,1,0,0,0,1,2
Spring 2021,1/28/2021,Thursday,10:30 AM,3,0,1,0,0,4
Spring 2021,1/28/2021,Thursday,11:30 AM,5,0,2,0,0,7
Spring 2021,1/28/2021,Thursday,12:30 PM,7,0,1,0,0,8
Spring 2021,1/28/2021,Thursday,1:30 PM,6,0,0,0,0,6
Spring 2021,1/28/2021,Thursday,2:30 PM,5,0,1,0,0,6
Spring 2021,1/28/2021,Thursday,3:30 PM,5,1,1,0,1,8
Spring 2021,1/28/2021,Thursday,4:30 PM,4,0,0,2,0,6
Spring 2021,1/28/2021,Thursday,6:30 PM,2,1,0,0,0,3
Spring 2021,1/28/2021,Thursday,5:30 PM,2,1,0,0,3,6
Spring 2021,1/28/2021,Thursday,7:30 PM,3,0,0,0,3,6
Spring 2021,1/29/2021,Friday,7:30 AM,3,0,0,0,0,3
Spring 2021,1/29/2021,Friday,8:30 AM,1,0,0,0,0,1
Spring 2021,1/29/2021,Friday,9:30 AM,1,0,0,0,0,1
Spring 2021,1/29/2021,Friday,10:30 AM,5,0,0,0,1,6
Spring 2021,1/29/2021,Friday,11:30 AM,5,0,0,0,1,6
Spring 2021,1/29/2021,Friday,12:30 PM,8,0,0,0,1,9
Spring 2021,1/29/2021,Friday,1:30 PM,10,0,0,0,2,12
Spring 2021,1/29/2021,Friday,12:30 PM,10,0,0,0,2,12
Spring 2021,1/29/2021,Friday,1:30 PM,6,0,0,0,1,7
Spring 2021,1/29/2021,Friday,2:30 PM,2,0,0,0,1,3
Spring 2021,1/29/2021,Friday,3:30 PM,3,0,1,0,0,4
Spring 2021,1/29/2021,Friday,4:30 PM,2,1,1,0,0,4
Spring 2021,1/29/2021,Friday,5:30 PM,4,1,1,0,0,6
Spring 2021,1/30/2021,Saturday,10:30 AM,1,0,0,0,1,2
Spring 2021,1/30/2021,Saturday,11:30 AM,1,0,0,0,1,2
Spring 2021,1/30/2021,Saturday,12:30 PM,2,0,0,0,3,5
Spring 2021,1/30/2021,Saturday,1:30 PM,2,0,0,0,0,2
Spring 2021,1/30/2021,Saturday,2:30 PM,2,0,0,0,0,2
Spring 2021,2/1/2021,Monday,7:30 AM,1,0,0,0,0,1
Spring 2021,2/1/2021,Monday,8:30 AM,3,0,0,0,0,3
Spring 2021,2/1/2021,Monday,9:30 AM,3,0,1,0,0,4
Spring 2021,2/1/2021,Monday,10:30 AM,5,0,1,0,0,6
Spring 2021,2/1/2021,Monday,11:30 AM,4,0,4,0,0,8
Spring 2021,2/1/2021,Monday,12:30 PM,4,0,0,0,2,6
Spring 2021,2/1/2021,Monday,1:30 PM,4,0,1,0,2,7
Spring 2021,2/1/2021,Monday,2:30 PM,3,0,2,0,1,6
Spring 2021,2/1/2021,Monday,4:30 PM,6,0,0,0,4,10
Spring 2021,2/1/2021,Monday,4:30 PM,3,0,0,2,0,5
Spring 2021,2/1/2021,Monday,5:30 PM,4,2,0,0,2,8
Spring 2021,2/1/2021,Monday,5:30 PM,3,0,0,2,0,5
Spring 2021,2/1/2021,Monday,6:30 PM,3,1,0,0,0,4
Spring 2021,2/1/2021,Monday,7:30 PM,3,1,0,0,0,4
Spring 2021,2/2/2021,Tuesday,7:30 AM,0,0,0,0,0,0
Spring 2021,2/2/2021,Tuesday,8:30 AM,1,0,0,0,0,1
Spring 2021,2/2/2021,Tuesday,9:30 AM,0,0,0,0,0,0
Spring 2021,2/2/2021,Tuesday,10:30 AM,7,0,1,0,0,8
Spring 2021,2/2/2021,Tuesday,10:30 AM,7,0,2,0,0,9
Spring 2021,2/2/2021,Tuesday,11:30 AM,7,0,1,0,1,9
Spring 2021,2/2/2021,Tuesday,12:30 PM,7,0,1,0,1,9
Spring 2021,2/2/2021,Tuesday,1:30 PM,7,0,0,0,1,8
Spring 2021,2/2/2021,Tuesday,2:30 PM,4,0,0,0,0,4
Spring 2021,2/2/2021,Tuesday,3:30 PM,1,0,0,1,0,2
Spring 2021,2/2/2021,Tuesday,4:30 PM,2,0,0,1,4,7
Spring 2021,2/2/2021,Tuesday,5:30 PM,3,1,0,0,0,4
Spring 2021,2/2/2021,Tuesday,6:30 PM,4,0,0,1,1,6
Spring 2021,2/2/2021,Tuesday,7:30 PM,3,0,0,0,1,4
Spring 2021,2/3/2021,Wednesday,7:30 AM,3,0,0,0,0,3
Spring 2021,2/3/2021,Wednesday,8:30 AM,0,0,0,0,0,0
Spring 2021,2/3/2021,Wednesday,9:30 AM,3,0,0,0,1,4
Spring 2021,2/3/2021,Wednesday,10:30 AM,6,0,1,0,0,7
Spring 2021,2/3/2021,Wednesday,11:30 AM,6,0,1,0,2,9
Spring 2021,2/3/2021,Wednesday,12:30 PM,4,0,1,0,3,8
Spring 2021,2/3/2021,Wednesday,1:30 PM,3,0,1,0,2,6
Spring 2021,2/3/2021,Wednesday,2:30 PM,6,0,2,0,1,9
Spring 2021,2/3/2021,Wednesday,4:30 PM,6,1,0,0,1,8
Spring 2021,2/3/2021,Wednesday,5:30 PM,3,1,1,0,1,6
Spring 2021,2/3/2021,Wednesday,6:30 PM,6,0,0,0,0,6
Spring 2021,2/3/2021,Wednesday,7:30 PM,1,0,0,0,0,1
Spring 2021,2/4/2021,Thursday,7:30 AM,0,0,0,0,1,1
Spring 2021,2/4/2021,Thursday,8:30 AM,0,0,0,0,1,1
Spring 2021,2/4/2021,Thursday,10:30 AM,1,0,1,0,2,4
Spring 2021,2/4/2021,Thursday,9:30 AM,1,0,1,0,2,4
Spring 2021,2/4/2021,Thursday,10:30 AM,2,0,1,0,2,5
Spring 2021,2/4/2021,Thursday,11:30 AM,5,0,1,0,0,6
Spring 2021,2/4/2021,Thursday,12:30 PM,2,0,1,0,0,3
Spring 2021,2/4/2021,Thursday,1:30 PM,4,1,0,0,0,5
Spring 2021,2/4/2021,Thursday,2:30 PM,6,0,1,0,0,7
Spring 2021,2/4/2021,Thursday,3:30 PM,2,0,1,0,0,3
Spring 2021,2/4/2021,Thursday,4:30 PM,2,0,0,0,0,2
Spring 2021,2/4/2021,Thursday,5:30 PM,3,0,0,1,0,4
Spring 2021,2/4/2021,Thursday,6:30 PM,4,0,0,1,0,5
Spring 2021,2/4/2021,Thursday,7:30 PM,0,0,0,0,0,0
Spring 2021,2/5/2021,Friday,7:30 AM,1,0,0,0,0,1
Spring 2021,2/5/2021,Friday,8:30 AM,1,0,1,0,0,2
Spring 2021,2/5/2021,Friday,9:30 AM,2,0,1,0,0,3
Spring 2021,2/5/2021,Friday,10:30 AM,1,0,2,0,0,3
Spring 2021,2/5/2021,Friday,11:30 AM,2,0,3,0,0,5
Spring 2021,2/5/2021,Friday,12:30 PM,3,0,2,0,0,5
Spring 2021,2/5/2021,Friday,1:30 PM,5,0,1,0,1,7
Spring 2021,2/5/2021,Friday,2:30 PM,2,0,1,0,2,5
Spring 2021,2/5/2021,Friday,3:30 PM,3,0,1,0,0,4
Spring 2021,2/5/2021,Friday,4:30 PM,4,0,2,0,0,6
Spring 2021,2/5/2021,Friday,5:30 PM,1,1,0,0,0,2
Spring 2021,2/5/2021,Friday,6:30 PM,1,0,0,0,0,1
Spring 2021,2/5/2021,Friday,7:30 PM,1,1,0,0,0,2
Spring 2021,2/6/2021,Saturday,9:30 AM,0,0,0,0,0,0
Spring 2021,2/6/2021,Saturday,10:30 AM,1,0,0,0,0,1
Spring 2021,2/6/2021,Saturday,11:30 AM,4,0,2,0,0,6
Spring 2021,2/6/2021,Saturday,12:30 PM,2,0,1,0,1,4
Spring 2021,2/6/2021,Saturday,1:30 PM,5,0,3,0,2,10
Spring 2021,2/6/2021,Saturday,2:30 PM,5,0,2,0,0,7
Spring 2021,2/20/2021,Saturday,9:30 AM,3,0,0,0,1,4
Spring 2021,2/20/2021,Saturday,10:30 AM,3,0,0,0,1,4
Spring 2021,2/20/2021,Saturday,11:30 AM,4,1,0,0,1,6
Spring 2021,2/20/2021,Saturday,12:30 PM,6,1,0,2,2,11
Spring 2021,2/20/2021,Saturday,1:30 PM,3,0,2,0,3,8
Spring 2021,2/22/2021,Monday,8:30 AM,2,2,0,0,0,4
Spring 2021,2/22/2021,Monday,9:30 AM,6,0,2,0,1,9
Spring 2021,2/22/2021,Monday,10:30 AM,6,0,1,0,0,7
Spring 2021,2/22/2021,Monday,11:30 AM,9,0,5,0,3,17
Spring 2021,2/22/2021,Monday,12:30 PM,6,0,6,0,3,15
Spring 2021,2/22/2021,Monday,1:30 PM,4,0,5,0,0,9
Spring 2021,2/22/2021,Monday,2:30 PM,3,0,1,0,1,5
Spring 2021,2/22/2021,Monday,3:30 PM,2,0,0,0,0,2
Spring 2021,2/22/2021,Monday,4:30 PM,3,0,0,0,1,4
Spring 2021,2/22/2021,Monday,5:30 PM,2,0,0,0,2,4
Spring 2021,2/22/2021,Monday,6:30 PM,4,0,0,0,1,5
Spring 2021,2/22/2021,Monday,7:30 PM,5,0,1,0,0,6
Spring 2021,2/23/2021,Tuesday,7:30 AM,0,0,0,0,0,0
Spring 2021,2/23/2021,Tuesday,8:30 AM,0,0,0,0,0,0
Spring 2021,2/23/2021,Tuesday,9:30 AM,2,0,0,0,0,2
Spring 2021,2/23/2021,Tuesday,10:30 AM,6,0,0,0,0,6
Spring 2021,2/23/2021,Tuesday,11:30 AM,9,0,0,0,0,9
Spring 2021,2/23/2021,Tuesday,12:30 PM,9,0,0,0,1,10
Spring 2021,2/23/2021,Tuesday,1:30 PM,7,0,1,0,0,8
Spring 2021,2/23/2021,Tuesday,2:30 PM,3,0,2,0,0,5
Spring 2021,2/23/2021,Tuesday,3:30 PM,2,0,0,2,0,4
Spring 2021,2/23/2021,Tuesday,4:30 PM,2,0,0,0,1,3
Spring 2021,2/23/2021,Tuesday,5:30 PM,8,0,0,0,1,9
Spring 2021,2/23/2021,Tuesday,6:30 PM,6,0,0,0,1,7
Spring 2021,2/23/2021,Tuesday,7:30 PM,4,0,0,0,0,4
Spring 2021,2/24/2021,Wednesday,7:30 AM,2,0,0,0,0,2
Spring 2021,2/24/2021,Wednesday,8:30 AM,1,0,0,0,0,1
Spring 2021,2/24/2021,Wednesday,9:30 AM,3,0,0,0,0,3
Spring 2021,2/24/2021,Wednesday,10:30 AM,5,0,1,0,0,6
Spring 2021,2/24/2021,Wednesday,11:30 AM,4,0,6,0,1,11
Spring 2021,2/24/2021,Wednesday,12:30 PM,9,0,5,0,2,16
Spring 2021,2/24/2021,Wednesday,1:30 PM,4,0,1,0,1,6
Spring 2021,2/24/2021,Wednesday,2:30 PM,1,0,0,0,1,2
Spring 2021,2/24/2021,Wednesday,4:30 PM,5,0,1,0,2,8
Spring 2021,2/24/2021,Wednesday,5:30 PM,3,0,1,0,2,6
Spring 2021,2/24/2021,Wednesday,6:30 PM,3,0,0,0,2,5
Spring 2021,2/24/2021,Wednesday,7:30 PM,7,0,0,0,0,7
Spring 2021,2/25/2021,Thursday,7:30 AM,2,0,0,0,0,2
Spring 2021,2/25/2021,Thursday,8:30 AM,1,0,0,0,0,1
Spring 2021,2/25/2021,Thursday,9:30 AM,6,0,0,0,1,7
Spring 2021,2/25/2021,Thursday,10:30 AM,9,0,0,0,1,10
Spring 2021,2/25/2021,Thursday,11:30 AM,5,0,1,0,0,6
Spring 2021,2/25/2021,Thursday,12:30 PM,5,0,0,0,1,6
Spring 2021,2/25/2021,Thursday,1:30 PM,5,0,0,0,0,5
Spring 2021,2/25/2021,Thursday,2:30 PM,4,0,1,0,0,5
Spring 2021,2/25/2021,Thursday,12:30 PM,5,0,0,0,0,5
Spring 2021,2/25/2021,Thursday,3:30 PM,5,0,0,0,0,5
Spring 2021,2/25/2021,Thursday,4:30 PM,5,0,0,0,0,5
Spring 2021,2/25/2021,Thursday,5:30 PM,3,0,0,0,3,6
Spring 2021,2/25/2021,Thursday,6:30 PM,2,0,0,0,3,5
Spring 2021,2/25/2021,Thursday,7:30 PM,3,0,0,0,2,5
Spring 2021,2/26/2021,Friday,7:30 AM,0,0,0,0,0,0
Spring 2021,2/26/2021,Friday,8:30 AM,1,0,0,0,0,1
Spring 2021,2/26/2021,Friday,9:30 AM,1,0,0,0,0,1
Spring 2021,2/26/2021,Friday,10:30 AM,2,0,0,0,0,2
Spring 2021,2/26/2021,Friday,11:30 AM,1,0,0,0,0,1
Spring 2021,2/26/2021,Friday,12:30 PM,2,0,0,0,0,2
Spring 2021,2/26/2021,Friday,1:30 PM,1,0,0,0,2,3
Spring 2021,2/26/2021,Friday,2:30 PM,2,0,0,0,3,5
Spring 2021,2/26/2021,Friday,4:30 PM,1,0,1,0,0,2
Spring 2021,2/26/2021,Friday,5:30 PM,2,0,1,0,0,3
Spring 2021,2/26/2021,Friday,6:30 PM,1,0,2,0,0,3
Spring 2021,2/26/2021,Friday,7:30 PM,1,0,1,0,0,2
Spring 2021,2/27/2021,Saturday,9:30 AM,3,0,0,0,0,3
Spring 2021,2/27/2021,Saturday,10:30 AM,4,0,0,0,0,4
Spring 2021,2/27/2021,Saturday,11:30 AM,2,0,1,0,4,7
Spring 2021,2/27/2021,Saturday,12:30 PM,1,0,1,0,2,4
Spring 2021,2/27/2021,Saturday,1:30 PM,3,0,0,0,0,3
Spring 2021,2/27/2021,Saturday,2:30 PM,2,0,0,0,0,2
Spring 2021,3/1/2021,Monday,7:30 AM,1,0,0,0,0,1
Spring 2021,3/1/2021,Monday,8:30 AM,1,0,0,0,0,1
Spring 2021,3/1/2021,Monday,10:30 AM,6,0,2,0,1,9
Spring 2021,3/1/2021,Monday,11:30 AM,4,0,3,0,2,9
Spring 2021,3/1/2021,Monday,12:30 PM,4,0,2,0,3,9
Spring 2021,3/1/2021,Monday,1:30 PM,5,0,2,0,3,10
Spring 2021,3/1/2021,Monday,3:30 PM,1,0,2,0,1,4
Spring 2021,3/1/2021,Monday,4:30 PM,5,0,0,0,0,5
Spring 2021,3/1/2021,Monday,5:30 PM,3,0,1,0,2,6
Spring 2021,3/1/2021,Monday,6:30 PM,4,0,0,0,3,7
Spring 2021,3/1/2021,Monday,7:30 PM,1,0,0,0,0,1
Spring 2021,3/2/2021,Tuesday,7:30 AM,1,0,0,0,0,1
Spring 2021,3/2/2021,Tuesday,8:30 AM,1,0,0,0,0,1
Spring 2021,3/2/2021,Tuesday,9:30 AM,4,0,0,0,0,4
Spring 2021,3/2/2021,Tuesday,10:30 AM,7,0,0,0,0,7
Spring 2021,3/2/2021,Tuesday,11:30 AM,8,0,0,0,0,8
Spring 2021,3/2/2021,Tuesday,12:30 PM,5,0,0,0,0,5
Spring 2021,3/2/2021,Tuesday,1:30 PM,7,0,1,0,0,8
Spring 2021,3/2/2021,Tuesday,2:30 PM,6,0,0,0,0,6
Spring 2021,3/2/2021,Tuesday,3:30 PM,4,0,0,0,2,6
Spring 2021,3/2/2021,Tuesday,4:30 PM,4,0,0,0,2,6
Spring 2021,3/2/2021,Tuesday,5:30 PM,5,0,0,0,2,7
Spring 2021,3/2/2021,Tuesday,6:30 PM,3,0,0,0,0,3
Spring 2021,3/2/2021,Tuesday,7:30 PM,1,0,0,1,0,2
Spring 2021,3/3/2021,Wednesday,7:30 AM,1,0,0,0,0,1
Spring 2021,3/3/2021,Wednesday,8:30 AM,1,0,0,0,0,1
Spring 2021,3/3/2021,Wednesday,9:30 AM,3,0,0,0,0,3
Spring 2021,3/3/2021,Wednesday,10:30 AM,4,0,1,0,0,5
Spring 2021,3/3/2021,Wednesday,11:30 AM,8,0,2,0,1,11
Spring 2021,3/3/2021,Wednesday,12:30 PM,5,0,1,0,2,8
Spring 2021,3/3/2021,Wednesday,1:30 PM,5,0,3,0,1,9
Spring 2021,3/3/2021,Wednesday,4:30 PM,3,0,0,0,2,5
Spring 2021,3/3/2021,Wednesday,5:30 PM,5,0,1,0,3,9
Spring 2021,3/3/2021,Wednesday,6:30 PM,1,0,0,0,3,4
Spring 2021,3/3/2021,Wednesday,6:30 PM,3,0,0,0,1,4
Spring 2021,3/3/2021,Wednesday,7:30 PM,2,0,0,0,0,2
Spring 2021,3/4/2021,Thursday,7:30 AM,0,0,0,0,1,1
Spring 2021,3/4/2021,Thursday,8:30 AM,2,0,0,0,0,2
Spring 2021,3/4/2021,Thursday,9:30 AM,2,0,0,0,1,3
Spring 2021,3/4/2021,Thursday,10:30 AM,5,0,0,0,3,8
Spring 2021,3/4/2021,Thursday,11:30 AM,4,0,1,0,0,5
Spring 2021,3/4/2021,Thursday,1:30 PM,5,0,0,0,0,5
Spring 2021,3/4/2021,Thursday,2:30 PM,4,0,1,0,0,5
Spring 2021,3/4/2021,Thursday,3:30 PM,6,0,0,0,2,8
Spring 2021,3/4/2021,Thursday,4:30 PM,1,0,0,0,0,1
Spring 2021,3/4/2021,Thursday,5:30 PM,1,0,0,0,1,2
Spring 2021,3/5/2021,Friday,7:30 AM,1,0,0,0,0,1
Spring 2021,3/5/2021,Friday,8:30 AM,2,0,0,0,0,2
Spring 2021,3/5/2021,Friday,9:30 AM,5,0,0,0,1,6
Spring 2021,3/5/2021,Friday,10:30 AM,5,0,1,0,2,8
Spring 2021,3/5/2021,Friday,11:30 AM,3,0,2,0,3,8
Spring 2021,3/5/2021,Friday,12:30 PM,3,0,1,0,4,8
Spring 2021,3/5/2021,Friday,1:30 PM,6,0,3,0,2,11
Spring 2021,3/5/2021,Friday,2:30 PM,6,0,3,0,0,9
Spring 2021,3/5/2021,Friday,3:30 PM,7,0,2,0,0,9
Spring 2021,3/5/2021,Friday,4:30 PM,6,0,1,1,0,8
Spring 2021,3/5/2021,Friday,5:30 PM,5,0,0,0,0,5
Spring 2021,3/5/2021,Friday,6:30 PM,1,0,0,0,0,1
Spring 2021,3/5/2021,Friday,7:30 PM,1,0,0,0,0,1
Spring 2021,3/6/2021,Saturday,9:30 AM,1,0,0,0,2,3
Spring 2021,3/6/2021,Saturday,10:30 AM,3,0,0,0,3,6
Spring 2021,3/6/2021,Saturday,11:30 AM,7,0,0,0,1,8
Spring 2021,3/6/2021,Saturday,12:30 PM,2,0,2,0,0,4
Spring 2021,3/6/2021,Saturday,1:30 PM,6,0,1,0,0,7
Spring 2021,3/6/2021,Saturday,2:30 PM,5,0,1,0,0,6
Spring 2021,3/8/2021,Monday,7:30 AM,1,0,0,0,0,1
Spring 2021,3/8/2021,Monday,8:30 AM,1,0,0,0,0,1
Spring 2021,3/8/2021,Monday,9:30 AM,3,0,0,0,1,4
Spring 2021,3/8/2021,Monday,10:30 AM,5,0,3,0,0,8
Spring 2021,3/8/2021,Monday,11:30 AM,8,0,3,0,1,12
Spring 2021,3/8/2021,Monday,1:30 PM,9,0,5,0,2,16
Spring 2021,3/8/2021,Monday,12:30 PM,9,0,5,0,2,16
Spring 2021,3/8/2021,Monday,1:30 PM,6,0,3,0,1,10
Spring 2021,3/8/2021,Monday,2:30 PM,6,0,1,0,2,9
Spring 2021,3/8/2021,Monday,4:30 PM,4,0,0,1,3,8
Spring 2021,3/8/2021,Monday,5:30 PM,3,0,0,0,3,6
Spring 2021,3/8/2021,Monday,6:30 PM,2,0,0,0,0,2
Spring 2021,3/8/2021,Monday,7:30 PM,2,0,0,1,0,3
Spring 2021,3/9/2021,Tuesday,7:30 AM,0,0,0,0,1,1
Spring 2021,3/9/2021,Tuesday,8:30 AM,0,0,0,0,0,0
Spring 2021,3/9/2021,Tuesday,9:30 AM,1,0,0,0,0,1
Spring 2021,3/9/2021,Tuesday,10:30 AM,4,0,0,0,0,4
Spring 2021,3/9/2021,Tuesday,11:30 AM,8,0,0,0,0,8
Spring 2021,3/9/2021,Tuesday,12:30 PM,7,0,1,0,1,9
Spring 2021,3/9/2021,Tuesday,1:30 PM,9,0,1,0,0,10
Spring 2021,3/9/2021,Tuesday,2:30 PM,5,0,1,0,0,6
Spring 2021,3/9/2021,Tuesday,3:30 PM,3,0,0,1,0,4
Spring 2021,3/9/2021,Tuesday,4:30 PM,6,0,0,0,2,8
Spring 2021,3/9/2021,Tuesday,5:30 PM,3,0,0,0,1,4
Spring 2021,3/9/2021,Tuesday,6:30 PM,3,0,0,1,0,4
Spring 2021,3/9/2021,Tuesday,7:30 PM,1,0,0,0,0,1
Spring 2021,3/10/2021,Wednesday,7:30 AM,0,0,0,0,0,0
Spring 2021,3/10/2021,Wednesday,8:30 AM,2,0,0,0,0,2
Spring 2021,3/10/2021,Wednesday,9:30 AM,5,0,2,0,2,9
Spring 2021,3/10/2021,Wednesday,10:30 AM,8,0,2,0,1,11
Spring 2021,3/10/2021,Wednesday,11:30 AM,6,0,2,0,3,11
Spring 2021,3/10/2021,Wednesday,12:30 PM,7,0,4,0,1,12
Spring 2021,3/10/2021,Wednesday,1:30 PM,6,0,3,0,2,11
Spring 2021,3/10/2021,Wednesday,2:30 PM,4,0,1,0,3,8
Spring 2021,3/10/2021,Wednesday,4:30 PM,5,0,1,0,2,8
Spring 2021,3/10/2021,Wednesday,5:30 PM,4,1,0,0,0,5
Spring 2021,3/10/2021,Wednesday,6:30 PM,4,0,0,0,0,4
Spring 2021,3/10/2021,Wednesday,7:30 PM,0,0,0,0,0,0
Spring 2021,3/11/2021,Thursday,7:30 AM,0,0,0,0,0,0
Spring 2021,3/11/2021,Thursday,8:30 AM,2,0,0,0,0,2
Spring 2021,3/11/2021,Thursday,9:30 AM,3,0,0,0,0,3
Spring 2021,3/11/2021,Thursday,10:30 AM,2,0,2,0,0,4
Spring 2021,3/11/2021,Thursday,11:30 AM,8,0,1,0,0,9
Spring 2021,3/11/2021,Thursday,12:30 PM,4,0,2,0,1,7
Spring 2021,3/11/2021,Thursday,1:30 PM,4,0,1,0,0,5
Spring 2021,3/11/2021,Thursday,2:30 PM,7,0,0,0,0,7
Spring 2021,3/11/2021,Thursday,3:30 PM,5,0,0,0,1,6
Spring 2021,3/11/2021,Thursday,4:30 PM,7,0,0,0,0,7
Spring 2021,3/11/2021,Thursday,5:30 PM,4,0,0,0,4,8
Spring 2021,3/11/2021,Thursday,6:30 PM,2,0,0,0,0,2
Spring 2021,3/11/2021,Thursday,7:30 PM,1,0,0,0,0,1
Spring 2021,3/12/2021,Friday,7:30 AM,0,0,0,0,0,0
Spring 2021,3/12/2021,Friday,8:30 AM,1,0,1,0,0,2
Spring 2021,3/12/2021,Friday,10:30 AM,1,0,1,0,0,2
Spring 2021,3/12/2021,Friday,10:30 AM,6,0,1,0,0,7
Spring 2021,3/12/2021,Friday,11:30 AM,5,0,1,0,1,7
Spring 2021,3/12/2021,Friday,12:30 PM,4,0,1,0,1,6
Spring 2021,3/12/2021,Friday,1:30 PM,5,0,0,0,1,6
Spring 2021,3/12/2021,Friday,2:30 PM,4,0,0,0,1,5
Spring 2021,3/12/2021,Friday,4:30 PM,1,0,0,0,0,1
Spring 2021,3/12/2021,Friday,5:30 PM,2,0,0,0,0,2
Spring 2021,3/12/2021,Friday,6:30 PM,1,0,0,0,0,1
Spring 2021,3/12/2021,Friday,7:30 PM,0,0,0,0,0,0
Spring 2021,3/13/2021,Saturday,9:30 AM,1,0,0,0,0,1
Spring 2021,3/13/2021,Saturday,10:30 AM,2,0,1,0,0,3
Spring 2021,3/13/2021,Saturday,10:30 AM,2,0,0,0,0,2
Spring 2021,3/13/2021,Saturday,11:30 AM,2,0,1,0,0,3
Spring 2021,3/13/2021,Saturday,12:30 PM,2,0,2,0,0,4
Spring 2021,3/13/2021,Saturday,1:30 PM,2,0,1,0,0,3
Spring 2021,3/13/2021,Saturday,2:30 PM,0,0,2,0,2,4
Spring 2021,3/13/2021,Saturday,2:30 PM,0,0,2,0,0,2
Spring 2021,3/22/2021,Monday,7:30 AM,1,0,0,0,0,1
Spring 2021,3/22/2021,Monday,8:30 AM,1,0,0,0,0,1
Spring 2021,3/22/2021,Monday,9:30 AM,3,0,0,0,0,3
Spring 2021,3/22/2021,Monday,10:30 AM,4,0,0,0,0,4
Spring 2021,3/22/2021,Monday,11:30 AM,4,0,0,0,0,4
Spring 2021,3/22/2021,Monday,12:30 PM,2,0,0,0,0,2
Spring 2021,3/22/2021,Monday,1:30 PM,2,0,1,0,0,3
Spring 2021,3/22/2021,Monday,2:30 PM,3,0,1,0,0,4
Spring 2021,3/22/2021,Monday,3:30 PM,3,0,1,0,1,5
Spring 2021,3/22/2021,Monday,4:30 PM,6,0,0,0,0,6
Spring 2021,3/22/2021,Monday,5:30 PM,5,0,1,0,0,6
Spring 2021,3/22/2021,Monday,6:30 PM,5,0,1,0,2,8
Spring 2021,3/22/2021,Monday,6:30 PM,5,0,0,0,2,7
Spring 2021,3/22/2021,Monday,7:30 PM,1,0,0,1,0,2
Spring 2021,3/23/2021,Tuesday,7:30 AM,0,0,0,0,0,0
Spring 2021,3/23/2021,Tuesday,8:30 AM,2,0,0,0,0,2
Spring 2021,3/23/2021,Tuesday,9:30 AM,4,0,0,0,0,4
Spring 2021,3/23/2021,Tuesday,10:30 AM,1,0,0,0,0,1
Spring 2021,3/23/2021,Tuesday,11:30 AM,3,0,0,0,0,3
Spring 2021,3/23/2021,Tuesday,12:30 PM,2,0,1,0,0,3
Spring 2021,3/23/2021,Tuesday,1:30 PM,7,0,1,0,1,9
Spring 2021,3/23/2021,Tuesday,2:30 PM,3,0,0,0,0,3
Spring 2021,3/23/2021,Tuesday,3:30 PM,3,0,0,1,2,6
Spring 2021,3/23/2021,Tuesday,4:30 PM,3,0,0,0,0,3
Spring 2021,3/23/2021,Tuesday,5:30 PM,3,0,1,0,1,5
Spring 2021,3/23/2021,Tuesday,6:30 PM,3,0,0,2,0,5
Spring 2021,3/23/2021,Tuesday,7:30 PM,2,0,0,0,0,2
Spring 2021,3/24/2021,Wednesday,7:30 AM,0,0,0,0,0,0
Spring 2021,3/24/2021,Wednesday,8:30 AM,0,0,0,0,0,0
Spring 2021,3/24/2021,Wednesday,9:30 AM,0,0,0,0,0,0
Spring 2021,3/24/2021,Wednesday,10:30 AM,1,0,0,0,0,1
Spring 2021,3/24/2021,Wednesday,11:30 AM,2,0,0,0,0,2
Spring 2021,3/24/2021,Wednesday,12:30 PM,1,0,1,0,1,3
Spring 2021,3/24/2021,Wednesday,1:30 PM,2,0,2,0,1,5
Spring 2021,3/24/2021,Wednesday,2:30 PM,1,0,3,0,0,4
Spring 2021,3/24/2021,Wednesday,6:30 PM,5,0,3,0,0,8
Spring 2021,3/24/2021,Wednesday,7:30 PM,4,0,2,0,0,6
Spring 2021,3/25/2021,Thursday,7:30 AM,0,0,0,0,0,0
Spring 2021,3/25/2021,Thursday,8:30 AM,1,0,0,0,1,2
Spring 2021,3/25/2021,Thursday,9:30 AM,1,0,0,0,1,2
Spring 2021,3/25/2021,Thursday,10:30 AM,2,0,0,0,1,3
Spring 2021,3/25/2021,Thursday,11:30 AM,3,0,0,0,0,3
Spring 2021,3/25/2021,Thursday,12:30 PM,3,0,0,0,0,3
Spring 2021,3/25/2021,Thursday,1:30 PM,3,0,0,0,0,3
Spring 2021,3/25/2021,Thursday,2:30 PM,5,0,1,0,0,6
Spring 2021,3/25/2021,Thursday,3:30 PM,3,0,1,0,0,4
Spring 2021,3/25/2021,Thursday,4:30 PM,1,0,2,0,0,3
Spring 2021,3/25/2021,Thursday,5:30 PM,1,0,0,0,2,3
Spring 2021,3/25/2021,Thursday,4:30 PM,1,0,0,0,3,4
Spring 2021,3/25/2021,Thursday,6:30 PM,2,0,1,0,3,6
Spring 2021,3/25/2021,Thursday,7:30 PM,3,0,0,0,1,4
Spring 2021,3/25/2021,Thursday,7:30 PM,2,0,1,1,1,5
Spring 2021,3/26/2021,Friday,7:30 AM,1,0,0,0,0,1
Spring 2021,3/26/2021,Friday,8:30 AM,2,0,0,0,0,2
Spring 2021,3/26/2021,Friday,9:30 AM,3,0,0,0,0,3
Spring 2021,3/26/2021,Friday,10:30 AM,3,0,0,0,0,3
Spring 2021,3/26/2021,Friday,11:30 AM,3,0,1,0,2,6
Spring 2021,3/26/2021,Friday,12:30 PM,4,0,0,0,2,6
Spring 2021,3/26/2021,Friday,1:30 PM,3,0,0,0,1,4
Spring 2021,3/26/2021,Friday,2:30 PM,6,0,0,0,1,7
Spring 2021,3/26/2021,Friday,3:30 PM,4,0,0,0,1,5
Spring 2021,3/26/2021,Friday,4:30 PM,3,0,0,0,2,5
Spring 2021,3/26/2021,Friday,5:30 PM,1,0,0,0,2,3
Spring 2021,3/26/2021,Friday,6:30 PM,0,0,0,0,2,2
Spring 2021,3/26/2021,Friday,7:30 PM,0,0,0,0,0,0
Spring 2021,3/27/2021,Saturday,9:30 AM,0,0,0,0,0,0
Spring 2021,3/27/2021,Saturday,10:30 AM,1,0,0,0,1,2
Spring 2021,3/27/2021,Saturday,11:30 AM,2,0,2,0,0,4
Spring 2021,3/27/2021,Saturday,12:30 PM,2,0,0,0,0,2
Spring 2021,3/27/2021,Saturday,1:30 PM,5,0,1,0,0,6
Spring 2021,3/27/2021,Saturday,2:30 PM,3,0,0,0,0,3
Spring 2021,3/29/2021,Monday,7:30 AM,1,0,0,0,0,1
Spring 2021,3/29/2021,Monday,8:30 AM,1,0,0,0,0,1
Spring 2021,3/29/2021,Monday,9:30 AM,4,0,1,0,0,5
Spring 2021,3/29/2021,Monday,10:30 AM,5,0,2,0,0,7
Spring 2021,3/29/2021,Monday,11:30 AM,7,0,0,0,1,8
Spring 2021,3/29/2021,Monday,12:30 PM,2,0,2,0,1,5
Spring 2021,3/29/2021,Monday,1:30 PM,5,0,1,0,1,7
Spring 2021,3/29/2021,Monday,3:30 PM,3,0,2,0,1,6
Spring 2021,3/29/2021,Monday,3:30 PM,1,0,0,0,0,1
Spring 2021,3/29/2021,Monday,4:30 PM,3,0,0,0,1,4
Spring 2021,3/29/2021,Monday,5:30 PM,2,1,0,0,2,5
Spring 2021,3/29/2021,Monday,6:30 PM,3,0,0,1,0,4
Spring 2021,3/29/2021,Monday,7:30 PM,1,0,0,0,0,1
Spring 2021,3/30/2021,Tuesday,7:30 AM,0,0,0,0,0,0
Spring 2021,3/30/2021,Tuesday,8:30 AM,0,0,0,0,1,1
Spring 2021,3/30/2021,Tuesday,9:30 AM,1,0,0,0,1,2
Spring 2021,3/30/2021,Tuesday,10:30 AM,3,0,0,0,0,3
Spring 2021,3/30/2021,Tuesday,11:30 AM,3,0,0,0,0,3
Spring 2021,3/30/2021,Tuesday,1:30 PM,3,0,1,0,0,4
Spring 2021,3/30/2021,Tuesday,1:30 PM,6,0,2,0,0,8
Spring 2021,3/30/2021,Tuesday,2:30 PM,2,0,2,0,0,4
Spring 2021,3/30/2021,Tuesday,3:30 PM,3,0,0,0,2,5
Spring 2021,3/30/2021,Tuesday,4:30 PM,3,0,0,0,3,6
Spring 2021,3/30/2021,Tuesday,5:30 PM,2,0,0,0,3,5
Spring 2021,3/30/2021,Tuesday,6:30 PM,1,1,0,0,2,4
Spring 2021,3/30/2021,Tuesday,7:30 PM,1,0,0,0,1,2
Spring 2021,3/31/2021,Wednesday,7:30 AM,1,0,0,0,0,1
Spring 2021,3/31/2021,Wednesday,8:30 AM,0,0,0,0,1,1
Spring 2021,3/31/2021,Wednesday,9:30 AM,2,0,0,0,0,2
Spring 2021,3/31/2021,Wednesday,10:30 AM,3,0,0,0,0,3
Spring 2021,3/31/2021,Wednesday,11:30 AM,11,0,0,0,5,16
Spring 2021,3/31/2021,Wednesday,12:30 PM,2,0,0,0,1,3
Spring 2021,3/31/2021,Wednesday,1:30 PM,4,0,0,0,0,4
Spring 2021,3/31/2021,Wednesday,1:30 PM,5,0,0,0,0,5
Spring 2021,3/31/2021,Wednesday,2:30 PM,3,0,0,0,0,3
Spring 2021,3/31/2021,Wednesday,3:30 PM,4,0,0,1,0,5
Spring 2021,3/31/2021,Wednesday,4:30 PM,3,1,0,0,0,4
Spring 2021,3/31/2021,Wednesday,5:30 PM,2,0,0,0,0,2
Spring 2021,3/31/2021,Wednesday,6:30 PM,0,0,0,0,0,0
Spring 2021,3/31/2021,Wednesday,7:30 PM,2,0,0,0,0,2
Spring 2021,4/1/2021,Thursday,7:30 AM,2,0,0,0,0,2
Spring 2021,4/1/2021,Thursday,8:30 AM,1,0,1,0,0,2
Spring 2021,4/1/2021,Thursday,9:30 AM,1,0,3,0,0,4
Spring 2021,4/1/2021,Thursday,10:30 AM,0,0,5,0,0,5
Spring 2021,4/1/2021,Thursday,11:30 AM,4,0,3,0,0,7
Spring 2021,4/1/2021,Thursday,12:30 PM,6,0,1,0,0,7
Spring 2021,4/1/2021,Thursday,1:30 PM,3,0,3,0,0,6
Spring 2021,4/1/2021,Thursday,2:30 PM,2,0,1,0,0,3
Spring 2021,4/1/2021,Thursday,3:30 PM,4,1,0,0,1,6
Spring 2021,4/1/2021,Thursday,3:30 PM,3,0,1,0,0,4
Spring 2021,4/1/2021,Thursday,4:30 PM,4,0,2,0,2,8
Spring 2021,4/1/2021,Thursday,5:30 PM,2,0,0,0,0,2
Spring 2021,4/1/2021,Thursday,6:30 PM,2,0,0,0,0,2
Spring 2021,4/1/2021,Thursday,7:30 PM,1,0,0,0,0,1
Spring 2021,4/2/2021,Friday,7:30 AM,1,0,0,0,0,1
Spring 2021,4/2/2021,Friday,8:30 AM,2,0,0,0,0,2
Spring 2021,4/2/2021,Friday,9:30 AM,1,0,0,0,0,1
Spring 2021,4/2/2021,Friday,10:30 AM,3,0,0,0,1,4
Spring 2021,4/2/2021,Friday,11:30 AM,3,0,1,0,3,7
Spring 2021,4/2/2021,Friday,12:30 PM,4,0,2,0,4,10
Spring 2021,4/2/2021,Friday,1:30 PM,2,0,2,0,2,6
Spring 2021,4/2/2021,Friday,2:30 PM,2,0,2,0,0,4
Spring 2021,4/2/2021,Friday,4:30 PM,1,0,0,0,0,1
Spring 2021,4/2/2021,Friday,5:30 PM,1,0,0,0,1,2
Spring 2021,4/2/2021,Friday,6:30 PM,0,0,0,0,1,1
Spring 2021,4/2/2021,Friday,7:30 PM,1,0,0,0,1,2
Spring 2021,4/3/2021,Saturday,8:30 AM,0,0,0,0,0,0
Spring 2021,4/3/2021,Saturday,9:30 AM,0,0,0,0,0,0
Spring 2021,4/3/2021,Saturday,9:30 AM,0,0,0,0,1,1
Spring 2021,4/3/2021,Saturday,10:30 AM,1,0,0,0,3,4
Spring 2021,4/3/2021,Saturday,11:30 AM,2,0,0,0,2,4
Spring 2021,4/3/2021,Saturday,1:30 PM,2,0,0,0,2,4
Spring 2021,4/3/2021,Saturday,12:30 PM,2,0,0,0,2,4
Spring 2021,4/3/2021,Saturday,1:30 PM,0,0,0,0,3,3
Spring 2021,4/3/2021,Saturday,2:30 PM,1,0,0,0,0,1
Spring 2021,4/5/2021,Monday,7:30 AM,0,0,0,0,0,0
Spring 2021,4/5/2021,Monday,8:30 AM,2,0,0,0,0,2
Spring 2021,4/5/2021,Monday,9:30 AM,4,0,0,0,0,4
Spring 2021,4/5/2021,Monday,10:30 AM,6,0,0,0,2,8
Spring 2021,4/5/2021,Monday,11:30 AM,7,0,5,0,1,13
Spring 2021,4/5/2021,Monday,1:30 PM,8,0,1,0,3,12
Spring 2021,4/5/2021,Monday,1:30 PM,4,0,0,0,1,5
Spring 2021,4/5/2021,Monday,2:30 PM,7,0,2,0,0,9
Spring 2021,4/5/2021,Monday,3:30 PM,3,0,0,2,0,5
Spring 2021,4/5/2021,Monday,4:30 PM,1,1,0,0,0,2
Spring 2021,4/5/2021,Monday,4:30 PM,2,0,1,0,0,3
Spring 2021,4/5/2021,Monday,5:30 PM,3,0,1,0,0,4
Spring 2021,4/5/2021,Monday,5:30 PM,0,0,1,5,0,6
Spring 2021,4/5/2021,Monday,6:30 PM,1,0,0,0,0,1
Spring 2021,4/5/2021,Monday,7:30 PM,0,0,0,0,0,0
Spring 2021,4/5/2021,Monday,5:30 PM,0,0,0,0,0,0
Spring 2021,4/6/2021,Tuesday,7:30 AM,0,0,0,0,0,0
Spring 2021,4/6/2021,Tuesday,8:30 AM,0,0,0,0,0,0
Spring 2021,4/6/2021,Tuesday,9:30 AM,2,0,0,0,0,2
Spring 2021,4/6/2021,Tuesday,10:30 AM,3,0,0,0,0,3
Spring 2021,4/6/2021,Tuesday,11:30 AM,8,0,1,0,0,9
Spring 2021,4/6/2021,Tuesday,12:30 PM,12,0,0,0,1,13
Spring 2021,4/6/2021,Tuesday,1:30 PM,7,0,0,0,0,7
Spring 2021,4/6/2021,Tuesday,2:30 PM,6,0,0,0,0,6
Spring 2021,4/6/2021,Tuesday,1:30 PM,7,0,1,0,0,8
Spring 2021,4/6/2021,Tuesday,4:30 PM,5,0,0,0,1,6
Spring 2021,4/6/2021,Tuesday,3:30 PM,6,0,0,0,1,7
Spring 2021,4/6/2021,Tuesday,3:30 PM,4,0,0,1,0,5
Spring 2021,4/6/2021,Tuesday,6:30 PM,7,0,0,0,0,7
Spring 2021,4/6/2021,Tuesday,7:30 PM,17,0,1,0,0,18
Spring 2021,4/7/2021,Wednesday,7:30 AM,0,0,0,0,0,0
Spring 2021,4/7/2021,Wednesday,8:30 AM,0,0,0,0,0,0
Spring 2021,4/7/2021,Wednesday,9:30 AM,4,0,0,0,0,4
Spring 2021,4/7/2021,Wednesday,10:30 AM,5,0,1,0,2,8
Spring 2021,4/7/2021,Wednesday,11:30 AM,5,0,2,0,1,8
Spring 2021,4/7/2021,Wednesday,12:30 PM,7,0,4,0,2,13
Spring 2021,4/7/2021,Wednesday,1:30 PM,1,3,0,0,1,5
Spring 2021,4/7/2021,Wednesday,1:30 PM,3,0,0,0,0,3
Spring 2021,4/7/2021,Wednesday,3:30 PM,4,0,1,0,3,8
Spring 2021,4/7/2021,Wednesday,4:30 PM,5,0,0,0,1,6
Spring 2021,4/7/2021,Wednesday,5:30 PM,4,0,0,0,1,5
Spring 2021,4/7/2021,Wednesday,6:30 PM,4,0,0,0,1,5
Spring 2021,4/7/2021,Wednesday,6:30 PM,2,0,0,0,2,4
Spring 2021,4/7/2021,Wednesday,7:30 PM,3,0,0,0,2,5
Spring 2021,4/8/2021,Thursday,7:30 AM,1,0,0,0,0,1
Spring 2021,4/8/2021,Thursday,8:30 AM,2,0,0,0,1,3
Spring 2021,4/8/2021,Thursday,9:30 AM,2,0,0,0,1,3
Spring 2021,4/8/2021,Thursday,11:30 AM,4,0,1,0,2,7
Spring 2021,4/8/2021,Thursday,11:30 AM,6,0,0,0,0,6
Spring 2021,4/8/2021,Thursday,12:30 PM,6,0,0,0,1,7
Spring 2021,4/8/2021,Thursday,12:30 PM,6,0,0,0,2,8
Spring 2021,4/8/2021,Thursday,2:30 PM,3,0,0,0,2,5
Spring 2021,4/8/2021,Thursday,1:30 PM,4,0,1,0,0,5
Spring 2021,4/8/2021,Thursday,3:30 PM,4,1,0,0,1,6
Spring 2021,4/8/2021,Thursday,4:30 PM,2,0,0,1,0,3
Spring 2021,4/8/2021,Thursday,5:30 PM,4,0,0,0,0,4
Spring 2021,4/8/2021,Thursday,6:30 PM,2,0,0,1,0,3
Spring 2021,4/8/2021,Thursday,7:30 PM,2,0,0,0,0,2
Spring 2021,4/9/2021,Friday,7:30 AM,2,0,0,0,0,2
Spring 2021,4/9/2021,Friday,8:30 AM,1,0,0,0,0,1
Spring 2021,4/9/2021,Friday,9:30 AM,3,0,0,0,0,3
Spring 2021,4/9/2021,Friday,10:30 AM,1,0,0,0,0,1
Spring 2021,4/9/2021,Friday,11:30 AM,1,0,0,0,1,2
Spring 2021,4/9/2021,Friday,12:30 PM,2,0,1,0,1,4
Spring 2021,4/9/2021,Friday,1:30 PM,3,0,1,0,0,4
Spring 2021,4/9/2021,Friday,2:30 PM,5,0,0,0,1,6
Spring 2021,4/9/2021,Friday,4:30 PM,1,0,0,0,0,1
Spring 2021,4/9/2021,Friday,5:30 PM,0,0,0,0,0,0
Spring 2021,4/9/2021,Friday,6:30 PM,0,0,0,0,0,0
Spring 2021,4/9/2021,Friday,7:30 PM,0,0,0,0,0,0
Spring 2021,4/10/2021,Saturday,8:30 AM,0,0,0,0,0,0
Spring 2021,4/10/2021,Saturday,9:30 AM,0,0,0,0,0,0
Spring 2021,4/10/2021,Saturday,10:30 AM,2,0,0,0,0,2
Spring 2021,4/10/2021,Saturday,11:30 AM,4,0,0,0,2,6
Spring 2021,4/10/2021,Saturday,12:30 PM,2,0,0,0,2,4
Spring 2021,4/10/2021,Saturday,1:30 PM,1,0,0,0,2,3
Spring 2021,4/10/2021,Saturday,2:30 PM,2,0,0,0,2,4
Spring 2021,4/12/2021,Monday,7:30 AM,2,0,0,0,0,2
Spring 2021,4/12/2021,Monday,8:30 AM,2,0,0,0,0,2
Spring 2021,4/12/2021,Monday,9:30 AM,5,0,0,0,0,5
Spring 2021,4/12/2021,Monday,10:30 AM,4,0,1,0,0,5
Spring 2021,4/12/2021,Monday,11:30 AM,5,0,8,0,1,14
Spring 2021,4/12/2021,Monday,12:30 PM,6,0,3,0,3,12
Spring 2021,4/12/2021,Monday,1:30 PM,6,0,3,0,2,11
Spring 2021,4/12/2021,Monday,2:30 PM,5,0,0,0,1,6
Spring 2021,4/12/2021,Monday,3:30 PM,4,0,0,0,0,4
Spring 2021,4/12/2021,Monday,4:30 PM,5,0,0,0,0,5
Spring 2021,4/12/2021,Monday,5:30 PM,7,0,0,0,0,7
Spring 2021,4/12/2021,Monday,6:30 PM,1,0,0,0,0,1
Spring 2021,4/12/2021,Monday,7:30 PM,3,0,0,0,0,3
Spring 2021,4/13/2021,Tuesday,7:30 AM,0,0,0,0,0,0
Spring 2021,4/13/2021,Tuesday,9:30 AM,2,0,0,0,1,3
Spring 2021,4/13/2021,Tuesday,9:30 AM,1,0,1,0,1,3
Spring 2021,4/13/2021,Tuesday,10:30 AM,3,0,0,0,0,3
Spring 2021,4/13/2021,Tuesday,11:30 AM,10,0,2,0,0,12
Spring 2021,4/13/2021,Tuesday,12:30 PM,10,0,2,0,0,12
Spring 2021,4/13/2021,Tuesday,1:30 PM,5,0,0,0,0,5
Spring 2021,4/13/2021,Tuesday,2:30 PM,8,0,0,0,0,8
Spring 2021,4/13/2021,Tuesday,12:30 PM,4,0,0,0,2,6
Spring 2021,4/13/2021,Tuesday,3:30 PM,4,0,0,0,2,6
Spring 2021,4/13/2021,Tuesday,3:30 PM,3,0,0,0,2,5
Spring 2021,4/13/2021,Tuesday,4:30 PM,5,0,0,0,2,7
Spring 2021,4/13/2021,Tuesday,5:30 PM,4,0,0,0,1,5
Spring 2021,4/13/2021,Tuesday,6:30 PM,1,0,0,1,0,2
Spring 2021,4/13/2021,Tuesday,7:30 PM,3,0,0,2,0,0
Spring 2021,4/14/2021,Wednesday,7:30 AM,0,0,0,0,0,0
Spring 2021,4/14/2021,Wednesday,8:30 AM,1,0,0,0,0,1
Spring 2021,4/14/2021,Wednesday,9:30 AM,8,0,1,0,1,10
Spring 2021,4/14/2021,Wednesday,10:30 AM,3,0,1,0,0,4
Spring 2021,4/14/2021,Wednesday,11:30 AM,2,0,3,0,2,7
Spring 2021,4/14/2021,Wednesday,11:30 AM,5,0,2,0,2,9
Spring 2021,4/14/2021,Wednesday,12:30 PM,5,0,2,0,2,9
Spring 2021,4/14/2021,Wednesday,1:30 PM,3,0,4,0,2,9
Spring 2021,4/14/2021,Wednesday,2:30 PM,3,0,3,0,1,7
Spring 2021,4/14/2021,Wednesday,3:30 PM,1,0,0,1,0,2
Spring 2021,4/14/2021,Wednesday,4:30 PM,2,1,2,0,1,6
Spring 2021,4/14/2021,Wednesday,5:30 PM,2,0,0,0,1,3
Spring 2021,4/14/2021,Wednesday,7:30 PM,0,1,1,0,0,2
Spring 2021,4/15/2021,Thursday,7:30 AM,0,0,0,0,0,0
Spring 2021,4/15/2021,Thursday,8:30 AM,1,0,0,0,1,2
Spring 2021,4/15/2021,Thursday,9:30 AM,5,0,1,0,1,7
Spring 2021,4/15/2021,Thursday,10:30 AM,4,0,2,0,2,8
Spring 2021,4/15/2021,Thursday,11:30 AM,6,0,2,0,0,8
Spring 2021,4/15/2021,Thursday,12:30 PM,7,0,4,0,1,12
Spring 2021,4/15/2021,Thursday,1:30 PM,7,0,3,0,0,10
Spring 2021,4/15/2021,Thursday,2:30 PM,7,0,1,0,0,8
Spring 2021,4/15/2021,Thursday,3:30 PM,3,0,0,0,0,3
Spring 2021,4/15/2021,Thursday,3:30 PM,2,0,0,0,1,3
Spring 2021,4/15/2021,Thursday,4:30 PM,2,0,0,0,1,3
Spring 2021,4/15/2021,Thursday,5:30 PM,5,0,0,0,1,6
Spring 2021,4/15/2021,Thursday,6:30 PM,2,0,0,0,0,2
Spring 2021,4/15/2021,Thursday,7:30 PM,4,1,0,0,0,5
Spring 2021,4/16/2021,Friday,7:30 AM,1,0,0,0,0,1
Spring 2021,4/16/2021,Friday,8:30 AM,2,0,0,0,0,2
Spring 2021,4/16/2021,Friday,9:30 AM,2,0,0,0,0,2
Spring 2021,4/16/2021,Friday,10:30 AM,4,0,1,0,0,5
Spring 2021,4/16/2021,Friday,11:30 AM,6,0,0,0,1,7
Spring 2021,4/16/2021,Friday,1:30 PM,3,0,1,0,1,5
Spring 2021,4/16/2021,Friday,2:30 PM,2,0,1,0,1,4
Spring 2021,4/16/2021,Friday,2:30 PM,1,0,2,0,1,4
Spring 2021,4/16/2021,Friday,4:30 PM,2,1,0,0,0,3
Spring 2021,4/16/2021,Friday,5:30 PM,1,1,0,0,3,5
Spring 2021,4/16/2021,Friday,6:30 PM,3,0,0,0,3,6
Spring 2021,4/16/2021,Friday,7:30 PM,1,0,0,0,3,4
Spring 2021,4/17/2021,Saturday,8:30 AM,1,0,0,0,0,1
Spring 2021,4/17/2021,Saturday,10:30 AM,0,0,0,0,0,0
Spring 2021,4/17/2021,Saturday,10:30 AM,1,0,0,0,0,1
Spring 2021,4/17/2021,Saturday,11:30 AM,0,0,0,0,0,0
Spring 2021,4/17/2021,Saturday,12:30 PM,1,0,0,0,0,1
Spring 2021,4/17/2021,Saturday,12:30 PM,0,0,0,0,0,0
Spring 2021,4/17/2021,Saturday,1:30 PM,2,0,0,0,0,2
Spring 2021,4/17/2021,Saturday,2:30 PM,2,0,0,0,0,2
Spring 2021,4/19/2021,Monday,7:30 AM,1,0,0,0,0,1
Spring 2021,4/19/2021,Monday,8:30 AM,1,0,0,0,0,1
Spring 2021,4/19/2021,Monday,9:30 AM,3,0,1,0,0,4
Spring 2021,4/19/2021,Monday,10:30 AM,3,1,0,0,0,4
Spring 2021,4/19/2021,Monday,11:30 AM,6,0,2,0,2,10
Spring 2021,4/19/2021,Monday,12:30 PM,8,0,1,0,2,11
Spring 2021,4/19/2021,Monday,1:30 PM,7,0,3,0,0,10
Spring 2021,4/19/2021,Monday,2:30 PM,5,0,3,0,0,8
Spring 2021,4/19/2021,Monday,3:30 PM,3,0,0,0,0,3
Spring 2021,4/19/2021,Monday,4:30 PM,4,1,0,0,0,5
Spring 2021,4/19/2021,Monday,5:30 PM,5,0,0,0,1,6
Spring 2021,4/19/2021,Monday,7:30 PM,3,0,0,0,1,4
Spring 2021,4/20/2021,Tuesday,7:30 AM,0,0,0,0,1,1
Spring 2021,4/20/2021,Tuesday,8:30 AM,0,0,0,0,0,0
Spring 2021,4/20/2021,Tuesday,9:30 AM,4,0,1,0,1,6
Spring 2021,4/20/2021,Tuesday,10:30 AM,3,0,1,0,2,6
Spring 2021,4/20/2021,Tuesday,11:30 AM,7,0,2,0,2,11
Spring 2021,4/20/2021,Tuesday,12:30 PM,6,0,1,0,0,7
Spring 2021,4/20/2021,Tuesday,1:30 PM,4,0,0,0,0,4
Spring 2021,4/20/2021,Tuesday,2:30 PM,5,0,0,0,0,5
Spring 2021,4/20/2021,Tuesday,3:30 PM,3,0,0,1,2,6
Spring 2021,4/20/2021,Tuesday,4:30 PM,4,0,1,0,1,6
Spring 2021,4/20/2021,Tuesday,5:30 PM,2,0,0,1,0,3
Spring 2021,4/20/2021,Tuesday,6:30 PM,4,2,0,0,0,6
Spring 2021,4/20/2021,Tuesday,7:30 PM,2,0,2,0,0,4
Spring 2021,4/21/2021,Wednesday,7:30 AM,2,0,0,0,0,2
Spring 2021,4/21/2021,Wednesday,8:30 AM,6,0,0,0,0,6
Spring 2021,4/21/2021,Wednesday,9:30 AM,5,0,1,0,0,6
Spring 2021,4/21/2021,Wednesday,10:30 AM,10,0,2,0,1,13
Spring 2021,4/21/2021,Wednesday,11:30 AM,5,0,4,0,1,10
Spring 2021,4/21/2021,Wednesday,12:30 PM,8,0,2,0,1,11
Spring 2021,4/21/2021,Wednesday,1:30 PM,6,0,2,0,1,9
Spring 2021,4/21/2021,Wednesday,1:30 PM,5,0,3,0,0,8
Spring 2021,4/21/2021,Wednesday,3:30 PM,6,0,3,1,3,13
Spring 2021,4/21/2021,Wednesday,4:30 PM,6,0,0,0,2,8
Spring 2021,4/21/2021,Wednesday,7:30 PM,5,1,0,0,3,9
Spring 2021,4/21/2021,Wednesday,7:30 PM,7,0,0,0,0,7
Spring 2021,4/22/2021,Thursday,7:30 AM,0,0,0,0,0,0
Spring 2021,4/22/2021,Thursday,8:30 AM,3,0,0,0,0,3
Spring 2021,4/22/2021,Thursday,9:30 AM,5,0,1,0,0,6
Spring 2021,4/22/2021,Thursday,10:30 AM,5,0,1,0,0,6
Spring 2021,4/22/2021,Thursday,11:30 AM,5,0,1,0,0,6
Spring 2021,4/22/2021,Thursday,12:30 PM,13,0,2,0,1,16
Spring 2021,4/22/2021,Thursday,1:30 PM,14,0,1,0,0,15
Spring 2021,4/22/2021,Thursday,2:30 PM,8,0,1,0,0,9
Spring 2021,4/22/2021,Thursday,12:30 PM,2,0,0,0,1,3
Spring 2021,4/22/2021,Thursday,3:30 PM,2,0,0,0,1,3
Spring 2021,4/22/2021,Thursday,4:30 PM,2,0,0,0,0,2
Spring 2021,4/22/2021,Thursday,5:30 PM,2,0,0,0,0,2
Spring 2021,4/22/2021,Thursday,6:30 PM,2,0,0,0,2,4
Spring 2021,4/22/2021,Thursday,7:30 PM,2,0,0,0,2,4
Spring 2021,4/23/2021,Friday,7:30 AM,3,0,0,0,1,4
Spring 2021,4/23/2021,Friday,9:30 AM,3,0,1,0,0,4
Spring 2021,4/23/2021,Friday,11:30 AM,3,0,2,1,1,7
Spring 2021,4/23/2021,Friday,12:30 PM,3,0,2,0,1,6
Spring 2021,4/23/2021,Friday,1:30 PM,4,0,4,0,1,9
Spring 2021,4/23/2021,Friday,2:30 PM,3,0,4,0,4,11
Spring 2021,4/23/2021,Friday,4:30 PM,1,0,0,0,7,8
Spring 2021,4/23/2021,Friday,5:30 PM,2,0,1,0,0,3
Spring 2021,4/23/2021,Friday,6:30 PM,0,0,1,0,0,1
Spring 2021,4/23/2021,Friday,7:30 PM,0,0,0,0,0,0
Spring 2021,4/24/2021,Saturday,9:30 AM,1,0,1,0,0,2
Spring 2021,4/24/2021,Saturday,9:30 AM,1,0,1,0,0,2
Spring 2021,4/24/2021,Saturday,10:30 AM,2,0,1,0,1,4
Spring 2021,4/24/2021,Saturday,11:30 AM,2,0,2,0,3,7
Spring 2021,4/24/2021,Saturday,12:30 PM,1,0,3,0,3,7
Spring 2021,4/24/2021,Saturday,2:30 PM,3,0,3,0,3,9
Spring 2021,4/26/2021,Monday,7:30 AM,1,0,0,0,0,1
Spring 2021,4/26/2021,Monday,8:30 AM,1,0,0,0,0,1
Spring 2021,4/26/2021,Monday,9:30 AM,3,0,1,1,1,6
Spring 2021,4/26/2021,Monday,10:30 AM,6,0,1,1,0,8
Spring 2021,4/26/2021,Monday,11:30 AM,6,0,2,1,2,11
Spring 2021,4/26/2021,Monday,12:30 PM,8,0,0,1,3,12
Spring 2021,4/26/2021,Monday,1:30 PM,1,0,2,1,1,5
Spring 2021,4/26/2021,Monday,2:30 PM,2,0,2,0,1,5
Spring 2021,4/26/2021,Monday,3:30 PM,4,0,0,1,0,5
Spring 2021,4/26/2021,Monday,4:30 PM,7,0,0,0,2,9
Spring 2021,4/26/2021,Monday,5:30 PM,5,0,0,0,2,7
Spring 2021,4/26/2021,Monday,5:30 PM,6,0,0,0,0,6
Spring 2021,4/26/2021,Monday,6:30 PM,5,0,1,0,0,6
Spring 2021,4/26/2021,Monday,7:30 PM,5,0,1,0,0,6
Spring 2021,4/27/2021,Tuesday,7:30 AM,0,0,0,0,1,1
Spring 2021,4/27/2021,Tuesday,8:30 AM,1,0,0,0,1,2
Spring 2021,4/27/2021,Tuesday,9:30 AM,2,0,0,0,0,2
Spring 2021,4/27/2021,Tuesday,10:30 AM,2,0,0,0,0,2
Spring 2021,4/27/2021,Tuesday,11:30 AM,6,0,1,0,0,7
Spring 2021,4/27/2021,Tuesday,12:30 PM,6,0,3,0,0,9
Spring 2021,4/27/2021,Tuesday,1:30 PM,6,0,1,0,0,7
Spring 2021,4/27/2021,Tuesday,2:30 PM,4,0,1,0,1,6
Spring 2021,4/27/2021,Tuesday,12:30 PM,1,1,0,0,2,4
Spring 2021,4/27/2021,Tuesday,3:30 PM,3,1,0,0,3,7
Spring 2021,4/27/2021,Tuesday,4:30 PM,1,2,0,1,3,7
Spring 2021,4/27/2021,Tuesday,5:30 PM,6,2,,,,
Spring 2021,4/27/2021,Tuesday,6:30 PM,5,0,0,1,0,6
Spring 2021,4/27/2021,Tuesday,7:30 PM,3,0,0,0,1,4
Spring 2021,4/28/2021,Wednesday,7:30 AM,0,0,0,0,0,0
Spring 2021,4/28/2021,Wednesday,8:30 AM,1,0,0,0,0,1
Spring 2021,4/28/2021,Wednesday,9:30 AM,4,0,1,0,0,5
Spring 2021,4/28/2021,Wednesday,10:30 AM,4,0,3,0,1,8
Spring 2021,4/28/2021,Wednesday,11:30 AM,4,0,4,0,2,10
Spring 2021,4/28/2021,Wednesday,12:30 PM,2,0,2,0,1,5
Spring 2021,4/28/2021,Wednesday,1:30 PM,5,0,2,0,0,7
Spring 2021,4/28/2021,Wednesday,2:30 PM,3,1,0,0,3,7
Spring 2021,4/28/2021,Wednesday,3:30 PM,1,0,0,0,3,4
Spring 2021,4/28/2021,Wednesday,4:30 PM,2,0,1,0,4,7
Spring 2021,4/28/2021,Wednesday,5:30 PM,2,0,1,0,3,6
Spring 2021,4/28/2021,Wednesday,6:30 PM,2,0,0,0,3,5
Spring 2021,4/28/2021,Wednesday,7:30 PM,1,0,0,0,2,3
Spring 2021,4/29/2021,Thursday,7:30 AM,1,0,0,0,0,1
Spring 2021,4/29/2021,Thursday,8:30 AM,1,0,0,0,1,2
Spring 2021,4/29/2021,Thursday,9:30 AM,4,0,0,0,1,5
Spring 2021,4/29/2021,Thursday,10:30 AM,5,0,1,0,2,8
Spring 2021,4/29/2021,Thursday,11:30 AM,5,0,1,0,1,7
Spring 2021,4/29/2021,Thursday,11:30 AM,8,0,2,0,0,10
Spring 2021,4/29/2021,Thursday,12:30 PM,5,0,4,0,0,9
Spring 2021,4/29/2021,Thursday,1:30 PM,6,0,3,0,0,9
Spring 2021,4/29/2021,Thursday,2:30 PM,4,0,2,0,0,6
Spring 2021,4/29/2021,Thursday,3:30 PM,5,1,0,0,1,7
Spring 2021,4/29/2021,Thursday,4:30 PM,5,2,0,0,1,8
Spring 2021,4/29/2021,Thursday,5:30 PM,3,1,0,1,2,7
Spring 2021,4/29/2021,Thursday,6:30 PM,2,2,1,0,2,7
Spring 2021,4/29/2021,Thursday,7:30 PM,1,1,0,0,1,3
Spring 2021,4/30/2021,Friday,7:30 AM,1,0,0,0,0,1
Spring 2021,4/30/2021,Friday,8:30 AM,1,0,0,0,0,1
Spring 2021,4/30/2021,Friday,9:30 AM,7,0,0,0,0,7
Spring 2021,4/30/2021,Friday,10:30 AM,5,0,2,0,1,8
Spring 2021,4/30/2021,Friday,11:30 AM,4,0,2,0,1,7
Spring 2021,4/30/2021,Friday,12:30 PM,5,0,3,0,1,9
Spring 2021,4/30/2021,Friday,1:30 PM,3,0,0,0,5,8
Spring 2021,4/30/2021,Friday,2:30 PM,5,0,0,0,6,11
Spring 2021,4/30/2021,Friday,3:30 PM,6,0,0,0,7,13
Spring 2021,4/30/2021,Friday,4:30 PM,4,1,0,0,4,9
Spring 2021,4/30/2021,Friday,5:30 PM,4,1,1,0,2,8
Spring 2021,4/30/2021,Friday,6:30 PM,6,1,1,0,0,8
Spring 2021,4/30/2021,Friday,7:30 PM,3,0,1,0,0,4
Spring 2021,5/1/2021,Saturday,9:30 AM,1,0,1,0,0,2
Spring 2021,5/1/2021,Saturday,10:30 AM,2,0,2,0,0,4
Spring 2021,5/1/2021,Saturday,11:30 AM,1,0,2,0,1,4
Spring 2021,5/1/2021,Saturday,12:30 PM,2,0,1,0,4,7
Spring 2021,5/1/2021,Saturday,1:30 PM,2,0,1,0,5,8
Spring 2021,5/1/2021,Saturday,2:30 PM,3,0,1,0,5,9
Spring 2021,5/3/2021,Monday,7:30 AM,0,0,2,0,0,2
Spring 2021,5/3/2021,Monday,8:30 AM,5,0,1,0,0,6
Spring 2021,5/3/2021,Monday,9:30 AM,5,0,1,0,0,6
Spring 2021,5/3/2021,Monday,10:30 AM,7,0,2,0,0,9
Spring 2021,5/3/2021,Monday,11:30 AM,8,0,4,0,1,13
Spring 2021,5/3/2021,Monday,12:30 PM,10,0,1,0,5,16
Spring 2021,5/3/2021,Monday,1:30 PM,4,0,2,0,6,12
Spring 2021,5/3/2021,Monday,2:30 PM,3,0,0,0,3,6
Spring 2021,5/3/2021,Monday,3:30 PM,1,1,0,1,0,3
Spring 2021,5/3/2021,Monday,4:30 PM,1,1,2,0,1,5
Spring 2021,5/3/2021,Monday,5:30 PM,3,0,1,0,3,7
Spring 2021,5/3/2021,Monday,5:30 PM,2,1,0,0,1,4
Spring 2021,5/3/2021,Monday,6:30 PM,3,0,0,0,0,3
Spring 2021,5/3/2021,Monday,7:30 PM,4,2,0,0,0,6
Spring 2021,5/4/2021,Tuesday,7:30 AM,2,0,0,0,0,2
Spring 2021,5/4/2021,Tuesday,8:30 AM,2,0,0,0,2,4
Spring 2021,5/4/2021,Tuesday,9:30 AM,2,0,3,0,3,8
Spring 2021,5/4/2021,Tuesday,10:30 AM,3,0,3,0,2,8
Spring 2021,5/4/2021,Tuesday,11:30 AM,5,0,3,0,0,8
Spring 2021,5/4/2021,Tuesday,12:30 PM,5,0,3,0,0,8
Spring 2021,5/4/2021,Tuesday,1:30 PM,4,0,3,0,0,7
Spring 2021,5/4/2021,Tuesday,2:30 PM,4,0,2,0,0,6
Spring 2021,5/4/2021,Tuesday,3:30 PM,1,2,0,0,0,3
Spring 2021,5/4/2021,Tuesday,4:30 PM,1,2,0,0,0,3
Spring 2021,5/4/2021,Tuesday,5:30 PM,2,2,0,2,2,8
Spring 2021,5/4/2021,Tuesday,6:30 PM,3,3,0,0,2,8
Spring 2021,5/4/2021,Tuesday,7:30 PM,3,3,0,0,0,6
Spring 2021,5/5/2021,Wednesday,7:30 AM,1,0,0,0,0,1
Spring 2021,5/5/2021,Wednesday,8:30 AM,1,0,1,0,0,2
Spring 2021,5/5/2021,Wednesday,9:30 AM,4,0,2,0,0,6
Spring 2021,5/5/2021,Wednesday,10:30 AM,5,0,2,0,0,7
Spring 2021,5/5/2021,Wednesday,11:30 AM,5,0,1,0,2,8
Spring 2021,5/5/2021,Wednesday,12:30 PM,7,0,3,0,3,13
Spring 2021,5/5/2021,Wednesday,1:30 PM,3,4,0,0,0,7
Spring 2021,5/5/2021,Wednesday,2:30 PM,2,0,3,0,0,5
Spring 2021,5/5/2021,Wednesday,3:30 PM,1,0,0,0,1,2
Spring 2021,5/5/2021,Wednesday,4:30 PM,6,0,0,0,1,7
Spring 2021,5/5/2021,Wednesday,5:30 PM,3,1,0,0,1,5
Spring 2021,5/5/2021,Wednesday,6:30 PM,3,0,1,0,2,6
Spring 2021,5/6/2021,Thursday,3:30 PM,6,1,0,0,0,7
Spring 2021,5/6/2021,Thursday,4:30 PM,9,1,0,0,0,10
Spring 2021,5/6/2021,Thursday,5:30 PM,2,0,0,0,3,5
Spring 2021,5/6/2021,Thursday,6:30 PM,2,0,0,0,2,4
Spring 2021,5/6/2021,Thursday,7:30 PM,2,0,0,0,2,4
Spring 2021,5/7/2021,Friday,7:30 AM,2,0,0,0,0,2
Spring 2021,5/7/2021,Friday,8:30 AM,4,0,0,0,0,4
Spring 2021,5/7/2021,Friday,9:30 AM,4,0,2,0,0,6
Spring 2021,5/7/2021,Friday,10:30 AM,5,0,2,0,0,7
Spring 2021,5/7/2021,Friday,11:30 AM,3,0,3,0,4,10
Spring 2021,5/7/2021,Friday,12:30 PM,5,0,4,0,3,12
Spring 2021,5/7/2021,Friday,1:30 PM,4,0,6,0,2,12
Spring 2021,5/7/2021,Friday,2:30 PM,4,0,3,0,3,10
Spring 2021,5/7/2021,Friday,4:30 PM,4,0,0,0,0,4
Spring 2021,5/7/2021,Friday,5:30 PM,2,0,0,0,0,2
Spring 2021,5/7/2021,Friday,6:30 PM,0,0,0,0,0,0
Spring 2021,5/8/2021,Saturday,10:30 AM,2,0,3,0,2,7
Spring 2021,5/8/2021,Saturday,11:30 AM,1,0,3,0,2,6
Spring 2021,5/8/2021,Saturday,12:30 PM,3,0,2,0,2,7
Spring 2021,5/8/2021,Saturday,2:30 PM,4,0,1,0,2,7
Spring 2021,5/8/2021,Saturday,2:30 PM,4,0,0,0,2,6
Spring 2021,5/10/2021,Monday,7:30 AM,2,0,0,0,0,2
Spring 2021,5/10/2021,Monday,8:30 AM,3,0,0,0,0,3
Spring 2021,5/10/2021,Monday,9:30 AM,2,0,1,1,0,4
Spring 2021,5/10/2021,Monday,10:30 AM,5,0,3,1,0,9
Spring 2021,5/10/2021,Monday,11:30 AM,5,0,1,0,2,8
Spring 2021,5/10/2021,Monday,12:30 PM,6,0,0,0,2,8
Spring 2021,5/10/2021,Monday,1:30 PM,7,0,3,0,0,10
Spring 2021,5/10/2021,Monday,2:30 PM,4,0,2,0,0,6
Spring 2021,5/10/2021,Monday,3:30 PM,5,2,0,0,0,7
Spring 2021,5/10/2021,Monday,4:30 PM,3,3,0,1,3,10
Spring 2021,5/10/2021,Monday,5:30 PM,3,2,0,0,4,9
Spring 2021,5/10/2021,Monday,6:30 PM,2,4,0,0,6,12
Spring 2021,5/10/2021,Monday,7:30 PM,2,1,0,0,6,9
Spring 2021,5/11/2021,Tuesday,7:30 AM,0,0,0,0,0,0
Spring 2021,5/11/2021,Tuesday,8:30 AM,5,0,1,0,0,6
Spring 2021,5/11/2021,Tuesday,9:30 AM,5,0,4,0,0,9
Spring 2021,5/11/2021,Tuesday,10:30 AM,6,0,2,0,0,8
Spring 2021,5/11/2021,Tuesday,11:30 AM,8,0,2,0,0,10
Spring 2021,5/11/2021,Tuesday,12:30 PM,12,1,3,0,0,16
Spring 2021,5/11/2021,Tuesday,1:30 PM,6,0,1,0,1,8
Spring 2021,5/11/2021,Tuesday,2:30 PM,8,1,1,0,1,11
Spring 2021,5/11/2021,Tuesday,3:30 PM,8,2,0,1,0,11
Spring 2021,5/11/2021,Tuesday,4:30 PM,3,2,0,0,3,8
Spring 2021,5/11/2021,Tuesday,5:30 PM,3,2,0,0,2,7
Spring 2021,5/11/2021,Tuesday,6:30 PM,6,4,0,0,2,12
Spring 2021,5/11/2021,Tuesday,7:30 PM,2,2,0,0,0,4
Spring 2021,5/12/2021,Wednesday,11:30 AM,10,0,1,0,1,12
Spring 2021,5/12/2021,Wednesday,12:30 PM,8,0,0,0,1,9
Spring 2021,5/12/2021,Wednesday,1:30 PM,12,0,3,0,3,18
Spring 2021,5/12/2021,Wednesday,2:30 PM,6,0,3,0,2,11
Spring 2021,5/12/2021,Wednesday,3:30 PM,4,2,0,2,1,9
Spring 2021,5/12/2021,Wednesday,4:30 PM,2,0,1,0,1,4
Spring 2021,5/12/2021,Wednesday,5:30 PM,3,0,0,0,2,5
Spring 2021,5/12/2021,Wednesday,6:30 PM,4,1,0,0,2,7
Spring 2021,5/12/2021,Wednesday,7:30 PM,2,0,0,0,0,2
Spring 2021,5/13/2021,Thursday,7:30 AM,0,0,0,0,0,0
Spring 2021,5/13/2021,Thursday,8:30 AM,2,0,1,0,0,3
Spring 2021,5/13/2021,Thursday,9:30 AM,8,0,2,0,0,10
Spring 2021,5/13/2021,Thursday,10:30 AM,6,0,3,0,2,11
Spring 2021,5/13/2021,Thursday,11:30 AM,10,0,2,0,0,12
Spring 2021,5/13/2021,Thursday,12:30 PM,7,0,2,0,0,9
Spring 2021,5/13/2021,Thursday,1:30 PM,6,0,1,1,1,9
Spring 2021,5/13/2021,Thursday,2:30 PM,12,0,2,1,0,15
Spring 2021,5/13/2021,Thursday,3:30 PM,6,1,0,1,3,11
Spring 2021,5/13/2021,Thursday,4:30 PM,3,0,0,0,2,5
Spring 2021,5/13/2021,Thursday,5:30 PM,4,1,0,0,3,8
Spring 2021,5/13/2021,Thursday,6:30 PM,2,1,0,0,2,5
Spring 2021,5/13/2021,Thursday,7:30 PM,0,0,0,0,0,0
Spring 2021,5/14/2021,Friday,7:30 AM,1,0,0,0,0,1
Spring 2021,5/14/2021,Friday,8:30 AM,1,0,0,0,0,1
Spring 2021,5/14/2021,Friday,9:30 AM,4,0,0,0,1,5
Spring 2021,5/14/2021,Friday,10:30 AM,4,0,0,0,1,5
Spring 2021,5/14/2021,Friday,11:30 AM,5,0,0,0,2,7
Spring 2021,5/14/2021,Friday,12:30 PM,6,0,0,0,2,8
Spring 2021,5/14/2021,Friday,1:30 PM,4,0,0,0,2,6
Spring 2021,5/14/2021,Friday,2:30 PM,3,0,0,0,1,4
Spring 2021,5/14/2021,Friday,3:30 PM,2,0,0,0,0,2
Spring 2021,5/14/2021,Friday,4:30 PM,3,0,0,0,2,5
Spring 2021,5/14/2021,Friday,5:30 PM,1,0,0,0,2,3
Spring 2021,5/15/2021,Saturday,8:30 AM,0,0,1,0,0,1
Spring 2021,5/15/2021,Saturday,10:30 AM,3,0,1,0,0,4
Spring 2021,5/15/2021,Saturday,10:30 AM,2,0,1,0,0,3
Spring 2021,5/15/2021,Saturday,11:30 AM,4,0,0,0,0,4
Spring 2021,5/15/2021,Saturday,1:30 PM,2,0,0,0,0,2
Spring 2021,5/15/2021,Saturday,12:30 PM,2,0,0,0,0,2
Spring 2021,5/15/2021,Saturday,2:30 PM,2,0,0,0,0,2
