Date,DayOfWeek,Time,Computers,Silent,Quiet,Active,Other,Total,
1/14/2019,Monday,7:30 AM,3,0,1,0,0,4,
1/14/2019,Monday,8:30 AM,5,2,3,1,0,11,
1/14/2019,Monday,9:30 AM,21,2,7,4,2,36,
1/14/2019,Monday,10:30 AM,25,2,24,4,5,60,
1/14/2019,Monday,11:30 AM,23,4,18,2,7,54,
1/14/2019,Monday,1:30 PM,18,7,17,5,4,51,
1/14/2019,Monday,2:30 PM,32,4,8,2,6,52,
1/14/2019,Monday,3:30 PM,19,5,9,3,3,39,
1/14/2019,Monday,4:30 PM,27,7,6,2,4,46,
1/14/2019,Monday,5:30 PM,18,2,3,4,5,32,
1/14/2019,Monday,6:30 PM,15,1,2,0,1,19,
1/14/2019,Monday,7:30 PM,14,2,7,1,1,25,
1/14/2019,Monday,8:30 PM,9,0,5,1,1,16,
1/15/2019,Tuesday,8:30 AM,6,2,3,4,2,17,
1/15/2019,Tuesday,9:30 AM,15,2,5,6,1,29,
1/15/2019,Tuesday,10:30 AM,29,3,20,8,4,64,
1/15/2019,Tuesday,11:30 AM,26,5,13,4,4,52,
1/15/2019,Tuesday,12:30 PM,34,7,38,2,9,90,
1/15/2019,Tuesday,1:30 PM,16,5,14,2,3,40,
1/15/2019,Tuesday,2:30 PM,18,5,11,6,2,42,
1/15/2019,Tuesday,3:30 PM,13,6,14,1,1,35,
1/15/2019,Tuesday,4:30 PM,15,5,9,1,0,30,
1/15/2019,Tuesday,5:30 PM,11,3,5,1,0,20,
1/15/2019,Tuesday,6:30 PM,13,2,3,1,0,19,
1/15/2019,Tuesday,7:30 PM,9,1,3,0,0,13,
1/15/2019,Tuesday,8:30 PM,8,1,4,0,0,13,
1/16/2019,Wednesday,7:30 AM,5,0,0,0,0,5,
1/16/2019,Wednesday,8:30 AM,7,1,2,0,0,10,
1/16/2019,Wednesday,9:30 AM,13,1,11,1,0,26,
1/16/2019,Wednesday,10:30 AM,20,0,17,3,2,42,
1/16/2019,Wednesday,11:30 AM,28,1,20,9,6,64,
1/16/2019,Wednesday,12:30 PM,40,12,48,12,13,125,
1/16/2019,Wednesday,1:30 PM,23,8,19,2,6,58,
1/16/2019,Wednesday,2:30 PM,11,2,8,0,3,24,
1/16/2019,Wednesday,3:30 PM,9,5,7,2,3,26,
1/16/2019,Wednesday,5:30 PM,9,1,3,2,1,16,
1/16/2019,Wednesday,6:30 PM,8,2,4,4,2,20,
1/16/2019,Wednesday,7:30 PM,5,1,2,4,0,12,
1/16/2019,Wednesday,8:30 PM,9,1,1,0,0,11,
1/17/2019,Thursday,7:30 AM,6,0,0,0,1,7,
1/17/2019,Thursday,8:30 AM,9,1,8,3,1,22,
1/17/2019,Thursday,9:30 AM,19,3,14,5,3,44,
1/17/2019,Thursday,10:30 AM,20,7,21,5,1,54,
1/17/2019,Thursday,11:30 AM,24,4,17,7,3,55,
1/17/2019,Thursday,12:30 PM,44,13,39,11,9,116,
1/17/2019,Thursday,1:30 PM,23,5,17,3,0,48,
1/17/2019,Thursday,3:30 PM,15,3,16,5,0,39,
1/17/2019,Thursday,4:30 PM,12,3,11,4,2,32,
1/17/2019,Thursday,5:30 PM,12,3,6,4,0,25,
1/17/2019,Thursday,6:30 PM,12,1,4,3,0,20,
1/17/2019,Thursday,7:30 PM,2,2,3,0,0,7,
1/17/2019,Thursday,8:30 PM,5,1,3,0,1,10,
1/18/2019,Friday,7:30 AM,1,0,1,0,0,2,
1/18/2019,Friday,8:30 AM,4,1,2,0,0,7,
1/18/2019,Friday,9:30 AM,4,0,1,0,0,5,
1/18/2019,Friday,10:30 AM,10,0,3,0,0,13,
1/18/2019,Friday,12:30 PM,15,0,3,0,3,21,
1/18/2019,Friday,1:30 PM,14,1,0,0,1,16,
1/18/2019,Friday,5:30 PM,11,0,7,0,0,18,
1/18/2019,Friday,6:30 PM,5,1,6,1,0,13,
1/18/2019,Friday,7:30 PM,4,0,0,0,1,5,
1/18/2019,Friday,8:30 PM,2,0,0,0,0,2,
1/19/2019,Saturday,9:30 AM,3,0,4,0,2,9,
1/19/2019,Saturday,10:30 AM,4,0,2,0,1,7,
1/19/2019,Saturday,11:30 AM,5,0,2,0,2,9,
1/19/2019,Saturday,12:30 PM,6,2,2,0,0,10,
1/19/2019,Saturday,1:30 PM,5,2,3,0,0,10,
1/19/2019,Saturday,2:30 PM,10,2,2,0,0,14,
1/19/2019,Saturday,3:30 PM,6,1,3,0,0,10,
1/19/2019,Saturday,4:30 PM,5,1,3,0,0,9,
1/19/2019,Saturday,5:30 PM,3,0,0,0,0,3,
1/22/2019,Tuesday,7:30 AM,2,0,0,0,1,3,
1/22/2019,Tuesday,8:30 AM,12,2,5,2,3,24,
1/22/2019,Tuesday,9:30 AM,14,2,9,5,3,33,
1/22/2019,Tuesday,11:30 AM,27,2,21,3,6,59,
1/22/2019,Tuesday,12:30 PM,48,8,38,8,7,109,
1/22/2019,Tuesday,1:30 PM,20,6,18,1,0,45,
1/22/2019,Tuesday,3:30 PM,12,3,15,2,1,33,
1/22/2019,Tuesday,4:30 PM,20,5,16,5,4,50,
1/22/2019,Tuesday,5:30 PM,21,8,7,1,1,38,
1/22/2019,Tuesday,6:30 PM,14,3,1,1,1,20,
1/22/2019,Tuesday,7:30 PM,11,2,1,0,0,14,
1/22/2019,Tuesday,8:30 PM,8,0,1,0,0,9,
1/23/2019,Wednesday,7:30 AM,4,0,0,0,0,4,
1/23/2019,Wednesday,8:30 AM,11,1,7,0,1,20,
1/23/2019,Wednesday,9:30 AM,19,6,9,1,0,35,
1/23/2019,Wednesday,10:30 AM,32,3,12,5,4,56,
1/23/2019,Wednesday,11:30 AM,30,6,19,5,4,64,
1/23/2019,Wednesday,12:30 PM,36,11,46,7,8,108,
1/23/2019,Wednesday,1:30 PM,26,9,22,5,1,63,
1/23/2019,Wednesday,2:30 PM,25,6,21,1,7,60,
1/23/2019,Wednesday,3:30 PM,17,6,16,0,4,43,
1/23/2019,Wednesday,5:30 PM,24,5,12,1,0,42,
1/23/2019,Wednesday,6:30 PM,5,2,7,3,0,17,
1/23/2019,Wednesday,7:30 PM,7,1,4,3,0,15,
1/23/2019,Wednesday,8:30 PM,6,2,4,3,0,15,
1/24/2019,Thursday,7:30 AM,4,0,0,0,0,4,
1/24/2019,Thursday,8:30 AM,8,2,3,2,0,15,
1/24/2019,Thursday,9:30 AM,18,5,16,4,2,45,
1/24/2019,Thursday,10:30 AM,22,7,21,4,2,56,
1/24/2019,Thursday,11:30 AM,21,5,22,2,3,53,
1/24/2019,Thursday,12:30 PM,39,6,44,4,3,96,
1/24/2019,Thursday,1:30 PM,14,6,12,2,2,36,
1/24/2019,Thursday,3:30 PM,22,3,13,1,0,39,
1/24/2019,Thursday,4:30 PM,14,3,14,5,0,36,
1/24/2019,Thursday,5:30 PM,16,2,20,5,0,43,
1/24/2019,Thursday,6:30 PM,8,1,9,2,0,20,
1/24/2019,Thursday,7:30 PM,13,1,5,2,0,21,
1/25/2019,Friday,7:30 AM,3,0,1,0,0,4,
1/25/2019,Friday,8:30 AM,6,1,0,1,0,8,
1/25/2019,Friday,9:30 AM,7,1,3,1,0,12,
1/25/2019,Friday,10:30 AM,14,1,5,1,1,22,
1/25/2019,Friday,12:30 PM,16,2,3,1,3,25,
1/25/2019,Friday,5:30 PM,10,2,5,1,0,18,
1/25/2019,Friday,6:30 PM,6,4,3,0,0,13,
1/25/2019,Friday,7:30 PM,6,4,0,0,0,10,
1/25/2019,Friday,8:30 PM,3,0,0,0,0,3,
1/26/2019,Saturday,9:30 AM,0,0,2,0,0,2,
1/26/2019,Saturday,10:30 AM,1,1,2,0,0,4,
1/26/2019,Saturday,11:30 AM,10,1,3,0,0,14,
1/26/2019,Saturday,1:30 PM,6,1,2,0,0,9,
1/26/2019,Saturday,2:30 PM,6,0,5,1,0,12,
1/26/2019,Saturday,3:30 PM,5,0,5,2,0,12,
1/26/2019,Saturday,4:30 PM,13,0,5,0,0,18,
1/26/2019,Saturday,5:30 PM,3,1,0,0,0,4,
1/28/2019,Monday,7:30 AM,2,0,1,0,0,3,
1/28/2019,Monday,8:30 AM,8,0,6,0,1,15,
1/28/2019,Monday,9:30 AM,18,4,16,3,0,41,
1/28/2019,Monday,11:30 AM,23,5,25,8,3,64,
1/28/2019,Monday,1:30 PM,27,6,24,2,0,59,
1/28/2019,Monday,2:30 PM,24,6,21,0,8,59,
1/28/2019,Monday,3:30 PM,19,8,9,5,0,41,
1/28/2019,Monday,6:30 PM,14,5,5,0,0,24,
1/28/2019,Monday,7:30 PM,14,4,5,3,0,26,
1/28/2019,Monday,8:30 PM,16,4,6,3,0,29,
1/29/2019,Tuesday,7:30 AM,0,0,0,0,0,0,
1/29/2019,Tuesday,8:30 AM,16,3,3,6,1,29,
1/29/2019,Tuesday,9:30 AM,24,2,10,6,4,46,
1/29/2019,Tuesday,10:30 AM,29,3,15,9,3,59,
1/29/2019,Tuesday,11:30 AM,25,5,18,2,4,54,
1/29/2019,Tuesday,12:30 PM,44,7,28,5,9,93,
1/29/2019,Tuesday,1:30 PM,17,4,18,2,0,41,
1/29/2019,Tuesday,3:30 PM,17,3,17,5,0,42,
1/29/2019,Tuesday,4:30 PM,11,3,9,6,0,29,
1/29/2019,Tuesday,5:30 PM,13,6,11,1,2,33,
1/29/2019,Tuesday,6:30 PM,13,2,6,1,0,22,
1/29/2019,Tuesday,7:30 PM,6,1,6,2,0,15,
1/30/2019,Wednesday,7:30 AM,4,0,0,0,0,4,
1/30/2019,Wednesday,8:30 AM,9,3,9,3,5,29,
1/30/2019,Wednesday,9:30 AM,23,4,12,4,3,46,
1/30/2019,Wednesday,10:30 AM,23,8,15,7,5,58,
1/30/2019,Wednesday,11:30 AM,26,8,25,6,3,68,
1/30/2019,Wednesday,12:30 PM,40,21,44,11,13,129,
1/30/2019,Wednesday,1:30 PM,28,9,17,8,2,64,
1/30/2019,Wednesday,2:30 PM,23,6,22,4,7,62,
1/30/2019,Wednesday,3:30 PM,20,5,17,4,5,51,
1/30/2019,Wednesday,4:30 PM,22,5,9,1,4,41,
1/30/2019,Wednesday,5:30 PM,22,6,12,6,0,46,
1/30/2019,Wednesday,6:30 PM,5,5,3,2,0,15,
1/30/2019,Wednesday,7:30 PM,9,5,2,6,0,22,
1/30/2019,Wednesday,8:30 PM,4,4,3,3,0,14,
1/31/2019,Thursday,7:30 AM,4,0,0,0,0,4,
1/31/2019,Thursday,8:30 AM,5,0,7,2,2,16,
1/31/2019,Thursday,9:30 AM,17,3,20,2,1,43,
1/31/2019,Thursday,10:30 AM,29,3,29,8,3,72,
1/31/2019,Thursday,11:30 AM,18,4,20,3,2,47,
1/31/2019,Thursday,12:30 PM,34,5,47,8,5,99,
1/31/2019,Thursday,1:30 PM,10,7,18,1,2,38,
1/31/2019,Thursday,3:30 PM,15,7,13,5,0,40,
1/31/2019,Thursday,4:30 PM,26,8,11,4,0,49,
1/31/2019,Thursday,5:30 PM,11,5,9,4,0,29,
1/31/2019,Thursday,6:30 PM,8,1,1,2,0,12,
1/31/2019,Thursday,7:30 PM,8,0,1,1,0,10,
1/31/2019,Thursday,8:30 PM,8,0,1,1,0,10,
2/1/2019,Friday,7:30 AM,1,0,0,0,0,1,
2/1/2019,Friday,8:30 AM,3,1,0,0,0,4,
2/1/2019,Friday,9:30 AM,2,3,0,0,0,5,
2/1/2019,Friday,11:30 AM,7,2,2,0,1,12,
2/1/2019,Friday,12:30 PM,11,3,6,0,0,20,
2/1/2019,Friday,5:30 PM,9,3,4,2,0,18,
2/1/2019,Friday,6:30 PM,7,3,7,0,0,17,
2/1/2019,Friday,7:30 PM,7,3,6,0,1,17,
2/1/2019,Friday,8:30 PM,1,3,5,0,0,9,
2/2/2019,Saturday,9:30 AM,2,0,2,0,0,4,
2/2/2019,Saturday,10:30 AM,2,0,8,0,0,10,
2/2/2019,Saturday,12:30 PM,17,3,9,2,0,31,
2/2/2019,Saturday,1:30 PM,10,2,9,3,0,24,
2/2/2019,Saturday,2:30 PM,15,2,4,0,0,21,
2/2/2019,Saturday,3:30 PM,14,2,8,0,0,24,
2/2/2019,Saturday,4:30 PM,11,2,9,0,2,24,
2/2/2019,Saturday,5:30 PM,2,0,0,0,0,2,
2/4/2019,Monday,7:30 AM,6,0,0,0,0,6,
2/4/2019,Monday,8:30 AM,11,3,10,1,0,25,
2/4/2019,Monday,9:30 AM,29,3,18,6,0,56,
2/4/2019,Monday,10:30 AM,20,6,26,8,0,60,
2/4/2019,Monday,11:30 AM,23,5,19,3,2,52,
2/4/2019,Monday,12:30 PM,42,13,41,16,10,122,
2/4/2019,Monday,1:30 PM,25,8,20,5,0,58,
2/4/2019,Monday,2:30 PM,24,8,15,4,2,53,
2/4/2019,Monday,3:30 PM,14,4,12,1,2,33,
2/4/2019,Monday,4:30 PM,16,4,13,0,0,33,
2/4/2019,Monday,5:30 PM,26,6,17,4,0,53,
2/4/2019,Monday,6:30 PM,16,5,12,7,0,40,
2/4/2019,Monday,7:30 PM,14,3,11,4,2,34,
2/4/2019,Monday,8:30 PM,16,2,9,2,0,29,
2/5/2019,Tuesday,8:30 AM,11,4,7,3,0,25,
2/5/2019,Tuesday,9:30 AM,13,5,22,6,1,47,
2/5/2019,Tuesday,10:30 AM,29,9,26,10,4,78,
2/5/2019,Tuesday,11:30 AM,14,4,15,6,2,41,
2/5/2019,Tuesday,12:30 PM,33,11,39,7,7,97,
2/5/2019,Tuesday,1:30 PM,19,9,23,2,0,53,
2/5/2019,Tuesday,3:30 PM,18,7,13,8,1,47,
2/5/2019,Tuesday,4:30 PM,23,4,9,5,1,42,
2/5/2019,Tuesday,5:30 PM,11,7,13,5,0,36,
2/5/2019,Tuesday,6:30 PM,7,3,5,2,0,17,
2/5/2019,Tuesday,7:30 PM,7,3,4,3,3,20,
2/5/2019,Tuesday,8:30 PM,4,2,5,0,0,11,
2/6/2019,Wednesday,7:30 AM,2,0,0,0,0,2,
2/6/2019,Wednesday,8:30 AM,16,3,10,3,0,32,
2/6/2019,Wednesday,9:30 AM,30,4,15,7,0,56,
2/6/2019,Wednesday,10:30 AM,33,6,23,9,3,74,
2/6/2019,Wednesday,12:30 PM,22,3,24,7,2,58,
2/6/2019,Wednesday,1:30 PM,22,7,17,2,0,48,
2/6/2019,Wednesday,2:30 PM,21,3,21,4,0,49,
2/6/2019,Wednesday,3:30 PM,21,4,14,1,5,45,
2/6/2019,Wednesday,5:30 PM,16,4,14,4,0,38,
2/6/2019,Wednesday,6:30 PM,14,4,10,4,0,32,
2/6/2019,Wednesday,7:30 PM,4,2,8,1,0,15,
2/6/2019,Wednesday,8:30 PM,9,2,6,2,0,19,
2/7/2019,Thursday,7:30 AM,2,0,0,0,1,3,
2/7/2019,Thursday,8:30 AM,12,2,2,4,0,20,
2/7/2019,Thursday,9:30 AM,18,3,18,1,2,42,
2/7/2019,Thursday,10:30 AM,28,7,30,7,2,74,
2/7/2019,Thursday,12:30 PM,37,12,42,8,7,106,
2/7/2019,Thursday,1:30 PM,20,11,12,5,2,50,
2/7/2019,Thursday,2:30 PM,16,3,16,7,2,44,
2/7/2019,Thursday,3:30 PM,18,4,11,5,0,38,
2/7/2019,Thursday,4:30 PM,10,2,15,5,2,34,
2/7/2019,Thursday,5:30 PM,4,3,10,4,0,21,
2/7/2019,Thursday,6:30 PM,8,4,4,0,0,16,
2/7/2019,Thursday,7:30 PM,10,2,4,2,0,18,
2/7/2019,Thursday,8:30 PM,8,1,1,2,0,12,
2/8/2019,Friday,7:30 AM,1,0,0,0,0,1,
2/8/2019,Friday,8:30 AM,6,0,0,0,0,6,
2/8/2019,Friday,10:30 AM,14,1,3,2,0,20,
2/8/2019,Friday,12:30 PM,11,3,3,0,1,18,
2/8/2019,Friday,1:30 PM,8,3,3,1,2,17,
2/8/2019,Friday,2:30 PM,5,1,5,0,1,12,
2/8/2019,Friday,5:30 PM,8,3,2,3,0,16,
2/8/2019,Friday,6:30 PM,9,3,5,2,0,19,
2/8/2019,Friday,7:30 PM,6,2,4,0,0,12,
2/8/2019,Friday,8:30 PM,7,2,3,0,0,12,
2/9/2019,Saturday,9:30 AM,4,0,1,0,0,5,
2/9/2019,Saturday,10:30 AM,2,0,6,0,0,8,
2/9/2019,Saturday,11:30 AM,4,1,5,0,0,10,
2/9/2019,Saturday,12:30 PM,5,7,7,4,0,23,
2/9/2019,Saturday,2:30 PM,9,3,6,0,0,18,
2/9/2019,Saturday,3:30 PM,10,2,5,1,0,18,
2/9/2019,Saturday,4:30 PM,8,3,5,0,0,16,
2/11/2019,Monday,7:30 AM,3,0,1,0,0,4,
2/11/2019,Monday,8:30 AM,15,1,4,1,0,21,
2/11/2019,Monday,9:30 AM,15,3,11,5,2,36,
2/11/2019,Monday,11:30 AM,25,5,27,16,4,77,
2/11/2019,Monday,1:30 PM,30,6,21,9,3,69,
2/11/2019,Monday,2:30 PM,27,9,28,3,4,71,
2/11/2019,Monday,3:30 PM,14,7,14,2,0,37,
2/11/2019,Monday,4:30 PM,30,5,17,3,0,55,
2/11/2019,Monday,5:30 PM,14,7,15,13,0,49,
2/11/2019,Monday,6:30 PM,6,2,11,1,0,20,
2/11/2019,Monday,7:30 PM,5,1,6,7,0,19,
2/11/2019,Monday,8:30 PM,9,1,12,5,0,27,
2/12/2019,Tuesday,7:30 AM,1,1,0,0,0,2,
2/12/2019,Tuesday,8:30 AM,9,3,4,1,5,22,
2/12/2019,Tuesday,9:30 AM,17,1,20,2,3,43,
2/12/2019,Tuesday,10:30 AM,24,5,34,8,4,75,
2/12/2019,Tuesday,11:30 AM,26,2,31,6,3,68,
2/12/2019,Tuesday,12:30 PM,39,9,43,7,7,105,
2/12/2019,Tuesday,1:30 PM,21,5,12,3,2,43,
2/12/2019,Tuesday,3:30 PM,11,4,13,1,0,29,
2/12/2019,Tuesday,4:30 PM,15,4,11,2,1,33,
2/12/2019,Tuesday,5:30 PM,8,8,8,2,0,26,
2/12/2019,Tuesday,6:30 PM,10,3,2,1,0,16,
2/12/2019,Tuesday,7:30 PM,7,1,2,0,0,10,
2/12/2019,Tuesday,8:30 PM,6,0,3,0,0,9,
2/13/2019,Wednesday,7:30 AM,3,0,0,0,0,3,
2/13/2019,Wednesday,8:30 AM,8,1,10,1,2,22,
2/13/2019,Wednesday,9:30 AM,13,8,10,3,0,34,
2/13/2019,Wednesday,10:30 AM,29,7,24,3,3,66,
2/13/2019,Wednesday,1:30 PM,25,5,24,13,3,70,
2/13/2019,Wednesday,2:30 PM,27,7,17,7,2,60,
2/13/2019,Wednesday,3:30 PM,19,5,16,3,1,44,
2/13/2019,Wednesday,4:30 PM,19,3,9,2,0,33,
2/13/2019,Wednesday,5:30 PM,12,4,17,1,0,34,
2/13/2019,Wednesday,7:30 PM,8,1,7,3,0,19,
2/13/2019,Wednesday,8:30 PM,11,1,6,1,0,19,
2/14/2019,Thursday,7:30 AM,9,2,0,0,3,14,
2/14/2019,Thursday,8:30 AM,19,2,4,3,0,28,
2/14/2019,Thursday,9:30 AM,18,4,20,6,4,52,
2/14/2019,Thursday,10:30 AM,30,6,20,12,5,73,
2/14/2019,Thursday,11:30 AM,25,10,12,4,1,52,
2/14/2019,Thursday,12:30 PM,22,7,28,7,0,64,
2/14/2019,Thursday,1:30 PM,20,5,8,0,2,35,
2/14/2019,Thursday,2:30 PM,22,7,10,9,2,50,
2/14/2019,Thursday,3:30 PM,20,5,15,4,0,44,
2/14/2019,Thursday,4:30 PM,20,3,14,5,0,42,
2/14/2019,Thursday,7:30 PM,9,0,1,4,0,14,
2/14/2019,Thursday,8:30 PM,4,0,0,2,0,6,
2/15/2019,Friday,7:30 AM,1,0,0,0,0,1,
2/15/2019,Friday,8:30 AM,4,0,0,0,0,4,
2/15/2019,Friday,9:30 AM,3,0,1,0,0,4,
2/15/2019,Friday,11:30 AM,6,3,4,0,1,14,
2/15/2019,Friday,12:30 PM,9,4,2,0,1,16,
2/15/2019,Friday,2:30 PM,8,3,1,0,0,12,
2/15/2019,Friday,5:30 PM,5,3,1,3,0,12,
2/15/2019,Friday,6:30 PM,9,1,3,3,0,16,
2/15/2019,Friday,7:30 PM,5,1,3,1,0,10,
2/15/2019,Friday,8:30 PM,2,1,2,0,0,5,
2/16/2019,Saturday,9:30 AM,0,0,2,0,0,2,
2/16/2019,Saturday,10:30 AM,4,2,3,0,1,10,
2/16/2019,Saturday,11:30 AM,7,2,4,0,2,15,
2/16/2019,Saturday,1:30 PM,7,1,2,2,2,14,
2/16/2019,Saturday,2:30 PM,4,1,3,1,0,9,
2/16/2019,Saturday,3:30 PM,8,2,7,2,0,19,
2/16/2019,Saturday,4:30 PM,7,0,3,1,0,11,
2/16/2019,Saturday,5:30 PM,3,0,0,2,0,5,
2/18/2019,Monday,7:30 AM,2,0,0,0,0,2,
2/18/2019,Monday,8:30 AM,9,2,10,2,0,23,
2/18/2019,Monday,9:30 AM,16,6,13,4,0,39,
2/18/2019,Monday,10:30 AM,24,13,28,7,4,76,
2/18/2019,Monday,2:30 PM,34,10,19,1,7,71,
2/18/2019,Monday,3:30 PM,25,7,13,3,3,51,
2/18/2019,Monday,4:30 PM,17,7,15,0,2,41,
2/18/2019,Monday,5:30 PM,24,7,17,0,1,49,
2/18/2019,Monday,7:30 PM,11,2,10,2,6,31,
2/18/2019,Monday,8:30 PM,6,1,9,2,2,20,
2/19/2019,Tuesday,7:30 AM,10,0,1,0,2,13,
2/19/2019,Tuesday,8:30 AM,6,1,9,4,3,23,
2/19/2019,Tuesday,10:30 AM,34,7,25,10,5,81,
2/19/2019,Tuesday,11:30 AM,21,5,27,3,3,59,
2/19/2019,Tuesday,12:30 PM,37,4,39,4,3,87,
2/19/2019,Tuesday,1:30 PM,25,6,14,4,2,51,
2/19/2019,Tuesday,2:30 PM,24,9,14,2,0,49,
2/19/2019,Tuesday,3:30 PM,20,6,12,4,0,42,
2/19/2019,Tuesday,4:30 PM,20,4,9,4,0,37,
2/19/2019,Tuesday,5:30 PM,19,3,9,5,1,37,
2/19/2019,Tuesday,6:30 PM,16,1,5,1,2,25,
2/19/2019,Tuesday,7:30 PM,17,0,6,1,1,25,
2/19/2019,Tuesday,8:30 PM,5,0,0,0,0,5,
2/20/2019,Wednesday,7:30 AM,4,0,0,0,0,4,
2/20/2019,Wednesday,8:30 AM,13,2,13,3,0,31,
2/20/2019,Wednesday,9:30 AM,23,5,12,4,1,45,
2/20/2019,Wednesday,10:30 AM,23,7,14,12,0,56,
2/20/2019,Wednesday,11:30 AM,24,10,24,4,0,62,
2/20/2019,Wednesday,12:30 PM,39,10,39,9,7,104,
2/20/2019,Wednesday,1:30 PM,34,6,15,14,3,72,
2/20/2019,Wednesday,2:30 PM,2,3,7,8,2,22,
2/20/2019,Wednesday,3:30 PM,17,5,10,3,3,38,
2/20/2019,Wednesday,4:30 PM,17,6,13,0,2,38,
2/20/2019,Wednesday,5:30 PM,11,3,12,1,0,27,
2/20/2019,Wednesday,6:30 PM,9,3,8,2,3,25,
2/20/2019,Wednesday,7:30 PM,2,2,10,6,0,20,
2/20/2019,Wednesday,8:30 PM,6,1,6,5,0,18,
2/21/2019,Thursday,8:30 AM,10,0,4,2,1,17,
2/21/2019,Thursday,9:30 AM,17,6,21,7,3,54,
2/21/2019,Thursday,10:30 AM,21,6,26,3,7,63,
2/21/2019,Thursday,11:30 AM,23,8,35,2,3,71,
2/21/2019,Thursday,12:30 PM,34,8,40,4,4,90,
2/21/2019,Thursday,1:30 PM,19,7,17,5,5,53,
2/21/2019,Thursday,2:30 PM,13,4,7,5,0,29,
2/21/2019,Thursday,3:30 PM,26,4,10,3,0,43,
2/21/2019,Thursday,4:30 PM,29,3,13,5,1,51,
2/21/2019,Thursday,5:30 PM,14,3,13,3,0,33,
2/21/2019,Thursday,6:30 PM,15,2,2,2,1,22,
2/21/2019,Thursday,8:30 PM,9,0,1,0,0,10,
2/22/2019,Friday,8:30 AM,3,0,1,1,0,5,
2/22/2019,Friday,9:30 AM,7,0,1,1,1,10,
2/22/2019,Friday,10:30 AM,11,6,3,4,0,24,
2/22/2019,Friday,12:30 PM,14,2,2,1,2,21,
2/22/2019,Friday,2:30 PM,8,1,4,0,0,13,
2/22/2019,Friday,5:30 PM,13,2,3,1,0,19,
2/22/2019,Friday,6:30 PM,5,2,5,1,0,13,
2/22/2019,Friday,7:30 PM,7,0,4,1,0,12,
2/22/2019,Friday,8:30 PM,1,0,0,0,0,1,
2/22/2019,Saturday,9:30 AM,2,0,2,0,0,4,
2/23/2019,Saturday,10:30 AM,4,0,5,0,0,9,
2/23/2019,Saturday,11:30 AM,8,0,5,0,0,13,
2/23/2019,Saturday,12:30 PM,5,1,12,0,0,18,
2/23/2019,Saturday,1:30 PM,9,1,6,0,0,16,
2/23/2019,Saturday,2:30 PM,6,1,5,0,0,12,
2/23/2019,Saturday,3:30 PM,9,3,4,0,0,16,
2/23/2019,Saturday,4:30 PM,9,2,5,0,2,18,
2/23/2019,Saturday,5:30 PM,1,1,0,0,0,2,
2/25/2019,Monday,7:30 AM,4,0,1,0,0,5,
2/25/2019,Monday,8:30 AM,14,3,7,1,0,25,
2/25/2019,Monday,9:30 AM,18,4,13,8,3,46,
2/25/2019,Monday,10:30 AM,20,12,17,11,2,62,
2/25/2019,Monday,11:30 AM,23,6,21,10,4,64,
2/25/2019,Monday,12:30 PM,38,14,33,18,4,107,
2/25/2019,Monday,1:30 PM,25,7,15,5,2,54,
2/25/2019,Monday,2:30 PM,16,7,19,2,1,45,
2/25/2019,Monday,3:30 PM,25,5,10,3,1,44,
2/25/2019,Monday,4:30 PM,24,5,6,5,2,42,
2/25/2019,Monday,5:30 PM,11,7,29,6,4,57,
2/25/2019,Monday,6:30 PM,4,4,8,3,1,20,
2/25/2019,Monday,7:30 PM,7,2,3,2,1,15,
2/25/2019,Monday,8:30 PM,7,2,6,2,1,18,
2/26/2019,Tuesday,7:30 AM,2,1,1,0,0,4,
2/26/2019,Tuesday,8:30 AM,7,2,10,2,1,22,
2/26/2019,Tuesday,10:30 AM,13,5,23,0,2,43,
2/26/2019,Tuesday,11:30 AM,25,7,20,2,2,56,
2/26/2019,Tuesday,1:30 PM,21,6,14,3,4,48,
2/26/2019,Tuesday,3:30 PM,15,2,17,6,0,40,
2/26/2019,Tuesday,4:30 PM,16,4,9,7,0,36,
2/26/2019,Tuesday,5:30 PM,13,4,7,4,1,29,
2/26/2019,Tuesday,6:30 PM,10,0,9,2,0,21,
2/26/2019,Tuesday,7:30 PM,13,0,7,1,0,21,
2/26/2019,Tuesday,8:30 PM,4,1,3,0,0,8,
2/27/2019,Wednesday,7:30 AM,0,0,0,0,0,0,
2/27/2019,Wednesday,8:30 AM,10,2,8,2,1,23,
2/27/2019,Wednesday,9:30 AM,19,4,16,6,2,47,
2/27/2019,Wednesday,11:30 AM,17,6,24,3,3,53,
2/27/2019,Wednesday,12:30 PM,23,11,26,7,2,69,
2/27/2019,Wednesday,1:30 PM,24,9,14,0,3,50,
2/27/2019,Wednesday,2:30 PM,15,7,12,7,3,44,
2/27/2019,Wednesday,3:30 PM,19,5,17,6,0,47,
2/27/2019,Wednesday,4:30 PM,23,5,12,6,0,46,
2/27/2019,Wednesday,6:30 PM,10,1,4,2,2,19,
2/27/2019,Wednesday,7:30 PM,14,1,3,1,0,19,
2/27/2019,Wednesday,8:30 PM,5,0,0,0,0,5,
2/28/2019,Thursday,7:30 AM,1,0,0,0,0,1,
2/28/2019,Thursday,8:30 AM,1,0,2,0,0,3,
2/28/2019,Thursday,9:30 AM,3,0,1,0,0,4,
2/28/2019,Thursday,10:30 AM,3,0,1,0,0,4,
2/28/2019,Thursday,11:30 AM,7,0,1,1,1,10,
2/28/2019,Thursday,12:30 PM,7,0,1,2,2,12,
2/28/2019,Thursday,1:30 PM,2,1,3,1,1,8,
2/28/2019,Thursday,5:30 PM,5,3,6,4,0,18,
2/28/2019,Thursday,6:30 PM,11,3,6,5,0,25,
2/28/2019,Thursday,7:30 PM,5,3,5,1,0,14,
2/28/2019,Thursday,8:30 PM,5,0,0,0,0,5,
3/1/2019,Friday,7:30 AM,1,0,0,0,0,1,
3/1/2019,Friday,8:30 AM,1,0,2,0,0,3,
3/1/2019,Friday,9:30 AM,3,0,11,0,0,14,
3/1/2019,Friday,10:30 AM,3,0,1,0,0,4,
3/1/2019,Friday,11:30 AM,7,0,1,1,1,10,
3/1/2019,Friday,12:30 PM,7,0,1,2,2,12,
3/1/2019,Friday,1:30 PM,2,1,3,1,1,8,
3/1/2019,Friday,5:30 PM,5,3,6,4,0,18,
3/1/2019,Friday,6:30 PM,11,3,6,5,0,25,
3/1/2019,Friday,7:30 PM,5,3,5,1,0,14,
3/1/2019,Friday,8:30 PM,1,2,3,2,0,8,
3/2/2019,Saturday,10:30 AM,3,1,1,0,0,5,
3/2/2019,Saturday,11:30 AM,9,0,3,1,0,13,
3/2/2019,Saturday,12:30 PM,5,1,4,0,0,10,
3/2/2019,Saturday,1:30 PM,7,1,2,0,0,10,
3/2/2019,Saturday,2:30 PM,4,0,3,3,0,10,
3/2/2019,Saturday,3:30 PM,10,0,3,2,0,15,
3/2/2019,Saturday,4:30 PM,12,1,3,6,0,22,
3/4/2019,Monday,10:30 AM,22,5,14,5,0,46,
3/4/2019,Monday,1:30 PM,25,4,14,2,1,46,
3/4/2019,Monday,2:30 PM,28,5,17,4,4,58,
3/4/2019,Monday,3:30 PM,22,3,12,3,2,42,
3/4/2019,Monday,4:30 PM,20,6,15,5,0,46,
3/4/2019,Monday,5:30 PM,12,4,25,11,1,53,
3/4/2019,Monday,6:30 PM,8,4,8,4,2,26,
3/4/2019,Monday,7:30 PM,7,2,10,2,0,21,
3/4/2019,Monday,8:30 PM,9,2,5,2,0,18,
3/5/2019,Tuesday,9:30 AM,15,3,16,3,2,39,
3/5/2019,Tuesday,10:30 AM,24,7,21,3,3,58,
3/5/2019,Tuesday,1:30 PM,23,10,23,4,2,62,
3/5/2019,Tuesday,2:30 PM,20,10,12,1,1,44,
3/5/2019,Tuesday,3:30 PM,15,5,18,3,0,41,
3/5/2019,Tuesday,4:30 PM,13,9,16,4,0,42,
3/5/2019,Tuesday,5:30 PM,10,8,10,0,1,29,
3/5/2019,Tuesday,6:30 PM,16,3,7,2,0,28,
3/5/2019,Tuesday,7:30 PM,9,4,6,2,0,21,
3/5/2019,Tuesday,8:30 PM,10,3,6,0,0,19,
3/6/2019,Wednesday,7:30 AM,1,0,0,0,0,1,
3/6/2019,Wednesday,8:30 AM,17,9,8,3,1,38,
3/6/2019,Wednesday,9:30 AM,21,5,17,5,0,48,
3/6/2019,Wednesday,10:30 AM,32,13,26,13,4,88,
3/6/2019,Wednesday,11:30 AM,24,14,24,12,6,80,
3/6/2019,Wednesday,1:30 PM,30,8,23,8,2,71,
3/6/2019,Wednesday,2:30 PM,31,8,14,2,4,59,
3/6/2019,Wednesday,3:30 PM,21,7,13,3,3,47,
3/6/2019,Wednesday,4:30 PM,18,6,12,4,0,40,
3/6/2019,Wednesday,5:30 PM,16,3,6,4,0,29,
3/6/2019,Wednesday,8:30 PM,9,5,5,1,0,20,
3/7/2019,Thursday,7:30 AM,11,0,1,1,0,13,
3/7/2019,Thursday,8:30 AM,18,1,9,5,0,33,
3/7/2019,Thursday,9:30 AM,14,3,14,3,0,34,
3/7/2019,Thursday,10:30 AM,17,8,24,15,1,65,
3/7/2019,Thursday,11:30 AM,18,4,20,4,1,47,
3/7/2019,Thursday,12:30 PM,33,7,39,8,5,92,
3/7/2019,Thursday,1:30 PM,11,6,9,1,0,27,
3/7/2019,Thursday,2:30 PM,13,7,14,4,0,38,
3/7/2019,Thursday,3:30 PM,27,7,8,2,6,50,
3/7/2019,Thursday,4:30 PM,29,7,12,2,2,52,
3/7/2019,Thursday,5:30 PM,20,3,9,4,0,36,
3/7/2019,Thursday,6:30 PM,14,2,7,3,0,26,
3/7/2019,Thursday,7:30 PM,7,3,4,4,0,18,
3/7/2019,Thursday,8:30 PM,4,2,3,2,0,11,
3/8/2019,Friday,7:30 AM,1,0,1,0,0,2,
3/8/2019,Friday,8:30 AM,5,0,1,1,0,7,
3/8/2019,Friday,9:30 AM,9,1,4,4,1,19,
3/8/2019,Friday,10:30 AM,11,2,4,2,4,23,
3/8/2019,Friday,11:30 AM,6,2,3,1,1,13,
3/8/2019,Friday,12:30 PM,11,4,6,0,0,21,
3/8/2019,Friday,1:30 PM,10,5,6,0,0,21,
3/8/2019,Friday,5:30 PM,5,5,1,3,0,14,
3/8/2019,Friday,6:30 PM,6,3,4,2,0,15,
3/8/2019,Friday,7:30 PM,6,4,6,0,0,16,
3/8/2019,Friday,8:30 PM,6,2,4,0,0,12,
3/9/2019,Saturday,9:30 AM,1,0,0,0,0,1,
3/9/2019,Saturday,10:30 AM,5,0,5,0,0,10,
3/9/2019,Saturday,11:30 AM,6,0,4,0,0,10,
3/9/2019,Saturday,1:30 PM,11,1,3,1,0,16,
3/9/2019,Saturday,2:30 PM,19,1,7,1,0,28,
3/9/2019,Saturday,3:30 PM,10,1,5,1,0,17,
3/9/2019,Saturday,4:30 PM,13,0,3,2,0,18,
3/9/2019,Saturday,5:30 PM,0,0,0,0,0,0,
3/11/2019,Monday,7:30 AM,3,0,0,0,0,3,
3/11/2019,Monday,8:30 AM,9,5,5,2,0,21,
3/11/2019,Monday,9:30 AM,15,5,14,7,0,41,
3/11/2019,Monday,10:30 AM,25,6,19,6,5,61,
3/11/2019,Monday,11:30 AM,22,7,22,12,0,63,
3/11/2019,Monday,12:30 PM,34,13,30,13,1,91,
3/11/2019,Monday,1:30 PM,26,8,14,9,1,58,
3/11/2019,Monday,2:30 PM,26,7,20,3,2,58,
3/11/2019,Monday,3:30 PM,19,8,12,0,2,41,
3/11/2019,Monday,4:30 PM,32,11,9,0,3,55,
3/11/2019,Monday,5:30 PM,26,10,12,2,1,51,
3/12/2019,Tuesday,8:30 AM,4,1,3,2,0,10,
3/12/2019,Tuesday,9:30 AM,13,4,16,0,3,36,
3/12/2019,Tuesday,10:30 AM,27,7,28,8,1,71,
3/12/2019,Tuesday,11:30 AM,23,4,22,6,2,57,
3/12/2019,Tuesday,1:30 PM,14,11,14,3,7,49,
3/12/2019,Tuesday,2:30 PM,11,9,13,3,3,39,
3/12/2019,Tuesday,3:30 PM,19,4,13,4,0,40,
3/12/2019,Tuesday,4:30 PM,14,7,11,3,1,36,
3/12/2019,Tuesday,5:30 PM,19,7,11,8,3,48,
3/12/2019,Tuesday,7:30 PM,15,0,8,4,3,30,
3/12/2019,Tuesday,8:30 PM,11,1,7,0,1,20,
3/13/2019,Wednesday,7:30 AM,3,0,1,0,0,4,
3/13/2019,Wednesday,8:30 AM,10,5,11,1,0,27,
3/13/2019,Wednesday,9:30 AM,14,5,15,3,2,39,
3/13/2019,Wednesday,10:30 AM,28,10,27,10,2,77,
3/13/2019,Wednesday,11:30 AM,17,12,24,9,1,63,
3/13/2019,Wednesday,12:30 PM,26,13,46,15,3,103,
3/13/2019,Wednesday,1:30 PM,16,14,16,9,1,56,
3/13/2019,Wednesday,2:30 PM,25,6,2,4,3,40,
3/13/2019,Wednesday,3:30 PM,25,8,9,2,1,45,
3/13/2019,Wednesday,4:30 PM,28,8,14,1,1,52,
3/13/2019,Wednesday,5:30 PM,12,4,12,2,3,33,
3/13/2019,Wednesday,6:30 PM,14,4,13,1,1,33,
3/13/2019,Wednesday,7:30 PM,17,2,11,1,0,31,
3/13/2019,Wednesday,8:30 PM,9,1,1,2,1,14,
3/14/2019,Thursday,7:30 AM,8,0,0,0,0,8,
3/14/2019,Thursday,8:30 AM,12,1,9,3,0,25,
3/14/2019,Thursday,9:30 AM,15,4,25,2,5,51,
3/14/2019,Thursday,10:30 AM,19,7,25,11,2,64,
3/14/2019,Thursday,11:30 AM,25,7,14,6,3,55,
3/14/2019,Thursday,12:30 PM,22,11,31,5,3,72,
3/14/2019,Thursday,1:30 PM,20,7,17,0,1,45,
3/14/2019,Thursday,2:30 PM,20,4,11,7,0,42,
3/14/2019,Thursday,3:30 PM,22,6,9,6,5,48,
3/14/2019,Thursday,4:30 PM,24,4,5,3,6,42,
3/14/2019,Thursday,5:30 PM,26,2,10,3,4,45,
3/14/2019,Thursday,6:30 PM,9,1,7,1,2,20,
3/14/2019,Thursday,8:30 PM,3,1,0,2,0,6,
3/15/2019,Friday,7:30 AM,1,0,0,0,0,1,
3/15/2019,Friday,8:30 AM,4,0,0,0,0,4,
3/15/2019,Friday,9:30 AM,3,0,0,0,0,3,
3/15/2019,Friday,11:30 AM,9,0,0,0,1,10,
3/15/2019,Friday,12:30 PM,10,0,0,0,1,11,
3/15/2019,Friday,1:30 PM,3,0,2,0,2,7,
3/15/2019,Friday,2:30 PM,7,0,3,0,1,11,
3/15/2019,Friday,5:30 PM,4,0,1,0,1,6,
3/15/2019,Friday,6:30 PM,7,0,2,0,0,9,
3/15/2019,Friday,7:30 PM,5,1,2,0,0,8,
3/15/2019,Friday,8:30 PM,5,0,0,0,0,5,
3/16/2019,Saturday,10:30 AM,3,0,0,1,3,7,
3/16/2019,Saturday,11:30 AM,5,0,0,0,5,10,
3/16/2019,Saturday,12:30 PM,5,0,1,0,4,10,
3/16/2019,Saturday,1:30 PM,9,2,1,0,1,13,
3/16/2019,Saturday,2:30 PM,7,2,0,0,0,9,
3/16/2019,Saturday,3:30 PM,4,1,0,0,0,5,
3/16/2019,Saturday,4:30 PM,3,0,3,0,0,6,
3/16/2019,Saturday,5:30 PM,3,0,0,0,0,3,
3/25/2019,Monday,7:30 AM,7,0,1,0,1,9,
3/25/2019,Monday,8:30 AM,15,3,8,2,0,28,
3/25/2019,Monday,9:30 AM,21,4,14,5,0,44,
3/25/2019,Monday,10:30 AM,22,7,27,7,0,63,
3/25/2019,Monday,11:30 AM,37,4,21,8,0,70,
3/25/2019,Monday,12:30 PM,30,10,30,10,0,80,
3/25/2019,Monday,1:30 PM,39,9,25,11,1,85,
3/25/2019,Monday,2:30 PM,15,7,13,0,0,35,
3/25/2019,Monday,3:30 PM,20,6,8,1,3,38,
3/25/2019,Monday,4:30 PM,31,3,9,0,0,43,
3/25/2019,Monday,6:30 PM,8,2,4,0,1,15,
3/25/2019,Monday,7:30 PM,11,2,5,0,0,18,
3/25/2019,Monday,8:30 PM,7,4,1,0,1,13,
3/26/2019,Tuesday,7:30 AM,2,1,3,0,0,6,
3/26/2019,Tuesday,8:30 AM,4,1,3,0,2,10,
3/26/2019,Tuesday,9:30 AM,18,2,6,3,2,31,
3/26/2019,Tuesday,10:30 AM,20,7,26,10,6,69,
3/26/2019,Tuesday,11:30 AM,42,6,25,3,5,81,
3/26/2019,Tuesday,12:30 PM,44,9,31,7,4,95,
3/26/2019,Tuesday,1:30 PM,34,9,15,3,2,63,
3/26/2019,Tuesday,2:30 PM,29,8,14,7,5,63,
3/26/2019,Tuesday,3:30 PM,23,5,13,2,3,46,
3/26/2019,Tuesday,5:30 PM,12,7,13,3,1,36,
3/26/2019,Tuesday,6:30 PM,6,3,4,3,0,16,
3/26/2019,Tuesday,7:30 PM,8,2,2,2,1,15,
3/26/2019,Tuesday,8:30 PM,6,1,5,2,0,14,
3/27/2019,Wednesday,7:30 AM,3,0,0,0,1,4,
3/27/2019,Wednesday,8:30 AM,11,2,7,1,0,21,
3/27/2019,Wednesday,9:30 AM,14,2,16,4,0,36,
3/27/2019,Wednesday,10:30 AM,22,5,22,7,0,56,
3/27/2019,Wednesday,11:30 AM,18,8,18,8,0,52,
3/27/2019,Wednesday,12:30 PM,28,14,40,5,0,87,
3/27/2019,Wednesday,1:30 PM,23,8,19,4,1,55,
3/27/2019,Wednesday,2:30 PM,24,7,18,0,2,51,
3/27/2019,Wednesday,3:30 PM,16,6,11,1,2,36,
3/27/2019,Wednesday,4:30 PM,18,6,10,1,2,37,
3/27/2019,Wednesday,5:30 PM,16,5,12,1,0,34,
3/27/2019,Wednesday,6:30 PM,9,2,12,1,1,25,
3/27/2019,Wednesday,7:30 PM,10,1,7,1,0,19,
3/27/2019,Wednesday,8:30 PM,9,1,4,1,0,15,
3/28/2019,Thursday,7:30 AM,4,0,2,0,0,6,
3/28/2019,Thursday,8:30 AM,10,0,3,1,1,15,
3/28/2019,Thursday,9:30 AM,7,1,7,4,2,21,
3/28/2019,Thursday,10:30 AM,18,2,24,3,1,48,
3/28/2019,Thursday,11:30 AM,27,6,17,5,3,58,
3/28/2019,Thursday,12:30 PM,34,13,38,9,5,99,
3/28/2019,Thursday,1:30 PM,32,8,20,2,3,65,
3/28/2019,Thursday,2:30 PM,18,6,11,6,0,41,
3/28/2019,Thursday,3:30 PM,24,6,12,4,3,49,
3/28/2019,Thursday,4:30 PM,16,3,16,6,0,41,
3/28/2019,Thursday,6:30 PM,8,3,8,1,0,20,
3/28/2019,Thursday,7:30 PM,6,2,4,0,0,12,
3/28/2019,Thursday,8:30 PM,7,1,2,0,0,10,
3/29/2019,Friday,7:30 AM,0,0,0,0,0,0,
3/29/2019,Friday,8:30 AM,0,1,0,0,0,1,
3/29/2019,Friday,9:30 AM,5,1,2,0,0,8,
3/29/2019,Friday,10:30 AM,6,0,1,0,0,7,
3/29/2019,Friday,11:30 AM,6,2,4,5,2,19,
3/29/2019,Friday,12:30 PM,8,2,7,2,1,20,
3/29/2019,Friday,5:30 PM,5,1,3,0,0,9,
3/29/2019,Friday,6:30 PM,3,3,3,0,0,9,
3/29/2019,Friday,7:30 PM,6,1,5,0,0,12,
3/29/2019,Friday,8:30 PM,2,3,2,0,0,7,
3/30/2019,Saturday,9:30 AM,0,0,0,0,0,0,
3/30/2019,Saturday,10:30 AM,0,0,0,0,0,0,
3/30/2019,Saturday,11:30 AM,8,1,2,0,0,11,
3/30/2019,Saturday,12:30 PM,2,1,3,2,1,9,
3/30/2019,Saturday,1:30 PM,5,0,2,1,0,8,
3/30/2019,Saturday,2:30 PM,4,0,2,3,1,10,
3/30/2019,Saturday,3:30 PM,4,0,3,0,1,8,
3/30/2019,Saturday,4:30 PM,3,0,2,0,0,5,
3/30/2019,Saturday,5:30 PM,0,1,1,0,4,6,
4/1/2019,Monday,7:30 AM,4,0,1,0,0,5,
4/1/2019,Monday,8:30 AM,14,2,7,0,0,23,
4/1/2019,Monday,9:30 AM,25,4,7,5,6,47,
4/1/2019,Monday,10:30 AM,27,7,14,7,3,58,
4/1/2019,Monday,11:30 AM,18,8,15,9,0,50,
4/1/2019,Monday,12:30 PM,43,15,42,18,0,118,
4/1/2019,Monday,1:30 PM,20,4,25,12,1,62,
4/1/2019,Monday,2:30 PM,26,6,27,3,2,64,
4/1/2019,Monday,4:30 PM,27,4,19,2,1,53,
4/1/2019,Monday,5:30 PM,15,8,11,1,1,36,
4/1/2019,Monday,6:30 PM,8,4,10,1,0,23,
4/1/2019,Monday,7:30 PM,10,2,8,1,0,21,
4/1/2019,Monday,8:30 PM,5,3,9,0,3,20,
4/2/2019,Tuesday,7:30 AM,2,0,0,0,0,2,
4/2/2019,Tuesday,8:30 AM,7,1,5,2,1,16,
4/2/2019,Tuesday,9:30 AM,11,1,9,1,1,23,
4/2/2019,Tuesday,10:30 AM,19,6,14,4,1,44,
4/2/2019,Tuesday,11:30 AM,20,11,20,5,0,56,
4/2/2019,Tuesday,12:30 PM,45,14,43,13,0,115,
4/2/2019,Tuesday,1:30 PM,30,6,17,3,3,59,
4/2/2019,Tuesday,2:30 PM,12,8,13,25,3,61,
4/2/2019,Tuesday,3:30 PM,15,5,12,3,1,36,
4/2/2019,Tuesday,4:30 PM,10,4,8,4,0,26,
4/2/2019,Tuesday,5:30 PM,10,6,10,0,1,27,
4/2/2019,Tuesday,6:30 PM,7,4,5,0,0,16,
4/2/2019,Tuesday,7:30 PM,20,5,7,0,2,34,
4/3/2019,Wednesday,7:30 AM,3,0,1,0,0,4,
4/3/2019,Wednesday,8:30 AM,10,2,9,2,0,23,
4/3/2019,Wednesday,9:30 AM,11,7,20,4,5,47,
4/3/2019,Wednesday,10:30 AM,34,7,21,10,0,72,
4/3/2019,Wednesday,11:30 AM,18,10,24,4,1,57,
4/3/2019,Wednesday,12:30 PM,36,14,37,10,2,99,
4/3/2019,Wednesday,1:30 PM,15,8,11,11,2,47,
4/3/2019,Wednesday,2:30 PM,27,7,14,4,2,54,
4/3/2019,Wednesday,3:30 PM,15,5,14,2,1,37,
4/3/2019,Wednesday,4:30 PM,12,3,7,3,0,25,
4/3/2019,Wednesday,6:30 PM,18,3,10,1,2,34,
4/3/2019,Wednesday,7:30 PM,16,3,3,0,2,24,
4/3/2019,Wednesday,8:30 PM,14,1,4,0,0,19,
4/4/2019,Thursday,7:30 AM,4,0,0,0,0,4,
4/4/2019,Thursday,8:30 AM,7,0,7,1,0,15,
4/4/2019,Thursday,9:30 AM,11,2,18,4,1,36,
4/4/2019,Thursday,10:30 AM,30,4,27,2,1,64,
4/4/2019,Thursday,11:30 AM,16,4,14,3,1,38,
4/4/2019,Thursday,12:30 PM,31,7,27,5,2,72,
4/4/2019,Thursday,1:30 PM,15,14,12,1,0,42,
4/4/2019,Thursday,2:30 PM,29,8,12,7,0,56,
4/4/2019,Thursday,3:30 PM,20,6,8,6,0,40,
4/4/2019,Thursday,5:30 PM,22,3,13,4,0,42,
4/4/2019,Thursday,6:30 PM,6,3,9,2,0,20,
4/4/2019,Thursday,7:30 PM,7,4,5,2,0,18,
4/4/2019,Thursday,8:30 PM,4,2,4,1,0,11,
4/5/2019,Friday,7:30 AM,2,0,0,0,0,2,
4/5/2019,Friday,8:30 AM,3,0,0,0,1,4,
4/5/2019,Friday,9:30 AM,9,1,8,1,0,19,
4/5/2019,Friday,10:30 AM,5,0,2,1,0,8,
4/5/2019,Friday,11:30 AM,15,2,0,2,1,20,
4/5/2019,Friday,5:30 PM,10,4,7,1,0,22,
4/5/2019,Friday,6:30 PM,7,1,3,1,0,12,
4/5/2019,Friday,7:30 PM,9,0,4,1,0,14,
4/5/2019,Friday,8:30 PM,4,1,4,2,0,11,
4/6/2019,Saturday,9:30 AM,0,0,0,1,0,1,
4/6/2019,Saturday,10:30 AM,2,1,5,1,0,9,
4/6/2019,Saturday,11:30 AM,2,3,6,0,0,11,
4/6/2019,Saturday,12:30 PM,7,2,5,1,0,15,
4/6/2019,Saturday,1:30 PM,0,4,5,4,0,13,
4/6/2019,Saturday,2:30 PM,8,2,3,0,0,13,
4/6/2019,Saturday,3:30 PM,11,0,3,0,0,14,
4/6/2019,Saturday,4:30 PM,6,0,4,0,0,10,
4/6/2019,Saturday,5:30 PM,2,0,0,0,0,2,
4/8/2019,Monday,7:30 AM,7,0,1,0,0,8,
4/8/2019,Monday,8:30 AM,11,2,6,1,0,20,
4/8/2019,Monday,9:30 AM,17,3,10,3,0,33,
4/8/2019,Monday,10:30 AM,26,3,16,7,0,52,
4/8/2019,Monday,11:30 AM,18,4,21,5,4,52,
4/8/2019,Monday,12:30 PM,34,11,43,13,3,104,
4/8/2019,Monday,1:30 PM,32,5,22,8,2,69,
4/8/2019,Monday,2:30 PM,26,5,16,4,2,53,
4/8/2019,Monday,3:30 PM,18,6,8,1,0,33,
4/8/2019,Monday,4:30 PM,9,7,1,2,0,19,
4/8/2019,Monday,5:30 PM,9,7,1,2,0,19,
4/8/2019,Monday,6:30 PM,8,3,1,0,1,13,
4/8/2019,Monday,7:30 PM,17,0,6,0,0,23,
4/8/2019,Monday,8:30 PM,5,1,3,0,1,10,
4/9/2019,Tuesday,7:30 AM,1,0,0,0,0,1,
4/9/2019,Tuesday,8:30 AM,12,5,8,20,0,45,
4/9/2019,Tuesday,9:30 AM,18,1,11,5,1,36,
4/9/2019,Tuesday,10:30 AM,26,5,19,7,3,60,
4/9/2019,Tuesday,11:30 AM,30,9,23,7,2,71,
4/9/2019,Tuesday,12:30 PM,44,5,33,12,4,98,
4/9/2019,Tuesday,1:30 PM,24,6,15,7,0,52,
4/9/2019,Tuesday,2:30 PM,18,2,12,8,1,41,
4/9/2019,Tuesday,3:30 PM,14,2,11,2,0,29,
4/9/2019,Tuesday,4:30 PM,14,1,8,3,1,27,
4/9/2019,Tuesday,5:30 PM,12,5,12,3,0,32,
4/9/2019,Tuesday,6:30 PM,9,3,7,1,0,20,
4/9/2019,Tuesday,7:30 PM,9,4,11,0,0,24,
4/9/2019,Tuesday,8:30 PM,4,4,11,0,0,19,
4/10/2019,Wednesday,7:30 AM,1,0,1,0,0,2,
4/10/2019,Wednesday,8:30 AM,9,2,9,1,0,21,
4/10/2019,Wednesday,9:30 AM,17,4,12,3,0,36,
4/10/2019,Wednesday,10:30 AM,26,5,31,8,0,70,
4/10/2019,Wednesday,11:30 AM,26,5,21,10,1,63,
4/10/2019,Wednesday,12:30 PM,36,12,34,14,2,98,
4/10/2019,Wednesday,1:30 PM,29,5,17,2,2,55,
4/10/2019,Wednesday,2:30 PM,21,4,14,0,2,41,
4/10/2019,Wednesday,3:30 PM,17,4,10,0,2,33,
4/10/2019,Wednesday,5:30 PM,9,3,11,1,0,24,
4/10/2019,Wednesday,6:30 PM,11,3,10,1,0,25,
4/10/2019,Wednesday,7:30 PM,13,1,5,0,0,19,
4/10/2019,Wednesday,8:30 PM,10,1,5,0,1,17,
4/11/2019,Thursday,7:30 AM,2,1,0,0,2,5,
4/11/2019,Thursday,8:30 AM,11,1,7,2,1,22,
4/11/2019,Thursday,9:30 AM,14,1,14,1,2,32,
4/11/2019,Thursday,10:30 AM,15,3,30,2,1,51,
4/11/2019,Thursday,11:30 AM,37,4,24,2,5,72,
4/11/2019,Thursday,12:30 PM,34,7,41,7,2,91,
4/11/2019,Thursday,1:30 PM,26,6,10,2,0,44,
4/11/2019,Thursday,4:30 PM,16,5,12,4,2,39,
4/11/2019,Thursday,5:30 PM,15,2,14,2,1,34,
4/11/2019,Thursday,6:30 PM,11,0,8,0,0,19,
4/11/2019,Thursday,7:30 PM,8,0,3,1,0,12,
4/11/2019,Thursday,8:30 PM,5,0,2,2,0,9,
4/12/2019,Friday,7:30 AM,0,0,0,0,0,0,
4/12/2019,Friday,8:30 AM,2,0,2,0,0,4,
4/12/2019,Friday,9:30 AM,6,1,4,0,0,11,
4/12/2019,Friday,10:30 AM,11,2,4,0,0,17,
4/12/2019,Friday,12:30 PM,7,1,7,2,1,18,
4/12/2019,Friday,1:30 PM,8,4,5,1,3,21,
4/12/2019,Friday,4:30 PM,10,2,5,0,0,17,
4/12/2019,Friday,5:30 PM,13,2,4,2,2,23,
4/12/2019,Friday,6:30 PM,12,4,8,0,0,24,
4/12/2019,Friday,7:30 PM,10,2,4,0,2,18,
4/12/2019,Friday,8:30 PM,3,2,3,0,0,8,
4/13/2019,Saturday,9:30 AM,3,0,0,0,0,3,
4/13/2019,Saturday,10:30 AM,4,0,1,0,0,5,
4/13/2019,Saturday,11:30 AM,3,0,1,0,0,4,
4/13/2019,Saturday,12:30 PM,10,0,3,0,1,14,
4/13/2019,Saturday,1:30 PM,12,0,2,1,0,15,
4/13/2019,Saturday,4:30 PM,8,0,1,1,0,10,
4/15/2019,Monday,7:30 AM,2,0,1,0,1,4,
4/15/2019,Monday,8:30 AM,19,7,8,1,0,35,
4/15/2019,Monday,9:30 AM,24,7,13,10,0,54,
4/15/2019,Monday,10:30 AM,21,7,17,9,0,54,
4/15/2019,Monday,11:30 AM,25,12,29,7,2,75,
4/15/2019,Monday,12:30 PM,41,18,39,8,5,111,
4/15/2019,Monday,1:30 PM,22,6,20,6,2,56,
4/15/2019,Monday,2:30 PM,23,9,11,3,2,48,
4/15/2019,Monday,3:30 PM,25,10,15,6,3,59,
4/15/2019,Monday,4:30 PM,20,9,13,4,2,48,
4/15/2019,Monday,5:30 PM,30,5,13,1,0,49,
4/15/2019,Monday,6:30 PM,25,3,15,1,2,46,
4/15/2019,Monday,7:30 PM,14,2,12,0,0,28,
4/15/2019,Monday,8:30 PM,12,1,4,0,2,19,
4/16/2019,Tuesday,10:30 AM,34,6,26,5,3,74,
4/16/2019,Tuesday,11:30 AM,32,7,29,7,5,80,
4/16/2019,Tuesday,12:30 PM,44,10,38,7,2,101,
4/16/2019,Tuesday,1:30 PM,21,8,17,5,2,53,
4/16/2019,Tuesday,2:30 PM,28,6,15,5,0,54,
4/16/2019,Tuesday,3:30 PM,26,5,16,7,0,54,
4/16/2019,Tuesday,4:30 PM,21,5,7,7,1,41,
4/16/2019,Tuesday,5:30 PM,18,3,6,0,2,29,
4/16/2019,Tuesday,6:30 PM,17,4,10,1,0,32,
4/16/2019,Tuesday,7:30 PM,13,2,7,1,0,23,
4/17/2019,Wednesday,7:30 AM,5,0,3,0,0,8,
4/17/2019,Wednesday,8:30 AM,10,5,4,1,1,21,
4/17/2019,Wednesday,9:30 AM,19,5,12,5,3,44,
4/17/2019,Wednesday,10:30 AM,22,9,18,7,0,56,
4/17/2019,Wednesday,11:30 AM,16,7,20,8,1,52,
4/17/2019,Wednesday,12:30 PM,40,13,36,14,3,106,
4/18/2019,Thursday,7:30 AM,3,1,0,0,0,4,
4/18/2019,Thursday,8:30 AM,6,3,3,1,1,14,
4/18/2019,Thursday,10:30 AM,25,5,20,9,1,60,
4/18/2019,Thursday,8:30 AM,6,3,3,1,1,14,
4/18/2019,Thursday,9:30 AM,21,3,12,9,0,45,
4/18/2019,Thursday,10:30 AM,25,5,20,9,1,60,
4/18/2019,Thursday,11:30 AM,24,9,29,6,1,69,
4/18/2019,Thursday,12:30 PM,37,4,35,8,3,87,
4/18/2019,Thursday,1:30 PM,31,4,16,3,3,57,
4/18/2019,Thursday,2:30 PM,15,7,8,3,2,35,
4/18/2019,Thursday,3:30 PM,15,6,8,3,3,35,
4/18/2019,Thursday,4:30 PM,17,5,5,1,0,28,
4/18/2019,Thursday,5:30 PM,14,5,13,0,0,32,
4/18/2019,Thursday,6:30 PM,11,3,3,1,0,18,
4/18/2019,Thursday,7:30 PM,7,3,6,1,0,17,
4/19/2019,Friday,7:30 AM,2,0,0,0,0,2,
4/19/2019,Friday,8:30 AM,3,0,0,0,0,3,
4/19/2019,Friday,9:30 AM,2,1,0,0,0,3,
4/19/2019,Friday,10:30 AM,7,1,5,0,0,13,
4/19/2019,Friday,11:30 AM,9,2,4,2,0,17,
4/19/2019,Friday,12:30 PM,15,6,4,4,1,30,
4/19/2019,Friday,1:30 PM,10,2,3,0,0,15,
4/19/2019,Friday,5:30 PM,6,0,1,0,0,7,
4/19/2019,Friday,6:30 PM,12,1,1,0,0,14,
4/19/2019,Friday,7:30 PM,8,1,1,0,0,10,
4/19/2019,Friday,8:30 PM,6,1,1,0,0,8,
4/20/2019,Saturday,9:30 AM,0,0,1,0,0,1,
4/20/2019,Saturday,10:30 AM,1,0,2,0,0,3,
4/20/2019,Saturday,11:30 AM,3,0,3,0,0,6,
4/20/2019,Saturday,12:30 PM,3,0,1,0,0,4,
4/20/2019,Saturday,1:30 PM,6,0,4,0,0,10,
4/20/2019,Saturday,2:30 PM,15,0,5,2,0,22,
4/20/2019,Saturday,3:30 PM,16,0,6,3,0,25,
4/20/2019,Saturday,4:30 PM,7,0,4,2,0,13,
4/20/2019,Saturday,5:30 PM,1,0,0,0,0,1,
4/22/2019,Monday,7:30 AM,7,0,0,0,0,7,
4/22/2019,Monday,8:30 AM,12,1,11,1,0,25,
4/22/2019,Monday,9:30 AM,14,4,20,6,0,44,
4/22/2019,Monday,10:30 AM,20,6,20,4,0,50,
4/22/2019,Monday,11:30 AM,22,6,18,6,3,55,
4/22/2019,Monday,12:30 PM,34,10,28,17,9,98,
4/22/2019,Monday,1:30 PM,30,8,15,4,3,60,
4/22/2019,Monday,3:30 PM,21,7,12,5,2,47,
4/22/2019,Monday,4:30 PM,23,9,9,2,2,45,
4/22/2019,Monday,5:30 PM,20,5,11,2,0,38,
4/22/2019,Monday,6:30 PM,12,3,6,2,0,23,
4/22/2019,Monday,7:30 PM,14,4,6,1,0,25,
4/23/2019,Tuesday,7:30 AM,3,0,0,0,0,3,
4/23/2019,Tuesday,8:30 AM,14,3,15,3,0,35,
4/23/2019,Tuesday,9:30 AM,16,5,9,1,0,31,
4/23/2019,Tuesday,10:30 AM,24,9,20,11,0,64,
4/23/2019,Tuesday,11:30 AM,27,6,29,1,0,63,
4/23/2019,Tuesday,12:30 PM,39,9,37,3,1,89,
4/23/2019,Tuesday,1:30 PM,19,8,24,8,2,61,
4/23/2019,Tuesday,2:30 PM,22,6,13,7,2,50,
4/23/2019,Tuesday,3:30 PM,16,5,17,4,3,45,
4/23/2019,Tuesday,5:30 PM,16,9,8,4,0,37,
4/23/2019,Tuesday,6:30 PM,15,5,5,1,0,26,
4/23/2019,Tuesday,7:30 PM,14,3,7,0,0,24,
4/23/2019,Tuesday,8:30 PM,11,3,2,0,0,16,
4/24/2019,Wednesday,7:30 AM,3,0,0,0,0,3,
4/24/2019,Wednesday,8:30 AM,11,3,10,0,1,25,
4/24/2019,Wednesday,9:30 AM,20,8,15,6,0,49,
4/24/2019,Wednesday,10:30 AM,24,5,22,11,0,62,
4/24/2019,Wednesday,11:30 AM,16,5,17,6,2,46,
4/24/2019,Wednesday,1:30 PM,32,8,20,0,2,62,
4/24/2019,Wednesday,2:30 PM,33,2,14,5,2,56,
4/24/2019,Wednesday,3:30 PM,26,3,13,2,1,45,
4/24/2019,Wednesday,4:30 PM,25,2,13,7,3,50,
4/24/2019,Wednesday,5:30 PM,26,5,21,2,0,54,
4/24/2019,Wednesday,6:30 PM,13,4,9,0,1,27,
4/24/2019,Wednesday,7:30 PM,9,1,11,0,2,23,
4/25/2019,Thursday,7:30 AM,1,0,0,0,0,1,
4/25/2019,Thursday,8:30 AM,8,1,7,0,0,16,
4/25/2019,Thursday,9:30 AM,11,2,16,4,1,34,
4/25/2019,Thursday,10:30 AM,20,4,27,7,1,59,
4/25/2019,Thursday,11:30 AM,24,11,21,5,2,63,
4/25/2019,Thursday,12:30 PM,28,12,42,4,2,88,
4/25/2019,Thursday,1:30 PM,14,10,15,4,0,43,
4/25/2019,Thursday,2:30 PM,13,6,20,5,2,46,
4/25/2019,Thursday,3:30 PM,29,4,15,6,0,54,
4/25/2019,Thursday,4:30 PM,27,3,12,7,0,49,
4/25/2019,Thursday,5:30 PM,18,3,12,1,0,34,
4/25/2019,Thursday,6:30 PM,8,2,8,1,0,19,
4/25/2019,Thursday,7:30 PM,6,0,9,0,3,18,
4/25/2019,Thursday,8:30 PM,7,1,5,0,0,13,
4/26/2019,Friday,7:30 AM,2,0,0,0,0,2,
4/26/2019,Friday,8:30 AM,4,0,0,0,1,5,
4/26/2019,Friday,9:30 AM,5,0,1,0,1,7,
4/26/2019,Friday,10:30 AM,7,2,2,0,0,11,
4/26/2019,Friday,11:30 AM,11,1,1,0,1,14,
4/26/2019,Friday,12:30 PM,13,2,3,3,2,23,
4/26/2019,Friday,3:30 PM,10,2,2,1,0,15,
4/26/2019,Friday,5:30 PM,10,4,7,1,0,22,
4/26/2019,Friday,6:30 PM,9,1,3,0,0,13,
4/26/2019,Friday,7:30 PM,6,0,2,3,0,11,
4/26/2019,Friday,8:30 PM,2,0,2,1,0,5,
4/27/2019,Saturday,9:30 AM,2,0,0,0,2,4,
4/27/2019,Saturday,10:30 AM,1,0,3,0,0,4,
4/27/2019,Saturday,11:30 AM,4,0,3,0,1,8,
4/27/2019,Saturday,12:30 PM,5,0,4,0,1,10,
4/27/2019,Saturday,1:30 PM,6,0,5,0,1,12,
4/27/2019,Saturday,2:30 PM,12,0,3,1,0,16,
4/27/2019,Saturday,4:30 PM,11,0,5,0,0,16,
4/27/2019,Saturday,5:30 PM,2,0,0,0,0,2,
4/29/2019,Monday,7:30 AM,4,0,2,0,0,6,
4/29/2019,Monday,8:30 AM,13,7,7,1,0,28,
4/29/2019,Monday,9:30 AM,20,7,7,7,0,41,
4/29/2019,Monday,10:30 AM,20,7,30,6,0,63,
4/29/2019,Monday,11:30 AM,26,6,20,8,0,60,
4/29/2019,Monday,12:30 PM,45,10,36,17,5,113,
4/29/2019,Monday,1:30 PM,22,7,25,6,3,63,
4/29/2019,Monday,2:30 PM,27,8,19,4,2,60,
4/29/2019,Monday,3:30 PM,26,8,24,0,2,60,
4/29/2019,Monday,4:30 PM,19,5,17,0,1,42,
4/29/2019,Monday,5:30 PM,16,3,14,2,0,35,
4/29/2019,Monday,6:30 PM,22,6,10,0,0,38,
4/29/2019,Monday,7:30 PM,13,5,8,0,0,26,
4/29/2019,Monday,8:30 PM,6,3,2,2,0,13,
4/30/2019,Tuesday,7:30 AM,6,1,0,0,0,7,
4/30/2019,Tuesday,8:30 AM,10,1,4,1,0,16,
4/30/2019,Tuesday,9:30 AM,16,1,10,7,2,36,
4/30/2019,Tuesday,10:30 AM,27,2,16,1,0,46,
4/30/2019,Tuesday,11:30 AM,24,6,17,1,0,48,
4/30/2019,Tuesday,12:30 PM,33,10,47,7,7,104,
4/30/2019,Tuesday,1:30 PM,19,7,15,8,0,49,
4/30/2019,Tuesday,2:30 PM,14,5,15,4,0,38,
4/30/2019,Tuesday,3:30 PM,18,3,12,4,1,38,
4/30/2019,Tuesday,4:30 PM,22,2,8,2,1,35,
4/30/2019,Tuesday,5:30 PM,17,2,13,1,0,33,
4/30/2019,Tuesday,6:30 PM,13,1,4,0,0,18,
4/30/2019,Tuesday,7:30 PM,13,2,2,0,0,17,
4/30/2019,Tuesday,8:30 PM,12,1,0,3,0,16,
5/1/2019,Wednesday,7:30 AM,1,0,1,0,2,4,
5/1/2019,Wednesday,8:30 AM,12,2,8,4,1,27,
5/1/2019,Wednesday,9:30 AM,21,4,10,4,0,39,
5/1/2019,Wednesday,10:30 AM,32,10,25,7,0,74,
5/1/2019,Wednesday,11:30 AM,37,4,31,7,0,79,
5/1/2019,Wednesday,12:30 PM,36,6,36,12,7,97,
5/1/2019,Wednesday,1:30 PM,26,8,24,1,3,62,
5/1/2019,Wednesday,2:30 PM,23,4,20,1,2,50,
5/1/2019,Wednesday,3:30 PM,40,6,21,3,2,72,
5/1/2019,Wednesday,4:30 PM,20,4,12,2,1,39,
5/1/2019,Wednesday,5:30 PM,23,4,13,3,1,44,
5/1/2019,Wednesday,6:30 PM,11,2,6,0,0,19,
5/1/2019,Wednesday,7:30 PM,13,2,8,2,0,25,
5/1/2019,Wednesday,8:30 PM,10,1,4,2,0,17,
5/2/2019,Thursday,10:30 AM,26,5,5,5,4,45,
5/2/2019,Thursday,11:30 AM,39,7,4,4,3,57,
5/2/2019,Thursday,12:30 PM,47,6,15,15,3,86,
5/2/2019,Thursday,1:30 PM,26,7,7,7,3,50,
5/2/2019,Thursday,2:30 PM,26,3,6,6,0,41,
5/2/2019,Thursday,3:30 PM,24,5,5,5,2,41,
5/2/2019,Thursday,4:30 PM,23,4,7,7,1,42,
5/2/2019,Thursday,5:30 PM,25,2,0,0,1,28,
5/2/2019,Thursday,6:30 PM,16,1,0,0,0,17,
5/2/2019,Thursday,7:30 PM,10,2,0,0,0,12,
5/2/2019,Thursday,8:30 PM,8,2,0,0,0,10,
5/3/2019,Friday,7:30 AM,4,0,3,0,0,7,
5/3/2019,Friday,9:30 AM,6,0,3,0,0,9,
5/3/2019,Friday,10:30 AM,6,1,3,1,0,11,
5/3/2019,Friday,11:30 AM,11,1,7,1,2,22,
5/3/2019,Friday,12:30 PM,15,1,6,2,2,26,
5/3/2019,Friday,1:30 PM,10,2,5,2,1,20,
5/3/2019,Friday,2:30 PM,9,1,4,0,1,15,
5/3/2019,Friday,5:30 PM,7,1,5,0,1,14,
5/3/2019,Friday,6:30 PM,7,0,4,0,0,11,
5/3/2019,Friday,8:30 PM,4,0,0,0,0,4,
5/4/2019,Saturday,9:30 AM,1,0,0,0,0,1,
5/4/2019,Saturday,10:30 AM,3,1,7,0,0,11,
5/4/2019,Saturday,12:30 PM,6,1,11,3,0,21,
5/4/2019,Saturday,1:30 PM,8,2,12,2,0,24,
5/4/2019,Saturday,2:30 PM,9,1,11,0,0,21,
5/4/2019,Saturday,3:30 PM,9,2,8,0,0,19,
5/4/2019,Saturday,4:30 PM,8,2,5,1,0,16,
5/4/2019,Saturday,5:30 PM,2,2,1,0,0,5,
5/6/2019,Monday,7:30 AM,6,1,0,0,0,7,
5/6/2019,Monday,8:30 AM,9,1,3,0,0,13,
5/6/2019,Monday,9:30 AM,13,5,9,3,1,31,
5/6/2019,Monday,10:30 AM,13,5,14,5,3,40,
5/6/2019,Monday,11:30 AM,19,9,30,4,0,62,
5/6/2019,Monday,12:30 PM,27,8,28,9,5,77,
5/6/2019,Monday,1:30 PM,35,8,33,6,3,85,
5/6/2019,Monday,2:30 PM,27,8,18,5,2,60,
5/6/2019,Monday,3:30 PM,22,5,18,4,1,50,
5/6/2019,Monday,4:30 PM,24,6,12,3,1,46,
5/6/2019,Monday,5:30 PM,27,4,18,1,0,50,
5/6/2019,Monday,6:30 PM,20,4,9,2,3,38,
5/6/2019,Monday,7:30 PM,19,5,9,5,3,41,
5/6/2019,Monday,8:30 PM,11,5,4,3,3,26,
5/7/2019,Tuesday,7:30 AM,2,1,3,0,0,6,
5/7/2019,Tuesday,8:30 AM,3,0,3,0,1,7,
5/7/2019,Tuesday,9:30 AM,12,3,17,2,2,36,
5/7/2019,Tuesday,10:30 AM,23,9,23,6,3,64,
5/7/2019,Tuesday,11:30 AM,22,5,18,9,2,56,
5/7/2019,Tuesday,12:30 PM,25,9,19,8,3,64,
5/7/2019,Tuesday,1:30 PM,18,8,34,8,2,70,
5/7/2019,Tuesday,2:30 PM,21,10,25,6,2,64,
5/7/2019,Tuesday,3:30 PM,21,8,25,9,0,63,
5/7/2019,Tuesday,4:30 PM,18,5,13,3,0,39,
5/7/2019,Tuesday,5:30 PM,23,6,11,2,1,43,
5/7/2019,Tuesday,6:30 PM,27,2,6,3,2,40,
5/7/2019,Tuesday,7:30 PM,16,0,4,0,0,20,
5/7/2019,Tuesday,8:30 PM,3,1,2,0,0,6,
5/8/2019,Wednesday,7:30 AM,2,0,0,0,0,2,
5/8/2019,Wednesday,8:30 AM,10,2,8,0,0,20,
5/8/2019,Wednesday,9:30 AM,19,5,8,2,1,35,
5/8/2019,Wednesday,10:30 AM,37,11,28,10,1,87,
5/8/2019,Wednesday,11:30 AM,23,7,17,3,2,52,
5/8/2019,Wednesday,12:30 PM,28,8,39,4,0,79,
5/8/2019,Wednesday,1:30 PM,22,5,16,5,4,52,
5/8/2019,Wednesday,2:30 PM,18,6,11,1,2,38,
5/8/2019,Wednesday,3:30 PM,13,3,8,3,0,27,
5/8/2019,Wednesday,4:30 PM,16,2,17,3,0,38,
5/8/2019,Wednesday,5:30 PM,19,4,15,4,3,45,
5/8/2019,Wednesday,6:30 PM,10,3,9,3,2,27,
5/8/2019,Wednesday,7:30 PM,12,4,11,4,2,33,
5/8/2019,Wednesday,8:30 PM,7,1,7,0,0,15,
5/9/2019,Thursday,7:30 AM,2,1,1,0,0,4,
5/9/2019,Thursday,8:30 AM,8,3,11,3,1,26,
5/9/2019,Thursday,9:30 AM,9,3,14,4,0,30,
5/9/2019,Thursday,10:30 AM,20,7,30,5,4,66,
