Date,DayOfWeek,Time,Computers,Silent,Quiet,Active,Other,Total,
8/31/2020,Monday,8:30 AM,1,0,0,0,0,1,
8/31/2020,Monday,9:30 AM,5,0,0,0,1,6,
8/31/2020,Monday,10:30 AM,1,0,0,0,0,1,
8/31/2020,Monday,4:30 PM,3,0,1,0,0,4,
8/31/2020,Monday,5:30 PM,3,0,0,1,1,5,
8/31/2020,Monday,6:30 PM,4,0,1,3,1,9,
8/31/2020,Monday,7:30 PM,2,0,0,0,0,2,
9/1/2020,Tuesday,8:30 AM,1,0,0,0,0,1,
9/1/2020,Tuesday,11:30 AM,3,0,0,0,0,3,
9/1/2020,Tuesday,12:30 PM,7,0,4,0,0,11,
9/1/2020,Tuesday,1:30 PM,2,0,3,0,0,5,
9/1/2020,Tuesday,2:30 PM,4,0,3,1,0,8,
9/1/2020,Tuesday,4:30 PM,9,0,2,2,1,14,
9/1/2020,Tuesday,5:30 PM,4,0,0,0,2,6,
9/1/2020,Tuesday,6:30 PM,5,0,0,1,0,6,
9/1/2020,Tuesday,7:30 PM,4,0,1,1,0,6,
9/2/2020,Wednesday,8:30 AM,0,0,0,0,0,0,
9/2/2020,Wednesday,9:30 AM,5,0,0,0,0,5,
9/2/2020,Wednesday,10:30 AM,7,0,0,0,0,7,
9/2/2020,Wednesday,4:30 PM,0,0,1,1,0,2,
9/2/2020,Wednesday,5:30 PM,5,0,0,1,0,6,
9/2/2020,Wednesday,6:30 PM,1,0,0,1,1,3,
9/2/2020,Wednesday,7:30 PM,1,0,0,1,0,2,
9/3/2020,Thursday,11:30 AM,3,0,4,0,0,7,
9/3/2020,Thursday,12:30 PM,5,0,3,0,0,8,
9/3/2020,Thursday,1:30 PM,4,0,1,0,0,5,
9/3/2020,Thursday,2:30 PM,5,0,0,0,1,6,
9/3/2020,Thursday,4:30 PM,2,0,0,0,0,2,
9/3/2020,Thursday,5:30 PM,1,0,0,1,0,2,
9/3/2020,Thursday,6:30 PM,1,0,0,2,0,3,
9/3/2020,Thursday,7:30 PM,2,0,0,2,0,4,
9/4/2020,Friday,8:30 AM,3,0,0,0,0,3,
9/4/2020,Friday,9:30 AM,1,0,1,0,0,2,
9/4/2020,Friday,10:30 AM,5,0,1,0,0,6,
9/4/2020,Friday,4:30 PM,5,0,0,1,0,6,
9/4/2020,Friday,5:30 PM,7,0,0,0,0,7,
9/4/2020,Friday,6:30 PM,1,0,1,0,0,2,
9/4/2020,Friday,7:30 PM,1,0,1,0,0,2,
9/8/2020,Tuesday,11:30 AM,8,0,1,0,0,9,
9/8/2020,Tuesday,12:30 PM,8,0,2,0,1,11,
9/8/2020,Tuesday,1:30 PM,4,0,4,0,4,12,
9/8/2020,Tuesday,2:30 PM,5,0,4,0,0,9,
9/8/2020,Tuesday,4:30 PM,3,0,3,0,0,6,
9/8/2020,Tuesday,5:30 PM,3,0,0,0,0,3,
9/8/2020,Tuesday,6:30 PM,0,0,0,1,0,1,
9/8/2020,Tuesday,7:30 PM,1,0,0,0,0,1,
9/9/2020,Wednesday,7:30 AM,0,0,0,0,0,0,
9/9/2020,Wednesday,8:30 AM,3,0,1,0,0,4,
9/9/2020,Wednesday,9:30 AM,5,0,0,0,0,5,
9/9/2020,Wednesday,10:30 AM,8,0,1,1,0,10,
9/9/2020,Wednesday,4:30 PM,2,0,0,0,0,2,
9/9/2020,Wednesday,5:30 PM,4,0,0,1,0,5,
9/9/2020,Wednesday,6:30 PM,1,0,0,1,0,2,
9/9/2020,Wednesday,7:30 PM,3,0,0,1,1,5,
9/10/2020,Thursday,7:30 AM,0,0,0,0,0,0,
9/10/2020,Thursday,11:30 AM,11,0,3,3,1,18,
9/10/2020,Thursday,12:30 PM,6,0,3,0,1,10,
9/10/2020,Thursday,1:30 PM,4,0,1,0,0,5,
9/10/2020,Thursday,2:30 PM,5,0,1,1,0,7,
9/10/2020,Thursday,4:30 PM,8,0,2,1,0,11,
9/10/2020,Thursday,5:30 PM,3,0,0,1,0,4,
9/10/2020,Thursday,6:30 PM,5,0,2,1,0,8,
9/10/2020,Thursday,7:30 PM,2,0,2,1,0,5,
9/11/2020,Friday,7:30 AM,0,0,0,0,0,0,
9/11/2020,Friday,8:30 AM,3,0,0,0,0,3,
9/11/2020,Friday,9:30 AM,3,0,0,0,0,3,
9/11/2020,Friday,10:30 AM,4,0,1,0,0,5,
9/11/2020,Friday,4:30 PM,4,0,4,0,4,12,
9/11/2020,Friday,5:30 PM,3,0,1,1,0,5,
9/11/2020,Friday,6:30 PM,1,0,0,1,0,2,
9/11/2020,Friday,7:30 PM,1,0,0,1,0,2,
9/14/2020,Monday,7:30 AM,0,0,0,0,0,0,
9/14/2020,Monday,8:30 AM,2,0,0,0,0,2,
9/14/2020,Monday,9:30 AM,1,0,0,0,0,1,
9/14/2020,Monday,10:30 AM,0,0,0,1,0,1,
9/14/2020,Monday,4:30 PM,6,0,0,2,4,12,
9/14/2020,Monday,5:30 PM,3,0,0,0,0,3,
9/14/2020,Monday,6:30 PM,4,0,0,0,0,4,
9/14/2020,Monday,7:30 PM,1,0,0,2,0,3,
9/15/2020,Tuesday,11:30 AM,7,0,2,1,0,10,
9/15/2020,Tuesday,12:30 PM,5,0,1,1,0,7,
9/15/2020,Tuesday,1:30 PM,2,0,1,1,2,6,
9/15/2020,Tuesday,2:30 PM,3,0,1,1,2,7,
9/15/2020,Tuesday,4:30 PM,4,0,1,0,0,5,
9/15/2020,Tuesday,5:30 PM,6,0,0,0,0,6,
9/15/2020,Tuesday,6:30 PM,2,0,0,1,0,3,
9/15/2020,Tuesday,7:30 PM,1,0,0,1,0,2,
9/16/2020,Wednesday,7:30 AM,2,0,0,0,0,2,
9/16/2020,Wednesday,8:30 AM,1,0,0,0,0,1,
9/16/2020,Wednesday,9:30 AM,2,0,0,0,0,2,
9/16/2020,Wednesday,10:30 AM,2,0,1,0,0,3,
9/16/2020,Wednesday,4:30 PM,4,0,0,1,1,6,
9/16/2020,Wednesday,5:30 PM,4,0,0,1,2,7,
9/16/2020,Wednesday,6:30 PM,2,0,0,3,1,6,
9/16/2020,Wednesday,7:30 PM,1,0,0,1,0,2,
9/17/2020,Thursday,11:30 AM,2,0,0,0,4,6,
9/17/2020,Thursday,12:30 PM,7,0,2,0,1,10,
9/17/2020,Thursday,1:30 PM,4,0,1,0,1,6,
9/17/2020,Thursday,2:30 PM,4,0,2,0,1,7,
9/17/2020,Thursday,4:30 PM,2,0,0,0,0,2,
9/17/2020,Thursday,5:30 PM,6,0,0,2,0,8,
9/17/2020,Thursday,6:30 PM,3,0,0,0,0,3,
9/17/2020,Thursday,7:30 PM,5,0,0,0,0,5,
9/18/2020,Friday,7:30 AM,0,0,0,0,0,0,
9/18/2020,Friday,8:30 AM,2,0,0,0,0,2,
9/18/2020,Friday,9:30 AM,1,0,1,0,0,2,
9/18/2020,Friday,10:30 AM,2,0,1,0,0,3,
9/18/2020,Friday,4:30 PM,5,0,0,0,0,5,
9/18/2020,Friday,5:30 PM,0,0,0,0,0,0,
9/18/2020,Friday,6:30 PM,0,0,0,0,0,0,
9/18/2020,Friday,7:30 PM,0,0,0,0,0,0,
9/21/2020,Monday,7:30 AM,0,0,0,0,0,0,
9/21/2020,Monday,8:30 AM,1,0,0,0,0,1,
9/21/2020,Monday,9:30 AM,5,0,0,0,0,5,
9/21/2020,Monday,10:30 AM,4,0,0,1,0,5,
9/21/2020,Monday,4:30 PM,7,1,0,0,0,8,
9/21/2020,Monday,5:30 PM,2,1,2,0,0,5,
9/21/2020,Monday,6:30 PM,0,0,2,0,0,2,
9/21/2020,Monday,7:30 PM,0,0,2,0,0,2,
9/22/2020,Tuesday,7:30 AM,0,0,0,0,0,0,
9/22/2020,Tuesday,8:30 AM,2,0,0,0,0,2,
9/22/2020,Tuesday,9:30 AM,5,0,0,0,1,6,
9/22/2020,Tuesday,10:30 AM,0,0,0,0,1,1,
9/22/2020,Tuesday,11:30 AM,6,0,1,0,0,7,
9/22/2020,Tuesday,12:30 PM,8,0,2,0,3,13,
9/22/2020,Tuesday,1:30 PM,7,0,2,0,4,13,
9/22/2020,Tuesday,2:30 PM,6,0,0,0,0,6,
9/22/2020,Tuesday,3:30 PM,4,0,0,0,0,4,
9/22/2020,Tuesday,4:30 PM,4,0,0,0,0,4,
9/22/2020,Tuesday,5:30 PM,7,0,1,0,0,8,
9/22/2020,Tuesday,6:30 PM,4,0,1,0,0,5,
9/22/2020,Tuesday,7:30 PM,3,0,0,1,0,4,
9/23/2020,Wednesday,7:30 AM,0,0,0,0,0,0,
9/23/2020,Wednesday,8:30 AM,0,0,0,0,0,0,
9/23/2020,Wednesday,9:30 AM,2,0,0,1,0,3,
9/23/2020,Wednesday,10:30 AM,3,0,0,1,0,4,
9/23/2020,Wednesday,11:30 AM,5,0,0,0,2,7,
9/23/2020,Wednesday,12:30 PM,6,0,0,0,1,7,
9/23/2020,Wednesday,1:30 PM,9,0,0,0,0,9,
9/23/2020,Wednesday,2:30 PM,5,0,0,0,1,6,
9/23/2020,Wednesday,3:30 PM,4,0,1,1,2,8,
9/23/2020,Wednesday,4:30 PM,4,0,1,1,0,6,
9/23/2020,Wednesday,5:30 PM,4,0,2,1,0,7,
9/23/2020,Wednesday,6:30 PM,2,0,0,1,2,5,
9/23/2020,Wednesday,7:30 PM,1,0,0,0,2,3,
9/24/2020,Thursday,7:30 AM,0,0,0,0,0,0,
9/24/2020,Thursday,8:30 AM,3,0,0,0,2,5,
9/24/2020,Thursday,9:30 AM,4,0,0,0,1,5,
9/24/2020,Thursday,10:30 AM,3,0,0,0,3,6,
9/24/2020,Thursday,11:30 AM,5,0,2,0,0,7,
9/24/2020,Thursday,12:30 PM,7,0,1,2,0,10,
9/24/2020,Thursday,1:30 PM,7,0,0,1,2,10,
9/24/2020,Thursday,2:30 PM,5,0,0,1,0,6,
9/24/2020,Thursday,3:30 PM,6,0,2,1,1,10,
9/24/2020,Thursday,4:30 PM,0,0,0,1,0,1,
9/24/2020,Thursday,5:30 PM,3,0,0,0,0,3,
9/24/2020,Thursday,6:30 PM,2,0,0,0,0,2,
9/24/2020,Thursday,7:30 PM,4,0,0,0,1,5,
9/25/2020,Friday,7:30 AM,0,0,0,0,0,0,
9/25/2020,Friday,8:30 AM,2,0,0,1,0,3,
9/25/2020,Friday,9:30 AM,3,0,0,0,0,3,
9/25/2020,Friday,10:30 AM,3,0,0,0,0,3,
9/25/2020,Friday,11:30 AM,6,0,0,0,0,6,
9/25/2020,Friday,12:30 PM,4,0,0,0,3,7,
9/25/2020,Friday,1:30 PM,4,0,0,0,3,7,
9/25/2020,Friday,2:30 PM,4,0,0,0,2,6,
9/25/2020,Friday,3:30 PM,0,0,0,0,0,0,
9/25/2020,Friday,4:30 PM,0,0,0,0,0,0,
9/25/2020,Friday,5:30 PM,0,0,1,1,2,4,
9/25/2020,Friday,6:30 PM,0,0,1,0,2,3,
9/25/2020,Friday,7:30 PM,0,0,1,0,1,2,
9/26/2020,Saturday,9:30 AM,0,0,0,0,0,0,
9/26/2020,Saturday,10:30 AM,0,0,0,0,0,0,
9/26/2020,Saturday,11:30 AM,1,0,0,0,0,1,
9/26/2020,Saturday,12:30 PM,2,0,0,0,0,2,
9/26/2020,Saturday,1:30 PM,3,0,1,0,0,4,
9/26/2020,Saturday,2:30 PM,4,0,1,0,0,5,
9/28/2020,Monday,7:30 AM,2,0,0,0,0,2,
9/28/2020,Monday,8:30 AM,5,0,0,1,0,6,
9/28/2020,Monday,9:30 AM,1,0,0,1,0,2,
9/28/2020,Monday,10:30 AM,5,0,1,1,0,7,
9/28/2020,Monday,11:30 AM,6,0,0,0,2,8,
9/28/2020,Monday,12:30 PM,2,0,0,0,1,3,
9/28/2020,Monday,1:30 PM,5,0,0,1,0,6,
9/28/2020,Monday,2:30 PM,4,0,0,0,5,9,
9/28/2020,Monday,3:30 PM,3,0,1,0,0,4,
9/28/2020,Monday,4:30 PM,2,0,1,0,2,5,
9/28/2020,Monday,5:30 PM,3,0,1,0,1,5,
9/28/2020,Monday,6:30 PM,3,0,0,0,1,4,
9/28/2020,Monday,7:30 PM,6,0,0,0,0,6,
9/29/2020,Tuesday,7:30 AM,1,0,0,0,0,1,
9/29/2020,Tuesday,8:30 AM,5,0,0,0,0,5,
9/29/2020,Tuesday,9:30 AM,9,0,0,0,0,9,
9/29/2020,Tuesday,10:30 AM,10,0,0,0,1,11,
9/29/2020,Tuesday,11:30 AM,13,0,1,0,0,14,
9/29/2020,Tuesday,12:30 PM,9,0,3,0,3,15,
9/29/2020,Tuesday,1:30 PM,8,0,3,0,3,14,
9/29/2020,Tuesday,2:30 PM,9,0,2,0,0,11,
9/29/2020,Tuesday,3:30 PM,7,0,2,0,1,10,
9/29/2020,Tuesday,4:30 PM,4,0,0,0,0,4,
9/29/2020,Tuesday,5:30 PM,2,0,1,0,0,3,
9/29/2020,Tuesday,6:30 PM,3,0,1,0,0,4,
9/29/2020,Tuesday,7:30 PM,0,0,2,0,0,2,
9/30/2020,Wednesday,7:30 AM,0,0,0,0,0,0,
9/30/2020,Wednesday,8:30 AM,0,0,0,0,0,0,
9/30/2020,Wednesday,9:30 AM,3,0,0,0,0,3,
9/30/2020,Wednesday,10:30 AM,4,0,0,0,0,4,
9/30/2020,Wednesday,11:30 AM,4,0,0,0,0,4,
9/30/2020,Wednesday,12:30 PM,4,0,0,0,1,5,
9/30/2020,Wednesday,1:30 PM,2,0,0,0,1,3,
9/30/2020,Wednesday,1:30 PM,1,0,0,0,1,2,
9/30/2020,Wednesday,2:30 PM,5,0,0,0,1,6,
9/30/2020,Wednesday,2:30 PM,4,0,0,0,1,5,
9/30/2020,Wednesday,4:30 PM,2,0,3,0,2,7,
9/30/2020,Wednesday,5:30 PM,2,0,3,0,2,7,
9/30/2020,Wednesday,6:30 PM,3,0,1,0,1,5,
9/30/2020,Wednesday,7:30 PM,0,0,0,0,1,1,
10/1/2020,Thursday,7:30 AM,0,0,0,0,0,0,
10/1/2020,Thursday,8:30 AM,6,0,0,0,0,6,
10/1/2020,Thursday,9:30 AM,7,0,0,0,0,7,
10/1/2020,Thursday,10:30 AM,11,0,0,0,0,11,
10/1/2020,Thursday,11:30 AM,6,0,1,0,0,7,
10/1/2020,Thursday,12:30 PM,5,0,1,0,0,6,
10/1/2020,Thursday,1:30 PM,4,0,2,0,1,7,
10/1/2020,Thursday,2:30 PM,6,0,1,0,1,8,
10/1/2020,Thursday,3:30 PM,2,0,2,0,4,8,
10/1/2020,Thursday,4:30 PM,4,0,1,0,0,5,
10/1/2020,Thursday,5:30 PM,6,0,1,0,0,7,
10/1/2020,Thursday,6:30 PM,5,0,1,0,0,6,
10/1/2020,Thursday,7:30 PM,4,0,0,0,0,4,
10/2/2020,Friday,7:30 AM,0,0,0,0,0,0,
10/2/2020,Friday,7:30 AM,1,0,0,0,0,1,
10/2/2020,Friday,8:30 AM,2,0,0,0,0,2,
10/2/2020,Friday,9:30 AM,1,0,0,0,2,3,
10/2/2020,Friday,10:30 AM,2,0,0,0,2,4,
10/2/2020,Friday,11:30 AM,2,0,0,0,0,2,
10/2/2020,Friday,11:30 AM,2,0,0,0,0,2,
10/2/2020,Friday,12:30 PM,7,0,0,0,0,7,
10/2/2020,Friday,1:30 PM,6,0,0,0,1,7,
10/2/2020,Friday,2:30 PM,7,0,0,0,1,8,
10/2/2020,Friday,4:30 PM,4,0,0,0,0,4,
10/2/2020,Friday,5:30 PM,0,0,0,0,0,0,
10/2/2020,Friday,6:30 PM,1,0,0,0,0,1,
10/2/2020,Friday,7:30 PM,1,0,0,0,0,1,
10/3/2020,Saturday,10:30 AM,1,0,0,0,0,1,
10/3/2020,Saturday,11:30 AM,1,0,0,0,0,1,
10/3/2020,Saturday,12:30 PM,4,0,0,0,0,4,
10/3/2020,Saturday,1:30 PM,3,0,0,0,0,3,
10/5/2020,Monday,7:30 AM,0,0,0,0,0,0,
10/5/2020,Monday,8:30 AM,0,0,2,0,0,2,
10/5/2020,Monday,9:30 AM,3,0,1,0,0,4,
10/5/2020,Monday,10:30 AM,2,0,0,0,0,2,
10/5/2020,Monday,11:30 AM,5,0,1,0,0,6,
10/5/2020,Monday,1:30 PM,4,0,1,0,0,5,
10/5/2020,Monday,2:30 PM,3,0,0,0,0,3,
10/5/2020,Monday,3:30 PM,4,0,0,0,0,4,
10/5/2020,Monday,3:30 PM,4,0,0,0,0,4,
10/5/2020,Monday,4:30 PM,4,0,0,0,0,4,
10/5/2020,Monday,5:30 PM,5,0,1,0,1,7,
10/5/2020,Monday,6:30 PM,2,0,3,0,0,5,
10/5/2020,Monday,7:30 PM,4,0,3,0,0,7,
10/6/2020,Tuesday,7:30 AM,0,0,0,0,0,0,
10/6/2020,Tuesday,8:30 AM,2,0,0,0,0,2,
10/6/2020,Tuesday,9:30 AM,4,0,0,0,0,4,
10/6/2020,Tuesday,10:30 AM,6,0,0,0,1,7,
10/6/2020,Tuesday,11:30 AM,6,0,0,0,0,6,
10/6/2020,Tuesday,12:30 PM,4,0,2,0,3,9,
10/6/2020,Tuesday,1:30 PM,5,0,0,3,0,8,
10/6/2020,Tuesday,2:30 PM,8,0,2,0,0,10,
10/6/2020,Tuesday,4:30 PM,7,0,1,0,0,8,
10/6/2020,Tuesday,5:30 PM,5,0,0,0,0,5,
10/6/2020,Tuesday,6:30 PM,4,0,0,0,0,4,
10/6/2020,Tuesday,7:30 PM,2,0,0,2,0,4,
10/7/2020,Wednesday,7:30 AM,0,0,0,0,0,0,
10/7/2020,Wednesday,8:30 AM,0,0,0,0,0,0,
10/7/2020,Wednesday,9:30 AM,5,0,0,0,0,5,
10/7/2020,Wednesday,10:30 AM,3,0,0,0,0,3,
10/7/2020,Wednesday,11:30 AM,9,0,1,0,3,13,
10/7/2020,Wednesday,12:30 PM,3,0,1,0,1,5,
10/7/2020,Wednesday,1:30 PM,2,0,1,0,1,4,
10/7/2020,Wednesday,2:30 PM,9,0,2,0,1,12,
10/7/2020,Wednesday,4:30 PM,5,0,0,0,0,5,
10/7/2020,Wednesday,5:30 PM,5,0,0,0,0,5,
10/7/2020,Wednesday,6:30 PM,4,0,0,0,0,4,
10/7/2020,Wednesday,7:30 PM,3,0,0,0,0,3,
10/8/2020,Thursday,7:30 AM,0,0,0,0,0,0,
10/8/2020,Thursday,8:30 AM,2,0,0,0,0,2,
10/8/2020,Thursday,9:30 AM,5,0,0,0,0,5,
10/8/2020,Thursday,10:30 AM,2,0,0,0,1,3,
10/8/2020,Thursday,11:30 AM,4,0,3,0,1,8,
10/8/2020,Thursday,12:30 PM,14,0,1,0,0,15,
10/8/2020,Thursday,1:30 PM,8,0,3,0,1,12,
10/8/2020,Thursday,2:30 PM,9,0,2,0,0,11,
10/8/2020,Thursday,3:30 PM,8,0,0,0,0,8,
10/8/2020,Thursday,4:30 PM,12,0,1,0,0,13,
10/8/2020,Thursday,5:30 PM,6,0,2,0,0,8,
10/8/2020,Thursday,6:30 PM,3,0,0,0,0,3,
10/8/2020,Thursday,7:30 PM,1,0,0,0,0,1,
10/9/2020,Friday,7:30 AM,1,0,0,0,0,1,
10/9/2020,Friday,8:30 AM,2,0,0,0,0,2,
10/9/2020,Friday,9:30 AM,3,0,0,0,0,3,
10/9/2020,Friday,10:30 AM,4,0,0,0,0,4,
10/9/2020,Friday,11:30 AM,4,0,0,0,0,4,
10/9/2020,Friday,12:30 PM,8,0,0,0,1,9,
10/9/2020,Friday,1:30 PM,2,0,0,0,1,3,
10/9/2020,Friday,2:30 PM,3,0,0,0,0,3,
10/9/2020,Friday,4:30 PM,1,0,0,0,1,2,
10/9/2020,Friday,5:30 PM,3,0,0,0,3,6,
10/9/2020,Friday,6:30 PM,2,0,0,0,2,4,
10/9/2020,Friday,7:30 PM,0,0,0,0,1,1,
10/12/2020,Monday,7:30 AM,1,0,0,0,0,1,
10/12/2020,Monday,8:30 AM,1,0,0,0,0,1,
10/12/2020,Monday,9:30 AM,4,0,1,0,0,5,
10/12/2020,Monday,10:30 AM,4,0,1,0,0,5,
10/12/2020,Monday,11:30 AM,8,0,0,0,0,8,
10/12/2020,Monday,12:30 PM,10,0,1,0,1,12,
10/12/2020,Monday,1:30 PM,5,0,3,0,2,10,
10/12/2020,Monday,2:30 PM,4,0,0,0,2,6,
10/12/2020,Monday,3:30 PM,4,0,0,0,0,4,
10/12/2020,Monday,4:30 PM,6,0,0,0,0,6,
10/12/2020,Monday,5:30 PM,1,0,1,0,0,2,
10/12/2020,Monday,6:30 PM,4,0,1,0,0,5,
10/12/2020,Monday,7:30 PM,1,0,1,0,0,2,
10/13/2020,Tuesday,7:30 AM,0,0,0,0,0,0,
10/13/2020,Tuesday,8:30 AM,2,0,0,0,3,5,
10/13/2020,Tuesday,9:30 AM,1,0,0,0,1,2,
10/13/2020,Tuesday,10:30 AM,4,0,0,0,1,5,
10/13/2020,Tuesday,11:30 AM,8,0,1,0,0,9,
10/13/2020,Tuesday,12:30 PM,13,0,2,0,2,17,
10/13/2020,Tuesday,1:30 PM,7,0,0,0,2,9,
10/13/2020,Tuesday,2:30 PM,3,0,0,0,0,3,
10/13/2020,Tuesday,4:30 PM,9,0,0,0,0,9,
10/13/2020,Tuesday,5:30 PM,3,0,1,0,0,4,
10/13/2020,Tuesday,6:30 PM,3,0,1,0,0,4,
10/13/2020,Tuesday,7:30 PM,0,0,1,0,0,1,
10/14/2020,Wednesday,7:30 AM,2,0,0,0,0,2,
10/14/2020,Wednesday,8:30 AM,4,0,0,0,0,4,
10/14/2020,Wednesday,9:30 AM,3,0,0,0,0,3,
10/14/2020,Wednesday,10:30 AM,3,0,1,0,0,4,
10/14/2020,Wednesday,11:30 AM,6,0,1,0,0,7,
10/14/2020,Wednesday,12:30 PM,9,0,1,0,2,12,
10/14/2020,Wednesday,1:30 PM,4,0,1,0,5,10,
10/14/2020,Wednesday,2:30 PM,2,0,1,0,0,3,
10/14/2020,Wednesday,4:30 PM,4,0,3,0,2,9,
10/14/2020,Wednesday,4:30 PM,3,0,2,0,1,6,
10/14/2020,Wednesday,5:30 PM,6,0,3,0,4,13,
10/14/2020,Wednesday,6:30 PM,5,0,2,0,2,9,
10/14/2020,Wednesday,7:30 PM,4,0,1,0,1,6,
10/15/2020,Thursday,7:30 AM,0,0,0,0,0,0,
10/15/2020,Thursday,8:30 AM,1,0,0,0,0,1,
10/15/2020,Thursday,9:30 AM,1,0,0,0,0,1,
10/15/2020,Thursday,10:30 AM,2,0,0,0,0,2,
10/15/2020,Thursday,11:30 AM,3,0,1,0,0,4,
10/15/2020,Thursday,1:30 PM,6,0,2,0,0,8,
10/15/2020,Thursday,3:30 PM,3,0,2,0,0,5,
10/15/2020,Thursday,4:30 PM,6,2,0,0,0,8,
10/15/2020,Thursday,5:30 PM,4,0,0,0,0,4,
10/15/2020,Thursday,6:30 PM,2,0,0,0,0,2,
10/15/2020,Thursday,7:30 PM,1,0,0,0,0,1,
10/16/2020,Friday,7:30 AM,0,0,0,0,0,0,
10/16/2020,Friday,8:30 AM,1,0,0,0,0,1,
10/16/2020,Friday,9:30 AM,1,0,0,0,0,1,
10/16/2020,Friday,10:30 AM,2,0,0,0,0,2,
10/16/2020,Friday,11:30 AM,2,0,0,0,1,3,
10/16/2020,Friday,12:30 PM,5,0,0,0,1,6,
10/16/2020,Friday,1:30 PM,5,0,0,0,0,5,
10/16/2020,Friday,2:30 PM,3,0,0,0,2,5,
10/16/2020,Friday,3:30 PM,5,0,0,0,0,5,
10/16/2020,Friday,4:30 PM,7,0,3,0,4,14,
10/16/2020,Friday,5:30 PM,8,0,3,0,4,15,
10/16/2020,Friday,6:30 PM,5,0,2,0,1,8,
10/16/2020,Friday,7:30 PM,3,0,0,0,1,4,
10/17/2020,Saturday,10:30 AM,2,0,0,0,0,2,
10/17/2020,Saturday,11:30 AM,3,1,2,0,0,6,
10/17/2020,Saturday,12:30 PM,2,0,0,0,0,2,
10/17/2020,Saturday,12:30 PM,2,0,0,0,0,2,
10/17/2020,Saturday,1:30 PM,2,0,0,0,0,2,
10/17/2020,Saturday,2:30 PM,1,0,0,0,0,1,
10/19/2020,Monday,7:30 AM,0,0,0,0,0,0,
10/19/2020,Monday,8:30 AM,3,0,0,0,0,3,
10/19/2020,Monday,9:30 AM,2,0,0,0,0,2,
10/19/2020,Monday,10:30 AM,2,0,0,0,0,2,
10/19/2020,Monday,11:30 AM,6,0,1,0,2,9,
10/19/2020,Monday,12:30 PM,7,0,0,0,2,9,
10/19/2020,Monday,1:30 PM,3,0,1,0,0,4,
10/19/2020,Monday,2:30 PM,4,0,1,0,0,5,
10/19/2020,Monday,3:30 PM,6,0,1,0,1,8,
10/19/2020,Monday,4:30 PM,9,0,2,0,3,14,
10/19/2020,Monday,5:30 PM,2,0,1,0,1,4,
10/19/2020,Monday,6:30 PM,4,0,2,0,2,8,
10/19/2020,Monday,7:30 PM,3,0,1,0,1,5,
10/20/2020,Tuesday,7:30 AM,0,0,0,0,0,0,
10/20/2020,Tuesday,8:30 AM,1,0,0,0,0,1,
10/20/2020,Tuesday,9:30 AM,1,0,0,0,0,1,
10/20/2020,Tuesday,10:30 AM,2,0,0,0,0,2,
10/20/2020,Tuesday,11:30 AM,5,0,1,0,0,6,
10/20/2020,Tuesday,12:30 PM,9,0,0,0,0,9,
10/20/2020,Tuesday,1:30 PM,7,0,2,0,1,10,
10/20/2020,Tuesday,3:30 PM,5,0,3,0,0,8,
10/20/2020,Tuesday,4:30 PM,4,0,2,0,0,6,
10/20/2020,Tuesday,5:30 PM,5,0,0,0,1,6,
10/20/2020,Tuesday,6:30 PM,1,0,0,0,0,1,
10/20/2020,Tuesday,7:30 PM,0,0,0,0,0,0,
10/21/2020,Wednesday,7:30 AM,0,0,0,0,0,0,
10/21/2020,Wednesday,8:30 AM,2,0,1,0,0,3,
10/21/2020,Wednesday,9:30 AM,11,0,0,0,0,11,
10/21/2020,Wednesday,10:30 AM,5,0,0,0,0,5,
10/21/2020,Wednesday,11:30 AM,5,0,0,0,4,9,
10/21/2020,Wednesday,12:30 PM,15,0,0,0,2,17,
10/21/2020,Wednesday,1:30 PM,5,0,1,0,0,6,
10/21/2020,Wednesday,2:30 PM,4,0,1,0,0,5,
10/21/2020,Wednesday,3:30 PM,8,0,0,0,0,8,
10/21/2020,Wednesday,4:30 PM,5,0,2,0,1,8,
10/21/2020,Wednesday,5:30 PM,5,0,2,0,1,8,
10/21/2020,Wednesday,6:30 PM,3,0,2,0,0,5,
10/21/2020,Wednesday,7:30 PM,4,0,0,1,0,5,
10/22/2020,Thursday,7:30 AM,0,0,0,0,0,0,
10/22/2020,Thursday,9:30 AM,4,0,0,0,2,6,
10/22/2020,Thursday,10:30 AM,3,0,0,0,0,3,
10/22/2020,Thursday,11:30 AM,7,0,0,0,0,7,
10/22/2020,Thursday,12:30 PM,6,0,0,0,0,6,
10/22/2020,Thursday,3:30 PM,1,0,0,0,0,1,
10/22/2020,Thursday,4:30 PM,3,0,0,0,0,3,
10/22/2020,Thursday,5:30 PM,4,0,0,0,0,4,
10/22/2020,Thursday,6:30 PM,0,0,0,0,0,0,
10/22/2020,Thursday,7:30 PM,1,0,0,0,0,1,
10/23/2020,Friday,7:30 AM,0,0,0,0,0,0,
10/23/2020,Friday,8:30 AM,2,0,0,0,0,2,
10/23/2020,Friday,9:30 AM,1,0,0,0,1,2,
10/23/2020,Friday,10:30 AM,3,0,1,0,0,4,
10/23/2020,Friday,11:30 AM,6,0,0,0,0,6,
10/23/2020,Friday,12:30 PM,4,0,0,0,1,5,
10/23/2020,Friday,1:30 PM,5,0,0,0,2,7,
10/23/2020,Friday,2:30 PM,8,0,0,0,2,10,
10/23/2020,Friday,3:30 PM,4,0,0,0,0,4,
10/23/2020,Friday,4:30 PM,5,0,0,0,0,5,
10/23/2020,Friday,6:30 PM,2,0,0,0,0,2,
10/23/2020,Friday,7:30 PM,0,0,0,0,0,0,
10/24/2020,Saturday,11:30 AM,1,0,1,0,0,2,
10/24/2020,Saturday,12:30 PM,1,0,1,0,0,2,
10/24/2020,Saturday,1:30 PM,0,0,4,0,0,4,
10/24/2020,Saturday,2:30 PM,2,0,4,0,0,6,
10/26/2020,Monday,7:30 AM,1,0,0,0,0,1,
10/26/2020,Monday,8:30 AM,0,0,0,0,0,0,
10/26/2020,Monday,9:30 AM,3,0,0,0,0,3,
10/26/2020,Monday,10:30 AM,3,0,0,0,0,3,
10/26/2020,Monday,11:30 AM,2,0,0,0,2,4,
10/26/2020,Monday,12:30 PM,2,0,0,0,2,4,
10/26/2020,Monday,12:30 PM,2,0,0,0,0,2,
10/26/2020,Monday,1:30 PM,5,0,0,0,1,6,
10/26/2020,Monday,2:30 PM,3,0,0,0,1,4,
10/26/2020,Monday,3:30 PM,4,0,0,0,1,5,
10/26/2020,Monday,4:30 PM,4,0,2,0,0,6,
10/26/2020,Monday,5:30 PM,2,0,1,0,0,3,
10/26/2020,Monday,6:30 PM,5,0,2,0,0,7,
10/26/2020,Monday,7:30 PM,8,0,4,0,0,12,
10/27/2020,Tuesday,7:30 AM,0,0,0,0,0,0,
10/27/2020,Tuesday,8:30 AM,3,0,0,0,0,3,
10/27/2020,Tuesday,9:30 AM,4,0,0,0,1,5,
10/27/2020,Tuesday,10:30 AM,4,0,0,0,0,4,
10/27/2020,Tuesday,10:30 AM,4,0,0,0,0,4,
10/27/2020,Tuesday,11:30 AM,5,0,0,0,0,5,
10/27/2020,Tuesday,12:30 PM,5,0,0,0,0,5,
10/27/2020,Tuesday,1:30 PM,6,0,3,0,1,10,
10/27/2020,Tuesday,3:30 PM,4,0,2,0,0,6,
10/27/2020,Tuesday,4:30 PM,4,0,1,0,0,5,
10/27/2020,Tuesday,5:30 PM,2,0,0,0,0,2,
10/27/2020,Tuesday,6:30 PM,3,0,1,0,0,4,
10/27/2020,Tuesday,7:30 PM,1,0,0,0,0,1,
10/28/2020,Wednesday,7:30 AM,0,0,0,0,0,0,
10/28/2020,Wednesday,8:30 AM,1,0,0,0,0,1,
10/28/2020,Wednesday,9:30 AM,2,0,0,0,0,2,
10/28/2020,Wednesday,10:30 AM,2,0,0,0,0,2,
10/28/2020,Wednesday,11:30 AM,10,0,0,0,1,11,
10/28/2020,Wednesday,12:30 PM,10,0,0,0,0,10,
10/28/2020,Wednesday,1:30 PM,3,0,0,0,0,3,
10/28/2020,Wednesday,2:30 PM,3,0,0,0,0,3,
10/28/2020,Wednesday,3:30 PM,3,0,0,0,0,3,
10/28/2020,Wednesday,4:30 PM,8,0,3,0,1,12,
10/28/2020,Wednesday,5:30 PM,6,0,3,0,0,9,
10/28/2020,Wednesday,6:30 PM,7,0,0,0,2,9,
10/28/2020,Wednesday,7:30 PM,3,0,1,0,1,5,
10/29/2020,Thursday,7:30 AM,0,0,0,0,0,0,
10/29/2020,Thursday,8:30 AM,3,0,0,0,0,3,
10/29/2020,Thursday,9:30 AM,6,0,0,0,0,6,
10/29/2020,Thursday,10:30 AM,4,0,0,0,0,4,
10/29/2020,Thursday,11:30 AM,4,0,0,0,0,4,
10/29/2020,Thursday,12:30 PM,7,0,0,0,0,7,
10/29/2020,Thursday,1:30 PM,4,0,0,0,0,4,
10/29/2020,Thursday,2:30 PM,3,0,3,0,0,6,
10/29/2020,Thursday,3:30 PM,3,0,1,0,0,4,
10/29/2020,Thursday,3:30 PM,4,0,1,0,2,7,
10/29/2020,Thursday,4:30 PM,4,0,1,0,2,7,
10/29/2020,Thursday,5:30 PM,6,0,2,0,0,8,
10/29/2020,Thursday,6:30 PM,6,0,1,0,0,7,
10/29/2020,Thursday,7:30 PM,2,0,1,0,0,3,
10/30/2020,Friday,7:30 AM,1,0,0,0,0,1,
10/30/2020,Friday,8:30 AM,1,0,0,0,0,1,
10/30/2020,Friday,9:30 AM,2,0,1,0,0,3,
10/30/2020,Friday,10:30 AM,2,0,1,0,0,3,
10/30/2020,Friday,11:30 AM,2,0,0,0,5,7,
10/30/2020,Friday,12:30 PM,3,0,1,0,6,10,
10/30/2020,Friday,1:30 PM,3,0,1,0,1,5,
10/30/2020,Friday,2:30 PM,4,0,2,0,0,6,
10/30/2020,Friday,3:30 PM,2,0,3,0,0,5,
10/30/2020,Friday,4:30 PM,5,0,4,0,2,11,
10/30/2020,Friday,5:30 PM,6,0,2,0,0,8,
10/30/2020,Friday,6:30 PM,5,0,4,0,0,9,
10/30/2020,Friday,6:30 PM,0,0,2,0,0,2,
10/31/2020,Saturday,9:30 AM,0,0,0,0,0,0,
10/31/2020,Saturday,10:30 AM,1,0,0,0,0,1,
10/31/2020,Saturday,11:30 AM,2,0,0,0,0,2,
10/31/2020,Saturday,12:30 PM,2,0,1,0,1,4,
10/31/2020,Saturday,1:30 PM,2,0,1,0,0,3,
10/31/2020,Saturday,2:30 PM,3,0,1,0,0,4,
11/2/2020,Monday,7:30 AM,0,0,0,0,0,0,
11/2/2020,Monday,8:30 AM,1,0,0,0,0,1,
11/2/2020,Monday,9:30 AM,3,0,0,0,0,3,
11/2/2020,Monday,10:30 AM,3,0,0,0,0,3,
11/2/2020,Monday,11:30 AM,4,0,0,0,0,4,
11/2/2020,Monday,11:30 AM,4,0,0,0,0,4,
11/2/2020,Monday,12:30 PM,5,1,2,0,0,8,
11/2/2020,Monday,1:30 PM,2,0,2,0,2,6,
11/2/2020,Monday,2:30 PM,3,0,3,0,1,7,
11/2/2020,Monday,4:30 PM,5,0,4,0,0,9,
11/2/2020,Monday,5:30 PM,1,0,2,0,0,3,
11/2/2020,Monday,6:30 PM,3,0,1,0,0,4,
11/2/2020,Monday,7:30 PM,7,0,0,0,0,7,
11/2/2020,Monday,7:30 PM,2,0,0,0,0,2,
11/4/2020,Wednesday,7:30 AM,1,0,0,0,0,1,
11/4/2020,Wednesday,8:30 AM,1,0,0,0,0,1,
11/4/2020,Wednesday,9:30 AM,1,0,1,0,1,3,
11/4/2020,Wednesday,10:30 AM,4,0,0,0,0,4,
11/4/2020,Wednesday,11:30 AM,7,0,0,0,1,8,
11/4/2020,Wednesday,12:30 PM,13,0,0,0,0,13,
11/4/2020,Wednesday,1:30 PM,6,0,1,0,0,7,
11/4/2020,Wednesday,2:30 PM,4,0,0,0,1,5,
11/4/2020,Wednesday,3:30 PM,3,0,3,0,0,6,
11/4/2020,Wednesday,4:30 PM,8,0,0,0,0,8,
11/4/2020,Wednesday,5:30 PM,6,0,1,0,1,8,
11/4/2020,Wednesday,6:30 PM,9,0,2,0,1,12,
11/4/2020,Wednesday,7:30 PM,6,0,1,0,0,7,
11/5/2020,Thursday,7:30 AM,0,0,0,0,0,0,
11/5/2020,Thursday,7:30 AM,2,0,0,0,0,2,
11/5/2020,Thursday,8:30 AM,2,0,0,0,0,2,
11/5/2020,Thursday,9:30 AM,7,0,0,0,0,7,
11/5/2020,Thursday,10:30 AM,6,0,0,0,0,6,
11/5/2020,Thursday,11:30 AM,7,0,1,0,0,8,
11/5/2020,Thursday,12:30 PM,3,0,0,0,2,5,
11/5/2020,Thursday,1:30 PM,2,0,0,0,3,5,
11/5/2020,Thursday,2:30 PM,4,0,0,0,0,4,
11/5/2020,Thursday,3:30 PM,1,0,2,0,1,4,
11/5/2020,Thursday,4:30 PM,2,0,1,0,0,3,
11/5/2020,Thursday,5:30 PM,3,0,2,0,0,5,
11/5/2020,Thursday,6:30 PM,4,0,2,0,0,6,
11/5/2020,Thursday,7:30 PM,1,0,2,0,0,3,
11/6/2020,Friday,7:30 AM,0,0,0,0,0,0,
11/6/2020,Friday,8:30 AM,3,0,0,0,0,3,
11/6/2020,Friday,9:30 AM,6,0,0,0,0,6,
11/6/2020,Friday,10:30 AM,3,0,0,0,0,3,
11/6/2020,Friday,11:30 AM,5,0,0,0,0,5,
11/6/2020,Friday,12:30 PM,5,0,0,0,1,6,
11/6/2020,Friday,1:30 PM,3,0,0,0,0,3,
11/6/2020,Friday,3:30 PM,3,0,0,0,0,3,
11/6/2020,Friday,4:30 PM,2,0,0,0,1,3,
11/6/2020,Friday,5:30 PM,1,0,1,0,0,2,
11/6/2020,Friday,6:30 PM,0,0,0,0,0,0,
11/6/2020,Friday,7:30 PM,0,0,0,0,0,0,
11/7/2020,Saturday,8:30 AM,1,0,0,0,0,1,
11/7/2020,Saturday,9:30 AM,1,0,0,0,0,1,
11/7/2020,Saturday,10:30 AM,1,0,1,0,0,2,
11/7/2020,Saturday,12:30 PM,3,2,0,0,0,5,
11/7/2020,Saturday,1:30 PM,0,0,1,0,0,1,
11/7/2020,Saturday,2:30 PM,0,0,2,0,0,2,
11/9/2020,Monday,7:30 AM,2,0,0,0,0,2,
11/9/2020,Monday,8:30 AM,2,0,0,0,0,2,
11/9/2020,Monday,9:30 AM,1,0,0,0,0,1,
11/9/2020,Monday,10:30 AM,3,0,0,0,1,4,
11/9/2020,Monday,11:30 AM,2,0,2,0,0,4,
11/9/2020,Monday,12:30 PM,9,0,0,0,0,9,
11/9/2020,Monday,1:30 PM,7,0,0,0,2,9,
11/9/2020,Monday,2:30 PM,4,0,2,0,1,7,
11/9/2020,Monday,4:30 PM,2,0,0,0,2,4,
11/9/2020,Monday,5:30 PM,2,0,0,0,0,2,
11/9/2020,Monday,6:30 PM,3,0,0,0,0,3,
11/9/2020,Monday,7:30 PM,2,0,0,0,0,2,
11/10/2020,Tuesday,7:30 AM,1,0,0,0,0,1,
11/10/2020,Tuesday,10:30 AM,1,0,0,0,0,1,
11/10/2020,Tuesday,11:30 AM,4,0,0,0,1,5,
11/10/2020,Tuesday,12:30 PM,6,0,0,0,2,8,
11/10/2020,Tuesday,12:30 PM,6,0,0,0,2,8,
11/10/2020,Tuesday,1:30 PM,5,0,0,0,1,6,
11/10/2020,Tuesday,2:30 PM,5,0,0,0,1,6,
11/10/2020,Tuesday,2:30 PM,7,0,1,0,0,8,
11/10/2020,Tuesday,4:30 PM,5,0,0,0,0,5,
11/10/2020,Tuesday,5:30 PM,2,0,0,0,0,2,
11/10/2020,Tuesday,6:30 PM,3,0,2,0,0,5,
11/10/2020,Tuesday,7:30 PM,1,0,2,0,0,3,
11/11/2020,Wednesday,7:30 AM,1,0,0,0,0,1,
11/11/2020,Wednesday,8:30 AM,1,0,0,0,0,1,
11/11/2020,Wednesday,9:30 AM,0,0,0,0,0,0,
11/11/2020,Wednesday,10:30 AM,4,0,1,0,1,6,
11/11/2020,Wednesday,11:30 AM,6,0,2,0,0,8,
11/11/2020,Wednesday,12:30 PM,6,0,1,0,1,8,
11/11/2020,Wednesday,1:30 PM,2,0,0,0,2,4,
11/11/2020,Wednesday,3:30 PM,7,0,2,0,2,11,
11/11/2020,Wednesday,4:30 PM,3,0,1,0,1,5,
11/11/2020,Wednesday,5:30 PM,5,0,1,0,0,6,
11/11/2020,Wednesday,6:30 PM,2,0,1,0,0,3,
11/11/2020,Wednesday,7:30 PM,1,0,1,0,0,2,
11/12/2020,Thursday,7:30 AM,0,0,0,0,0,0,
11/12/2020,Thursday,8:30 AM,1,0,0,0,0,1,
11/12/2020,Thursday,11:30 AM,9,0,1,0,0,10,
11/12/2020,Thursday,12:30 PM,5,0,2,0,0,7,
11/12/2020,Thursday,1:30 PM,8,0,3,0,2,13,
11/12/2020,Thursday,2:30 PM,1,0,3,0,2,6,
11/12/2020,Thursday,3:30 PM,5,0,4,0,0,9,
11/12/2020,Thursday,4:30 PM,2,0,3,0,0,5,
11/12/2020,Thursday,5:30 PM,4,0,2,0,0,6,
11/12/2020,Thursday,6:30 PM,3,0,1,0,0,4,
11/12/2020,Thursday,7:30 PM,3,0,1,0,0,4,
11/13/2020,Friday,7:30 AM,0,0,0,0,0,0,
11/13/2020,Friday,8:30 AM,2,0,0,0,0,2,
11/13/2020,Friday,9:30 AM,2,0,0,0,0,2,
11/13/2020,Friday,10:30 AM,4,0,0,0,0,4,
11/13/2020,Friday,11:30 AM,6,0,1,0,0,7,
11/13/2020,Friday,1:30 PM,5,0,1,0,0,6,
11/13/2020,Friday,4:30 PM,0,0,1,0,0,1,
11/13/2020,Friday,5:30 PM,1,0,0,0,1,2,
11/13/2020,Friday,6:30 PM,1,0,0,0,1,2,
11/13/2020,Friday,7:30 PM,1,0,0,0,0,1,
11/14/2020,Saturday,9:30 AM,0,0,0,0,0,0,
11/14/2020,Saturday,10:30 AM,0,0,0,0,0,0,
11/14/2020,Saturday,11:30 AM,2,0,0,0,0,2,
11/14/2020,Saturday,12:30 PM,3,0,1,0,0,4,
11/14/2020,Saturday,1:30 PM,6,0,1,0,0,7,
11/16/2020,Monday,7:30 AM,0,0,0,0,0,0,
11/16/2020,Monday,8:30 AM,0,0,0,0,1,1,
11/16/2020,Monday,9:30 AM,1,0,0,0,0,1,
11/16/2020,Monday,10:30 AM,4,0,1,0,0,5,
11/16/2020,Monday,11:30 AM,7,0,1,0,0,8,
11/16/2020,Monday,3:30 PM,1,1,0,0,0,2,
11/16/2020,Monday,4:30 PM,1,0,0,0,0,1,
11/16/2020,Monday,4:30 PM,1,0,1,0,1,3,
11/16/2020,Monday,5:30 PM,1,0,0,0,0,1,
11/16/2020,Monday,5:30 PM,1,0,1,0,0,2,
11/16/2020,Monday,6:30 PM,0,0,0,0,0,0,
11/16/2020,Monday,7:30 PM,0,0,0,0,0,0,
11/17/2020,Tuesday,7:30 AM,0,0,0,0,0,0,
11/17/2020,Tuesday,9:30 AM,4,0,0,0,0,4,
11/17/2020,Tuesday,11:30 AM,6,0,1,0,3,10,
11/17/2020,Tuesday,12:30 PM,8,0,0,0,2,10,
11/17/2020,Tuesday,1:30 PM,3,0,0,0,1,4,
11/17/2020,Tuesday,2:30 PM,2,0,1,0,0,3,
11/17/2020,Tuesday,3:30 PM,1,0,1,0,0,2,
11/17/2020,Tuesday,4:30 PM,4,0,2,0,0,6,
11/17/2020,Tuesday,5:30 PM,0,0,1,0,0,1,
11/17/2020,Tuesday,6:30 PM,2,0,1,0,0,3,
11/17/2020,Tuesday,7:30 PM,2,0,0,0,0,2,
11/18/2020,Wednesday,7:30 AM,0,0,0,0,0,0,
11/18/2020,Wednesday,8:30 AM,2,0,0,0,0,2,
11/18/2020,Wednesday,9:30 AM,2,0,0,0,0,2,
11/18/2020,Wednesday,10:30 AM,3,0,0,0,0,3,
11/18/2020,Wednesday,11:30 AM,3,0,0,0,0,3,
11/18/2020,Wednesday,12:30 PM,4,0,0,0,0,4,
11/18/2020,Wednesday,1:30 PM,3,0,0,0,0,3,
11/18/2020,Wednesday,4:30 PM,3,0,0,0,0,3,
11/18/2020,Wednesday,5:30 PM,3,0,0,0,0,3,
11/18/2020,Wednesday,6:30 PM,3,0,0,0,0,3,
11/18/2020,Wednesday,7:30 PM,0,0,0,0,0,0,
11/19/2020,Thursday,7:30 AM,0,0,0,0,0,0,
11/19/2020,Thursday,8:30 AM,2,0,0,0,0,2,
11/19/2020,Thursday,9:30 AM,0,0,0,0,0,0,
11/19/2020,Thursday,10:30 AM,4,0,0,0,1,5,
11/19/2020,Thursday,11:30 AM,4,0,0,0,1,5,
11/19/2020,Thursday,12:30 PM,4,0,0,0,1,5,
11/19/2020,Thursday,1:30 PM,3,0,0,0,1,4,
11/19/2020,Thursday,2:30 PM,2,0,0,0,1,3,
11/19/2020,Thursday,1:30 PM,2,0,0,0,2,4,
11/19/2020,Thursday,3:30 PM,1,0,0,0,1,2,
11/19/2020,Thursday,4:30 PM,3,0,0,0,0,3,
11/19/2020,Thursday,5:30 PM,2,0,1,0,0,3,
11/19/2020,Thursday,6:30 PM,1,0,1,0,0,2,
11/19/2020,Thursday,7:30 PM,0,0,2,0,0,2,
11/20/2020,Friday,7:30 AM,1,0,0,0,0,1,
11/20/2020,Friday,8:30 AM,3,0,0,0,0,3,
11/20/2020,Friday,9:30 AM,3,0,0,0,0,3,
11/20/2020,Friday,10:30 AM,3,0,0,0,0,3,
11/20/2020,Friday,11:30 AM,6,0,0,0,1,7,
11/20/2020,Friday,12:30 PM,6,1,0,0,1,8,
11/20/2020,Friday,1:30 PM,2,1,0,0,1,4,
11/20/2020,Friday,2:30 PM,2,0,0,0,0,2,
11/20/2020,Friday,4:30 PM,4,0,0,0,0,4,
11/20/2020,Friday,6:30 PM,0,0,0,0,0,0,
11/20/2020,Friday,7:30 PM,1,0,0,0,0,1,
11/21/2020,Saturday,9:30 AM,0,0,0,0,0,0,
11/21/2020,Saturday,10:30 AM,0,0,0,0,0,0,
11/21/2020,Saturday,11:30 AM,1,0,0,0,0,1,
11/21/2020,Saturday,12:30 PM,1,0,0,0,0,1,
11/21/2020,Saturday,1:30 PM,2,0,2,0,0,4,
11/21/2020,Saturday,2:30 PM,0,0,1,0,0,1,
11/23/2020,Monday,7:30 AM,0,0,0,0,0,0,
11/23/2020,Monday,8:30 AM,0,0,0,0,0,0,
11/23/2020,Monday,9:30 AM,4,0,0,0,0,4,
11/23/2020,Monday,10:30 AM,1,0,0,0,0,1,
11/23/2020,Monday,11:30 AM,2,0,0,0,0,2,
11/23/2020,Monday,12:30 PM,2,0,0,0,0,0,
11/23/2020,Monday,1:30 PM,0,1,0,0,0,1,
11/23/2020,Monday,2:30 PM,0,0,0,0,0,0,
11/23/2020,Monday,3:30 PM,2,0,0,0,0,2,
11/23/2020,Monday,4:30 PM,6,0,0,0,1,7,
11/23/2020,Monday,5:30 PM,3,0,0,0,2,5,
11/23/2020,Monday,6:30 PM,4,0,0,0,2,6,
11/23/2020,Monday,7:30 PM,3,0,1,0,0,4,
11/24/2020,Tuesday,7:30 AM,0,0,0,0,0,0,
11/24/2020,Tuesday,8:30 AM,1,0,0,0,0,1,
11/24/2020,Tuesday,9:30 AM,1,0,0,0,0,1,
11/24/2020,Tuesday,10:30 AM,0,0,0,0,0,0,
11/24/2020,Tuesday,11:30 AM,2,0,1,0,0,3,
11/24/2020,Tuesday,12:30 PM,1,0,0,0,3,4,
11/24/2020,Tuesday,1:30 PM,3,0,0,0,1,4,
11/24/2020,Tuesday,2:30 PM,5,0,0,0,0,5,
11/24/2020,Tuesday,3:30 PM,1,0,0,1,0,2,
11/24/2020,Tuesday,4:30 PM,3,0,0,0,2,5,
11/24/2020,Tuesday,5:30 PM,0,0,0,0,0,0,
11/24/2020,Tuesday,6:30 PM,2,0,1,0,0,3,
11/24/2020,Tuesday,7:30 PM,0,0,1,0,0,1,
11/30/2020,Monday,7:30 AM,0,0,0,0,0,0,
11/30/2020,Monday,8:30 AM,1,0,0,0,0,1,
11/30/2020,Monday,9:30 AM,3,0,0,0,0,3,
11/30/2020,Monday,10:30 AM,2,0,0,0,0,2,
11/30/2020,Monday,11:30 AM,4,0,0,0,0,4,
11/30/2020,Monday,12:30 PM,2,0,0,0,0,2,
11/30/2020,Monday,1:30 PM,3,1,1,0,3,8,
11/30/2020,Monday,2:30 PM,5,0,0,0,2,7,
11/30/2020,Monday,3:30 PM,5,1,1,1,0,8,
11/30/2020,Monday,4:30 PM,3,0,0,0,1,4,
11/30/2020,Monday,5:30 PM,1,0,0,0,1,2,
11/30/2020,Monday,6:30 PM,1,0,0,0,1,2,
11/30/2020,Monday,7:30 PM,1,0,1,0,1,3,
12/1/2020,Tuesday,7:30 AM,0,0,0,0,0,0,
12/1/2020,Tuesday,8:30 AM,2,0,0,0,0,2,
12/1/2020,Tuesday,9:30 AM,2,0,0,0,0,2,
12/1/2020,Tuesday,10:30 AM,4,0,0,0,0,4,
12/1/2020,Tuesday,11:30 AM,3,0,0,0,1,4,
12/1/2020,Tuesday,12:30 PM,1,0,0,1,1,3,
12/1/2020,Tuesday,1:30 PM,3,0,2,0,0,5,
12/1/2020,Tuesday,2:30 PM,2,0,1,0,1,4,
12/1/2020,Tuesday,1:30 PM,2,1,0,0,0,3,
12/1/2020,Tuesday,2:30 PM,1,0,1,0,2,4,
12/1/2020,Tuesday,3:30 PM,4,0,0,1,1,6,
12/1/2020,Tuesday,4:30 PM,3,0,1,0,0,4,
12/1/2020,Tuesday,5:30 PM,2,0,1,0,0,3,
12/1/2020,Tuesday,6:30 PM,2,0,0,0,0,2,
12/1/2020,Tuesday,7:30 PM,1,0,0,0,0,1,
12/2/2020,Wednesday,9:30 AM,1,0,0,0,0,1,
12/2/2020,Wednesday,10:30 AM,1,0,0,0,0,1,
12/2/2020,Wednesday,11:30 AM,3,0,0,0,1,4,
12/2/2020,Wednesday,12:30 PM,1,0,0,0,1,2,
12/2/2020,Wednesday,1:30 PM,3,0,0,0,1,4,
12/2/2020,Wednesday,2:30 PM,2,0,0,0,2,4,
12/2/2020,Wednesday,3:30 PM,3,0,0,0,0,3,
12/2/2020,Wednesday,4:30 PM,0,0,0,0,0,0,
12/2/2020,Wednesday,5:30 PM,2,0,0,0,3,5,
12/2/2020,Wednesday,6:30 PM,0,0,0,0,0,0,
12/2/2020,Wednesday,7:30 PM,0,0,0,0,0,0,
12/3/2020,Thursday,7:30 AM,0,0,0,0,0,0,
12/3/2020,Thursday,8:30 AM,1,0,0,0,0,1,
12/3/2020,Thursday,9:30 AM,1,0,0,0,0,1,
12/3/2020,Thursday,11:30 AM,1,0,0,0,0,1,
12/3/2020,Thursday,12:30 PM,3,0,0,0,1,4,
12/3/2020,Thursday,1:30 PM,5,0,0,0,1,6,
12/3/2020,Thursday,2:30 PM,1,0,0,1,1,3,
12/3/2020,Thursday,3:30 PM,2,0,0,0,0,2,
12/3/2020,Thursday,4:30 PM,1,0,0,0,0,1,
12/3/2020,Thursday,5:30 PM,1,0,0,0,0,1,
12/3/2020,Thursday,6:30 PM,0,0,0,0,0,0,
12/3/2020,Thursday,7:30 PM,0,0,0,0,0,0,
12/4/2020,Friday,7:30 AM,1,0,0,0,0,1,
12/4/2020,Friday,8:30 AM,1,0,0,0,0,1,
12/4/2020,Friday,9:30 AM,2,0,0,0,0,2,
12/4/2020,Friday,10:30 AM,2,0,0,0,0,2,
12/4/2020,Friday,11:30 AM,2,0,0,0,0,2,
12/4/2020,Friday,12:30 PM,4,0,0,0,1,5,
12/4/2020,Friday,1:30 PM,1,0,0,0,0,1,
12/4/2020,Friday,2:30 PM,1,0,1,0,1,3,
12/4/2020,Friday,3:30 PM,4,0,1,0,1,6,
12/4/2020,Friday,6:30 PM,0,0,0,0,0,0,
12/4/2020,Friday,7:30 PM,0,0,0,0,0,0,
12/5/2020,Saturday,10:30 AM,1,0,0,0,0,1,
12/5/2020,Saturday,11:30 AM,0,0,2,0,0,2,
12/7/2020,Monday,7:30 AM,0,0,0,0,0,0,
12/7/2020,Monday,8:30 AM,1,0,0,0,0,1,
12/7/2020,Monday,9:30 AM,1,0,0,0,0,1,
12/7/2020,Monday,10:30 AM,4,0,0,0,0,4,
12/7/2020,Monday,11:30 AM,1,0,0,0,0,1,
12/7/2020,Monday,12:30 PM,0,0,0,0,1,1,
12/7/2020,Monday,1:30 PM,1,0,0,0,1,2,
12/7/2020,Monday,2:30 PM,2,0,0,0,1,3,
12/7/2020,Monday,3:30 PM,4,0,1,0,0,5,
12/7/2020,Monday,4:30 PM,3,0,0,0,3,6,
12/7/2020,Monday,5:30 PM,2,0,0,0,3,5,
12/7/2020,Monday,6:30 PM,3,0,0,0,3,6,
12/7/2020,Monday,7:30 PM,0,0,0,0,1,1,
12/8/2020,Tuesday,7:30 AM,0,0,0,0,0,0,
12/8/2020,Tuesday,8:30 AM,1,0,0,0,0,1,
12/8/2020,Tuesday,9:30 AM,3,0,0,0,2,5,
12/8/2020,Tuesday,10:30 AM,1,0,0,0,2,3,
12/8/2020,Tuesday,11:30 AM,3,0,0,0,0,3,
12/8/2020,Tuesday,12:30 PM,3,0,0,0,2,5,
12/8/2020,Tuesday,1:30 PM,4,0,1,0,1,6,
12/8/2020,Tuesday,2:30 PM,4,0,1,0,0,5,
12/8/2020,Tuesday,3:30 PM,3,0,1,0,0,4,
12/8/2020,Tuesday,4:30 PM,5,0,1,0,1,7,
12/8/2020,Tuesday,5:30 PM,6,0,0,0,0,6,
12/8/2020,Tuesday,6:30 PM,2,0,0,0,0,2,
12/8/2020,Tuesday,7:30 PM,2,0,0,0,0,2,
12/9/2020,Wednesday,7:30 AM,0,0,0,0,0,0,
12/9/2020,Wednesday,8:30 AM,2,0,0,0,0,2,
12/9/2020,Wednesday,9:30 AM,2,0,0,0,0,2,
12/9/2020,Wednesday,10:30 AM,4,0,0,0,0,4,
12/9/2020,Wednesday,11:30 AM,3,1,0,0,1,5,
12/9/2020,Wednesday,12:30 PM,2,0,0,0,0,2,
12/9/2020,Wednesday,1:30 PM,2,0,0,0,0,2,
12/9/2020,Wednesday,2:30 PM,2,0,0,0,0,2,
12/9/2020,Wednesday,4:30 PM,3,0,0,0,1,4,
12/9/2020,Wednesday,5:30 PM,1,0,0,0,1,2,
12/9/2020,Wednesday,6:30 PM,0,0,0,0,1,1,
12/9/2020,Wednesday,7:30 PM,2,0,0,0,0,2,
12/10/2020,Thursday,7:30 AM,0,0,0,0,0,0,
12/10/2020,Thursday,8:30 AM,0,0,0,0,2,2,
12/10/2020,Thursday,9:30 AM,1,0,0,0,2,3,
12/10/2020,Thursday,10:30 AM,3,0,0,0,2,5,
12/10/2020,Thursday,11:30 AM,3,0,0,0,0,3,
12/10/2020,Thursday,12:30 PM,4,0,0,0,0,4,
12/10/2020,Thursday,1:30 PM,2,0,0,0,0,2,
12/10/2020,Thursday,2:30 PM,1,0,0,0,0,1,
12/10/2020,Thursday,2:30 PM,1,0,0,2,0,3,
12/10/2020,Thursday,3:30 PM,1,0,0,2,0,3,
12/10/2020,Thursday,4:30 PM,2,0,0,0,0,2,
12/10/2020,Thursday,5:30 PM,5,0,0,0,0,5,
12/10/2020,Thursday,6:30 PM,5,0,0,0,0,5,
12/10/2020,Thursday,7:30 PM,4,0,2,0,0,6,
12/11/2020,Friday,7:30 AM,1,0,0,0,0,1,
12/11/2020,Friday,8:30 AM,1,0,0,0,0,1,
12/11/2020,Friday,9:30 AM,2,0,0,0,0,2,
12/11/2020,Friday,10:30 AM,1,0,1,0,0,2,
12/11/2020,Friday,11:30 AM,2,0,0,0,0,2,
12/11/2020,Friday,12:30 PM,3,0,0,0,0,3,
12/11/2020,Friday,1:30 PM,4,0,0,0,0,4,
12/11/2020,Friday,2:30 PM,3,0,0,0,0,3,
12/11/2020,Friday,3:30 PM,2,0,1,0,0,3,
12/11/2020,Friday,4:30 PM,2,0,0,0,0,2,
12/11/2020,Friday,5:30 PM,3,0,0,0,1,4,
12/11/2020,Friday,6:30 PM,2,0,0,0,1,3,
